up_count,down_count,ngram,total_count,polar_score,polarity
39641,78645, 인하/NNG,118286,0.7318940877876972,Dovish
12,23, 개입설/NNG,35,0.7575794126291744,Dovish
5,12, 당분간/MAG;금리/NNG;하락/NNG,17,0.6050113364746877,Dovish
10395,28784, 금리/NNG;인하/NNG,39179,0.5243823937732947,Dovish
22,43, 교체수요/NNG,65,0.7428976410665934,Dovish
73,167, 심리/NNG;살/VV,240,0.6347184799423073,Dovish
974,2261, 초저금리/NNG,3235,0.6255084034246927,Dovish
39,92, 모노라인/NNG,131,0.6155332727612042,Dovish
13,28, 유럽투자은행/NNG,41,0.6741554892146522,Dovish
20,41, 비용/NNG;부담/NNG;완화/NNG,61,0.7083059548971955,Dovish
75,161, 인플레이션/NNG;둔화/NNG,236,0.6764101898474771,Dovish
120,238, 내수/NNG;위축/NNG,358,0.7321145584231517,Dovish
37,80, 성장/NNG;안정/NNG,117,0.6715625834869035,Dovish
401,1149, 인하/NNG;효과/NNG,1550,0.5067562316999474,Dovish
1759,4588, 금리/NNG;내리/VV,6347,0.5566948252095776,Dovish
538,1122, 금리/NNG;떨어/VV,1660,0.696248340156967,Dovish
572,1099, 걷/VV,1671,0.7557411853616482,Dovish
98,188, 만찬/NNG,286,0.7569077996747159,Dovish
830,1600, 회동/NNG,2430,0.7532391139109864,Dovish
1490,3335, 공조/NNG,4825,0.6487317958721092,Dovish
14,68, 국채/NNG;가격/NNG;상승/NNG;확대/NNG,82,0.2989467780227869,Dovish
178,402, 좁혀진/VV,580,0.642937420253698,Dovish
10,29, 강하/VA;상승/NNG;압력/NNG,39,0.5006990370825003,Dovish
6,12, 대내균형/NNG,18,0.7260136037696254,Dovish
3,16, 경제/NNG;충격/NNG;주/VV;않/VX,19,0.27225510141360953,Dovish
23,150, 실물/NNG;경기/NNG;침체/NNG,173,0.22264417182268512,Dovish
71,141, 이미/MAG;금리/NNG;인하/NNG,212,0.7311626364204739,Dovish
46,88, 의아/NNG,134,0.7590142221227901,Dovish
2495,4893, 디플레이션/NNG,7388,0.7404062707562703,Dovish
51,107, 누그러진/VV,158,0.6920877344345961,Dovish
20,45, 미/NNG;금리/NNG;오르/VV,65,0.6453454255730003,Dovish
109,225, 디플레이션/NNG;위험/NNG,334,0.7034265138745703,Dovish
1549,3273, 경기/NNG;침체/NNG,4822,0.6871952778729908,Dovish
5,16, 비용/NNG;확대/NNG,21,0.4537585023560159,Dovish
523,1113, 롤오버/NNG,1636,0.6823092808113461,Dovish
31,127, 원월물/NNG,158,0.35443183806076206,Dovish
355,722, 거래자/NNG,1077,0.7139468956737314,Dovish
14,28, 포지/NNG,42,0.7260136037696254,Dovish
54,108, 국채선물/NNG;가격/NNG;상승/NNG,162,0.7260136037696253,Dovish
446,877, fed/NNG;매파/NNG,1323,0.7384311682582735,Dovish
1570,3422, 감산/NNG,4992,0.6661843120504453,Dovish
26,54, 심리/NNG;약하/VA,80,0.6991242110374171,Dovish
62,153, 퍼진/VV,215,0.5884031821400886,Dovish
57,141, 심리/NNG;악화/NNG,198,0.5869897221967184,Dovish
83,167, 경제운용방향/NNG,250,0.7216662169207055,Dovish
5,14, 위험자산/NNG;비중/NNG;줄/VV,19,0.5185811455497324,Dovish
933,1833, 역전폭/NNG,2766,0.7390842251140868,Dovish
33,65, 다듬/VV,98,0.7371830438276197,Dovish
243,494, 폐기/NNG,737,0.7142562984454209,Dovish
57,117, 명백히/MAG,174,0.707397870339635,Dovish
7,16, 경제원리/NNG,23,0.6352619032984222,Dovish
32,72, 퇴장/NNG,104,0.6453454255730003,Dovish
62,190, 화살/NNG,252,0.47381940456543975,Dovish
122,313, 내심/NNG,435,0.5659658764210499,Dovish
6,20, 해국/NNG,26,0.43560816226177523,Dovish
15,56, 백약/NNG,71,0.38893585916229934,Dovish
124,274, 무효/NNG,398,0.6571218019520697,Dovish
18,36, 오차/NNG,54,0.7260136037696254,Dovish
49,110, 쓴다/VV,159,0.6468121197220299,Dovish
279,534, 짚/VV,813,0.7586434286581478,Dovish
42,92, 했으니/XSV,134,0.6628819860505275,Dovish
30,66, 고금리정책/NNG,96,0.6600123670632958,Dovish
26,51, 갇히/VV,77,0.7402491646278533,Dovish
777,1634, 상가/NNG,2411,0.690468262091798,Dovish
3,14, 초시/NNG,17,0.3111486873298395,Dovish
131,277, 서면/NNG,408,0.6866987876810176,Dovish
76,157, fed/NNG;통화/NNG;긴축/NNG,233,0.7028921514202743,Dovish
5359,11625, fed/NNG;금리/NNG;인상/NNG,16984,0.6693689294798146,Dovish
670,1329, fed/NNG;금리/NNG;오르/VV,1999,0.7320227457120376,Dovish
25,89, 실물/NNG;경제/NNG;위축/NNG,114,0.4078728111065311,Dovish
21,43, 실물/NNG;경기/NNG;둔화/NNG,64,0.7091295664726573,Dovish
10,33, 내수/NNG;경기/NNG;위축/NNG,43,0.44000824470886385,Dovish
9,19, 금리/NNG;상승/NNG;멈추/VV,28,0.687802361465961,Dovish
7,17, 인플레이션/NNG;충격/NNG,24,0.5978935560455738,Dovish
20,55, 부동산/NNG;위험/NNG,75,0.5280098936506367,Dovish
780,1551, 통화/NNG;완화/NNG,2331,0.730226448665774,Dovish
83,163, 전망/NNG;어둡/VA,246,0.7393758173359375,Dovish
1156,2231, 금리/NNG;낮/VA,3387,0.7523726812708983,Dovish
306,606, 불안/NNG;크/VV,912,0.7332018572722949,Dovish
46,120, 답변서/NNG,166,0.5566104295567127,Dovish
2449,4749, 풀/VV,7198,0.7487922996975417,Dovish
238,488, 강달러/NNG,726,0.7081608102343068,Dovish
4,23, 고마운/VA,27,0.2525264708763914,Dovish
318,623, 총량/NNG,941,0.7411631653250108,Dovish
7,14, 대출/NNG;증가율/NNG;상승/NNG,21,0.7260136037696254,Dovish
157,315, 부정적/VAX;영향/NNG;줄/VV,472,0.7237087986782932,Dovish
17,35, 장거리미사일/NNG,52,0.7052703579476362,Dovish
107,280, 반군/NNG,387,0.5548818257382138,Dovish
227,484, 이기/VV,711,0.6810127605607644,Dovish
16,36, 인상/NNG;가능성/NNG;높/VV,52,0.6453454255730003,Dovish
21,41, 나타낸다는/VV,62,0.7437212526420554,Dovish
6,16, 높/VA;급등/NNG,22,0.5445102028272191,Dovish
2910,5793, irs/NNG,8703,0.7293974061693802,Dovish
226,444, 호소/NNG,670,0.7390949299636727,Dovish
42,84, 엄두/NNG,126,0.7260136037696254,Dovish
7,24, 미심쩍/VA,31,0.42350793553228144,Dovish
44,86, 착각/NNG,130,0.7428976410665934,Dovish
14,31, 배짱/NNG,45,0.6557542227596617,Dovish
28,67, 날려/VV,95,0.6068173404641645,Dovish
23,44, 어정쩡/NNG,67,0.7590142221227901,Dovish
1318,2557, 문구/NNG,3875,0.7484442156968059,Dovish
3,13, 한다던/XSV,16,0.33508320173982714,Dovish
11,23, 엮여/VV,34,0.6944477949100765,Dovish
10,27, 물가/NNG;상승/NNG;견인/NNG,37,0.5377878546441669,Dovish
328,630, 임금/NNG;인상/NNG,958,0.7559760699569432,Dovish
20,51, 인상/NNG;자제/NNG,71,0.5694224343291179,Dovish
9,23, 같아졌/VV,32,0.5681845594718807,Dovish
290,563, 토로/NNG,853,0.7479358617875359,Dovish
5,16, 인플레이션/NNG;위험/NNG;증가/NNG,21,0.4537585023560159,Dovish
259,602, 국채/NNG;수익률/NNG;하락/NNG,861,0.6247093799878172,Dovish
15,35, 페니메이/NNG,50,0.6222973746596789,Dovish
112,228, 숏커버링/NNG,340,0.7132765230017372,Dovish
18,39, 신용위기/NNG;완화/NNG,57,0.6701664034796543,Dovish
135,272, 언와인딩/NNG,407,0.7206752684477898,Dovish
8,16, 애당초/NNG,24,0.7260136037696253,Dovish
88,169, 혼자/NNG,257,0.7560851731565329,Dovish
5,11, 엿보인다는/VV,16,0.6600123670632958,Dovish
6,19, 자각/NNG,25,0.458534907643974,Dovish
20,41, 갈까/VV,61,0.7083059548971955,Dovish
10,23, 완화/NNG;압박/NNG,33,0.6313161771909785,Dovish
44,85, 안정/NNG;추세/NNG,129,0.7516376133144357,Dovish
48,233, 핵협상/NNG,281,0.2991300685059401,Dovish
61,132, 반빅/NNG,193,0.6710125731810175,Dovish
86,173, 경제동향간담회/NNG,259,0.7218169933432114,Dovish
3,13, 원유/NNG;재고/NNG;예상/NNG;상회/NNG,16,0.33508320173982714,Dovish
160,422, 단타/NNG,582,0.5505316426689103,Dovish
24,47, 망령/NNG,71,0.7414607017221707,Dovish
7,16, 조력자/NNG,23,0.6352619032984222,Dovish
36,74, 당할/XSV,110,0.7063916144785545,Dovish
203,393, 바쁘/VA,596,0.7500293209426664,Dovish
27,64, 켰/VV,91,0.6125739781806214,Dovish
101,224, 몰락/NNG,325,0.6547086962565373,Dovish
143,276, 유전/NNG,419,0.7523184444859161,Dovish
737,1811, 테러/NNG,2548,0.5909133362542396,Dovish
43,88, 중후반대/NNG,131,0.709513294593043,Dovish
132,255, 차라리/MAG,387,0.7516376133144356,Dovish
150,305, 들/NNG,455,0.7141117414127462,Dovish
31,62, 내보내/VV,93,0.7260136037696255,Dovish
9,21, 은도/NNG,30,0.6222973746596789,Dovish
7,19, 벗어난다는/VV,26,0.5349573922513029,Dovish
7,22, 자위/NNG,29,0.4620086569443071,Dovish
25,57, 국고채/NNG;입찰/NNG;부진/NNG,82,0.6368540383944082,Dovish
7,21, 둔화/NNG;유가/NNG;하락/NNG,28,0.4840090691797503,Dovish
12,42, 금리/NNG;인하/NNG;중단/NNG,54,0.41486491643978596,Dovish
13,25, 하락/NNG;멈추/VV;상승/NNG,38,0.7550541479204105,Dovish
8,21, 금리/NNG;서둘/VV;오르/VV,29,0.5531532219197145,Dovish
4,13, 정책/NNG;방향/NNG;잡/VV,17,0.44677760231976943,Dovish
5,11, 하락/NNG;고점/NNG,16,0.6600123670632958,Dovish
18,52, 비용/NNG;급증/NNG,70,0.5026248026097407,Dovish
22,45, 완화/NNG;조짐/NNG,67,0.7098799681303004,Dovish
27,54, 예상/NNG;줄/VV,81,0.7260136037696253,Dovish
5,11, 마이너스/NNG;감소/NNG,16,0.6600123670632958,Dovish
25,58, 불확실성/NNG;하락/NNG,83,0.6258737963531253,Dovish
645,1255, 삭제/NNG,1900,0.7462609951098141,Dovish
19,59, 금리/NNG;인상/NNG;우려/NNG;약화/NNG,78,0.46760198208891135,Dovish
6,14, 유가/NNG;소폭/MAG;하락/NNG,20,0.622297374659679,Dovish
219,440, 가담/NNG,659,0.7227135419343089,Dovish
796,1655, 경색/NNG,2451,0.6983768321457665,Dovish
11,31, 공허/NNG,42,0.5152354607397341,Dovish
341,722, 롱플레이/NNG,1063,0.6857912434499785,Dovish
142,273, 든다/VV,415,0.7552668991596103,Dovish
174,346, 선점/NNG,520,0.7302102141960394,Dovish
40,94, 기대/NNG;인플레이션/NNG;하락/NNG,134,0.6178839181018089,Dovish
10,21, 둔화/NNG;유가/NNG;급락/NNG,31,0.6914415273996433,Dovish
9,22, 고물가/NNG;저성장/NNG,31,0.5940111303569663,Dovish
22,44, 얽힌/VV,66,0.7260136037696254,Dovish
9,19, 유가/NNG;하락/NNG;경기/NNG;둔화/NNG,28,0.687802361465961,Dovish
65,145,동반/NNG,210,0.6509087482072503,Dovish
110,214, 단절/NNG,324,0.7463691253706429,Dovish
17,35, 생리/NNG,52,0.7052703579476362,Dovish
29,63, 여길/VV,92,0.6683934764863217,Dovish
23,46, 절제/NNG,69,0.7260136037696253,Dovish
1016,1955, 엔원/NNG,2971,0.7546085129718051,Dovish
19,46, 원달러/NNG;상승/NNG;압력/NNG,65,0.5997503683314297,Dovish
6,21, 인플레이션/NNG;약화/NNG,27,0.41486491643978596,Dovish
669,1314, 금융시장/NNG;불안/NNG,1983,0.7392741262129062,Dovish
12,35, 원달러/NNG;안정/NNG,47,0.49783789972774317,Dovish
15,38, 수출/NNG;약화/NNG,53,0.5731686345549674,Dovish
64,132, 휴전/NNG,196,0.7040131915341822,Dovish
34,74, 손길/NNG,108,0.6671476358964126,Dovish
261,526, 처지/NNG,787,0.7204925877713773,Dovish
311,615, 단서/NNG,926,0.734277173243426,Dovish
59,148, 부동산/NNG;경기/NNG;회복/NNG,207,0.5788486840865932,Dovish
5,24, 부동산/NNG;긍정적/VAX,29,0.30250566823734387,Dovish
4,12, 바닥/NNG;내리/VV,16,0.4840090691797502,Dovish
17,34, 빨/VV,51,0.7260136037696254,Dovish
555,1064, 직/NNG,1619,0.7574014099476355,Dovish
95,188, 근/NNG,283,0.7337371527458981,Dovish
163,325, 해약/NNG,488,0.7282474917812244,Dovish
286,552, 등락폭/NNG,838,0.7523184444859161,Dovish
313,617, 극/NNG,930,0.7366037535815,Dovish
172,343, 부동산펀드/NNG,515,0.7281302615065631,Dovish
62,121, 재간접펀드/NNG,183,0.7440139410531699,Dovish
189,425, 폭등/NNG,614,0.6457250405292198,Dovish
236,480, 정작/NNG,716,0.7139133770401316,Dovish
29,56, 처사/NNG,85,0.751942661047112,Dovish
118,226, 양방향/NNG,344,0.7581380995116442,Dovish
56,115, 거침없이/MAG,171,0.7070741184538961,Dovish
4,13, 금융시장/NNG;불안/NNG;경기/NNG;둔화/NNG,17,0.44677760231976943,Dovish
11,26, 경상/NNG;수지/NNG;적자/NNG;축소/NNG,37,0.614319203189683,Dovish
12,28, 자금/NNG;조달/NNG;여건/NNG;악화/NNG,40,0.622297374659679,Dovish
5,11, 부동산/NNG;대출/NNG;부실/NNG,16,0.6600123670632958,Dovish
9,25, 은행채/NNG;금리/NNG;하락/NNG,34,0.5227297947141304,Dovish
13,29, 발행/NNG;금리/NNG;하락/NNG,42,0.6509087482072504,Dovish
9,19, 은행채/NNG;금리/NNG;오르/VV,28,0.687802361465961,Dovish
43,84, 경제/NNG;성장/NNG;우려/NNG,127,0.7432996419546165,Dovish
43,88, 스왑베이시스/NNG;확대/NNG,131,0.709513294593043,Dovish
95,217, 외환보유액/NNG;감소/NNG,312,0.635680113899672,Dovish
5,20, 일시적/VAX;이탈/NNG,25,0.3630068018848127,Dovish
147,290, 부작용/NNG;우려/NNG,437,0.7360275845112754,Dovish
56,110, 수요/NNG;충족/NNG,166,0.7392138511108913,Dovish
54,127, 경제/NNG;취약/NNG,181,0.61739739533165,Dovish
69,150, 비용/NNG;낮/VV,219,0.6679325154680554,Dovish
108,228, 스무딩/NNG,336,0.6878023614659609,Dovish
21,48, 미련/NNG,69,0.6352619032984221,Dovish
84,201, 협동조합/NNG,285,0.6068173404641645,Dovish
60,118, 심각/NNG;않/VX,178,0.7383189190877547,Dovish
49,121, 전망/NNG;늘/VV,170,0.5880110179291181,Dovish
21,41, 실책/NNG,62,0.7437212526420554,Dovish
23,54, 수출업자/NNG,77,0.618456032840792,Dovish
15,32, 수입업자/NNG,47,0.6806377535340238,Dovish
16,46, 경기/NNG;악화/NNG;우려/NNG,62,0.5050529417527828,Dovish
18,39, 스왑베이시스/NNG;역전폭/NNG;확대/NNG,57,0.6701664034796543,Dovish
39,78, 스왑베이시스/NNG;축소/NNG,117,0.7260136037696254,Dovish
68,162, 신용경색/NNG;완화/NNG,230,0.6094929019300559,Dovish
392,790, 바이/NNG,1182,0.7204995763992232,Dovish
25,57, 수치인/NNG,82,0.6368540383944082,Dovish
22,47, 준비자산/NNG,69,0.6796723099119898,Dovish
39,77, 난망/NNG,116,0.7354423518705296,Dovish
41,86, 소동/NNG,127,0.6922455291756893,Dovish
224,448, 아끼/VV,672,0.7260136037696254,Dovish
102,207, 체납/NNG,309,0.7154916674831091,Dovish
59,114, 금리/NNG;우호적/VAX,173,0.7514877653054016,Dovish
24,50, 수지/NNG;악화/NNG,74,0.6969730596188405,Dovish
8,17, 경제/NNG;여건/NNG;금리/NNG;인상/NNG,25,0.6833069211949414,Dovish
37,71, 객관적으로/MAG,108,0.7566902349148208,Dovish
4657,10274, 부양책/NNG,14931,0.6581750735361389,Dovish
5,12, 통화정책/NNG;방향/NNG;금리/NNG;인하/NNG,17,0.6050113364746877,Dovish
12,30, 성장/NNG;모멘텀/NNG;약화/NNG,42,0.5808108830157004,Dovish
29,77, 리딩/NNG,106,0.5468673898524451,Dovish
29,65, 만기효과/NNG,94,0.6478275233636658,Dovish
31,77, 재심/NNG,108,0.584582382256062,Dovish
25,67, 금리/NNG;인하/NNG;기대/NNG;상승/NNG,92,0.5418011968430041,Dovish
24,48, 위험자산/NNG;회피/NNG;완화/NNG,72,0.7260136037696254,Dovish
27,70, 가격/NNG;상승/NNG;압력/NNG,97,0.560067637193711,Dovish
47,107, 유동성/NNG;개선/NNG,154,0.6378063434985494,Dovish
79,170, 전망/NNG;강화/NNG,249,0.6747655846800048,Dovish
62,130, 절대/MAG;금리/NNG;부담/NNG,192,0.6925052835956428,Dovish
355,891, 도산/NNG,1246,0.5785293587838766,Dovish
870,1736, 금융지원/NNG,2606,0.7276864461746245,Dovish
500,1075, 롱포지션/NNG,1575,0.6753614918787213,Dovish
21,59, 실물/NNG;경제/NNG;부정적/VAX,80,0.5168232433614283,Dovish
19,37, 구조조정/NNG;가속/NNG,56,0.7456355930606964,Dovish
18,47, 연쇄/NNG;도산/NNG,65,0.5560955262916281,Dovish
631,1308, 리보금리/NNG,1939,0.7004810152578496,Dovish
69,175, 배드뱅크/NNG,244,0.5725135846869046,Dovish
33,65, 물의/NNG,98,0.7371830438276197,Dovish
11,27, 글로벌/NNG;신용경색/NNG;완화/NNG,38,0.5915666401085836,Dovish
60,127, 급박/NNG,187,0.6859971059240555,Dovish
13,44, 묘책/NNG,57,0.42900803859114234,Dovish
43,109, 옥/NNG,152,0.5728180726989706,Dovish
17,36, 망할/VV,53,0.6856795146713129,Dovish
389,751, 환영/NNG,1140,0.752115291255351,Dovish
1384,3063, 폐쇄/NNG,4447,0.6560906481339612,Dovish
7,16, 가계/NNG;대출/NNG;부실/NNG;우려/NNG,23,0.6352619032984222,Dovish
16,46, 실물/NNG;경제/NNG;악영향/NNG,62,0.5050529417527828,Dovish
15,39, 경기/NNG;침체/NNG;심각/NNG,54,0.5584720028997118,Dovish
401,864, 신용등급/NNG;상향/NNG,1265,0.6739154053509717,Dovish
566,1145, 금융시장/NNG;안정/NNG,1711,0.7177706545565204,Dovish
10,28, 붕괴/NNG;위험/NNG,38,0.5185811455497324,Dovish
147,284, 침체/NNG;빠지/VV,431,0.7515774630572882,Dovish
122,383, 구제안/NNG,505,0.4625256379106752,Dovish
16,42, 자금시장/NNG;불안/NNG,58,0.5531532219197145,Dovish
76,298, 구제금융안/NNG,374,0.37031566366772845,Dovish
165,346, 외평기금/NNG,511,0.6924407203583133,Dovish
409,784, 꺼리/VV,1193,0.7574988876065735,Dovish
8,22, 불신감/NNG,30,0.5280098936506367,Dovish
5,12, 회사채/NNG;시장/NNG;불안/NNG,17,0.6050113364746877,Dovish
7,21, 실물/NNG;경제/NNG;우려/NNG,28,0.4840090691797503,Dovish
240,695, 부결/NNG,935,0.5014194673516837,Dovish
243,541, 슬/VV,784,0.6522044573605137,Dovish
3053,6259, 협상/NNG,9312,0.708266346799382,Dovish
10,25, 여전/NNG;금리/NNG;인하/NNG,35,0.5808108830157004,Dovish
16,35, 신용위기/NNG;확산/NNG,51,0.6637838663036575,Dovish
43,124, 우려/NNG;점증/NNG,167,0.5035255639047402,Dovish
43,96, 강하/VA;지지/NNG,139,0.6503871867102894,Dovish
39,127, 글로벌/NNG;금리/NNG;인하/NNG,166,0.4458981188506361,Dovish
26,105, 금융위기/NNG;확산/NNG,131,0.35954959424781446,Dovish
37,88, 인하/NNG;추세/NNG,125,0.6105114395335487,Dovish
14,27, 정공법/NNG,41,0.7529029965018337,Dovish
12,36, 인하/NNG;가능성/NNG;배제/NNG,48,0.4840090691797503,Dovish
11,22, 국제/NNG;수지/NNG;악화/NNG,33,0.7260136037696254,Dovish
8,16, 신용경색/NNG;악화/NNG,24,0.7260136037696253,Dovish
6,13, 판매/NNG;실적/NNG;감소/NNG,19,0.6701664034796543,Dovish
158,313, 정책공/NNG,471,0.7329722006108679,Dovish
564,1141, 협조/NNG,1705,0.717741757276194,Dovish
14,35, 희망사항/NNG,49,0.5808108830157003,Dovish
236,570, 대공황/NNG,806,0.6011902122443213,Dovish
533,1036, 대부/NNG,1569,0.7470371637243443,Dovish
4,15, 금융시스템/NNG;붕괴/NNG;막/VV,19,0.3872072553438002,Dovish
8,42, 자금/NNG;경색/NNG;완화/NNG,50,0.27657661095985725,Dovish
17,152, 실물/NNG;경제/NNG;침체/NNG,169,0.16239777979057413,Dovish
9,18, 통화정책/NNG;모멘텀/NNG,27,0.7260136037696254,Dovish
12,29, 신용/NNG;완화/NNG,41,0.6008388444990004,Dovish
346,890, 고점/NNG;저점/NNG,1236,0.5644959705714392,Dovish
291,557, 전례/NNG,848,0.7585994926282261,Dovish
13,28, 수출업체/NNG;네고/NNG;쏟/VV,41,0.6741554892146522,Dovish
19,39, 회사채/NNG;금리/NNG;상승/NNG,58,0.707397870339635,Dovish
450,921, 총회/NNG,1371,0.7094595476576144,Dovish
9,30, 우려/NNG;소폭/MAG;하락/NNG,39,0.43560816226177523,Dovish
12,23, 해동/NNG,35,0.7575794126291744,Dovish
6,14, 경제/NNG;우려/NNG;증폭/NNG,20,0.622297374659679,Dovish
6,33, 실물/NNG;경기/NNG;침체/NNG;우려/NNG,39,0.26400494682531833,Dovish
60,118, 중소기업자금/NNG,178,0.7383189190877547,Dovish
129,250, 퍼져/VV,379,0.7492460390902534,Dovish
261,595, 비전통적/VAX,856,0.636939665828142,Dovish
331,684, 정책금융/NNG,1015,0.7026622890284971,Dovish
87,208, 플/NNG,295,0.6073383031534366,Dovish
472,902, 도로/NNG,1374,0.7598191152533552,Dovish
23,68, 유동성/NNG;완화/NNG,91,0.49112684960886416,Dovish
11,28, 개선/NNG;아니/VCN,39,0.5704392601047057,Dovish
11,27, 외화/NNG;유동성/NNG;개선/NNG,38,0.5915666401085836,Dovish
9,28, 청산결제/NNG,37,0.46672303099475926,Dovish
43,98, 실행계획/NNG,141,0.6371139788182427,Dovish
187,379, 안건/NNG,566,0.7164355878887597,Dovish
8,18, 헤아리/VV,26,0.6453454255730003,Dovish
258,506, 소집/NNG,764,0.740361698705784,Dovish
50,125, 피해기업/NNG,175,0.5808108830157004,Dovish
70,164, 모럴해저드/NNG,234,0.6197677105350462,Dovish
67,133, 깐깐/NNG,200,0.7314723526701488,Dovish
82,179, 올인/NNG,261,0.6651744749621149,Dovish
378,754, 처방/NNG,1132,0.7279393692968658,Dovish
64,150, 강변/NNG,214,0.6195316085500803,Dovish
486,933, 홀로/MAG,1419,0.7563614392969731,Dovish
28,58, 긴급/NNG;금리/NNG;인하/NNG,86,0.7009786519155004,Dovish
6,25, 금융위기/NNG;완화/NNG,31,0.34848652980942024,Dovish
11,27, 채권자금/NNG;이탈/NNG,38,0.5915666401085836,Dovish
80,160, 경제/NNG;저성장/NNG,240,0.7260136037696254,Dovish
10,26, 멍/MAG,36,0.5584720028997119,Dovish
5,23, 자금시장/NNG;경색/NNG;완화/NNG,28,0.3156580885954893,Dovish
42,96, 국고채/NNG;금리/NNG;급등/NNG,138,0.6352619032984221,Dovish
2869,5525, crs/NNG,8394,0.7540029065031874,Dovish
73,153, 위험/NNG;부담/NNG,226,0.6927972951004269,Dovish
41,85, 트리플강세/NNG,126,0.7003895942248152,Dovish
61,133, 우산/NNG,194,0.6659673658638668,Dovish
71,157, 직접지원/NNG,228,0.656649246721572,Dovish
101,209, 누그러지/VV,310,0.7016973586672935,Dovish
25,50, 국고채/NNG;금리/NNG;강세/NNG,75,0.7260136037696254,Dovish
7,16, 더디/VA;개선/NNG,23,0.6352619032984222,Dovish
66,155, 대주단/NNG,221,0.618282552887681,Dovish
46,110, 요법/NNG,156,0.6072113776982321,Dovish
121,244, 들어간다/VV,365,0.7200626725911858,Dovish
173,345, 그야말로/MAG,518,0.7281179910269288,Dovish
1665,3320, 갚/VV,4985,0.728200391732787,Dovish
5,11, 금단/NNG,16,0.6600123670632958,Dovish
70,139, 자본흐름/NNG,209,0.7312367232212055,Dovish
24,46, 명료/NNG,70,0.7575794126291744,Dovish
1193,2297, 대출자/NNG,3490,0.7541438653000985,Dovish
103,221, 최후/NNG,324,0.6767366623372979,Dovish
12,28, 설계자/NNG,40,0.622297374659679,Dovish
11,23, 분별/NNG,34,0.6944477949100765,Dovish
154,318, 저리/MAG,472,0.7031829872988825,Dovish
19,54, 유례없이/MAG,73,0.5108984619119586,Dovish
18,38, 예대비율/NNG,56,0.687802361465961,Dovish
23,54, 완결/NNG,77,0.618456032840792,Dovish
14,31, 도려내/VV,45,0.6557542227596617,Dovish
119,268, 만연/NNG,387,0.6447434242431748,Dovish
700,1580, 부연/NNG,2280,0.6433031932135922,Dovish
53,108, 금리/NNG;인하/NNG;기대/NNG;확산/NNG,161,0.7125689074035212,Dovish
18,47, 자금/NNG;조달/NNG;비용/NNG;줄/VV,65,0.5560955262916281,Dovish
35,72, 자국/NNG;통화/NNG;절하/NNG,107,0.7058465592204692,Dovish
19,52, 은행/NNG;신용위험/NNG,71,0.5305484027547263,Dovish
17,34, 비용/NNG;경감/NNG,51,0.7260136037696254,Dovish
891,2029, 금리/NNG;낮/VV,2920,0.637632450427537,Dovish
7,17, 금리/NNG;하락/NNG;과도/NNG,24,0.5978935560455738,Dovish
59,113, 응찰액/NNG,172,0.7581380995116442,Dovish
9,26, 자금/NNG;유입/NNG;강화/NNG,35,0.5026248026097407,Dovish
76,192, 스텝/NNG,268,0.5747607696509535,Dovish
71,153, 자평/NNG,224,0.6738165472894563,Dovish
3,22, 유례없/VA;금리/NNG;인하/NNG,25,0.19800371011898876,Dovish
4,13, 난데없이/MAG,17,0.44677760231976943,Dovish
22,49, 금리/NNG;인하/NNG;하락/NNG,71,0.6519305829768064,Dovish
12,35, 인하/NNG;기대/NNG;크/VV,47,0.49783789972774317,Dovish
6,13, 채권시장/NNG;인하/NNG,19,0.6701664034796543,Dovish
13,37, 국고채/NNG;급등/NNG,50,0.5101717215678448,Dovish
17,33, 부도설/NNG,50,0.7480140160050687,Dovish
6,13, 신용위험/NNG;부담/NNG,19,0.6701664034796543,Dovish
20,65, 채권안정펀드/NNG,85,0.44677760231976954,Dovish
119,388, 채안펀드/NNG,507,0.44533824148755374,Dovish
16,32,드디어/MAG,48,0.7260136037696253,Dovish
278,542, 명확히/MAG,820,0.744766722686184,Dovish
74,144, 응하/VV,218,0.7461806483187817,Dovish
31,110, 망하/VV,141,0.40920766757924343,Dovish
13,42, 재정/NNG;지출/NNG;증가/NNG,55,0.4494369928097681,Dovish
19,38, 하락/NNG;주춤/NNG,57,0.7260136037696254,Dovish
3,16, 시중/NNG;금리/NNG;내리/VV,19,0.27225510141360953,Dovish
24,56, 국채/NNG;수익률/NNG;급락/NNG,80,0.622297374659679,Dovish
278,800, 디플레이션/NNG;우려/NNG,1078,0.5045794546198896,Dovish
175,391, 최대/NNG;하락/NNG,566,0.6498843000495369,Dovish
9,29, 인하/NNG;부담/NNG,38,0.45062913337425026,Dovish
44,92, 어수선/NNG,136,0.6944477949100765,Dovish
6,21, 고춧가루/NNG,27,0.41486491643978596,Dovish
32,63, 수중/NNG,95,0.7375376292262861,Dovish
11,26, 금리/NNG;인하/NNG;경기/NNG;침체/NNG,37,0.614319203189683,Dovish
14,33, 실물/NNG;경제/NNG;악화/NNG,47,0.6160115425924094,Dovish
7,18, 부도/NNG;위험/NNG;낮/VA,25,0.5646772473763753,Dovish
8,16, 물가/NNG;급락/NNG,24,0.7260136037696253,Dovish
2500,5267, 경기/NNG;부양/NNG,7767,0.6892098004268326,Dovish
75,175, 수출/NNG;급감/NNG,250,0.6222973746596789,Dovish
5,16, 상대매매/NNG,21,0.4537585023560159,Dovish
54,114, 선결/NNG,168,0.6878023614659609,Dovish
9,20, 최대/NNG;제한/NNG,29,0.6534122433926629,Dovish
13,25, 국채선물/NNG;낙폭/NNG;확대/NNG,38,0.7550541479204105,Dovish
5,14, 연방주택대출은행/NNG,19,0.5185811455497324,Dovish
443,987, 환자/NNG,1430,0.6517204183788127,Dovish
10,22, 부의/NNG,32,0.6600123670632958,Dovish
9601,18911, 양적완화/NNG,28512,0.7371854063552613,Dovish
80,160, 대출자금/NNG,240,0.7260136037696254,Dovish
589,1165, 공유/NNG,1754,0.7341150431249945,Dovish
22,49, 금리/NNG;인하/NNG;기대/NNG;강세/NNG,71,0.6519305829768064,Dovish
772,1510, 경상/NNG;수지/NNG;흑자/NNG,2282,0.7423609299472196,Dovish
25,66, 경기/NNG;침체/NNG;가속/NNG,91,0.5500103058860799,Dovish
20,41, 자금/NNG;경색/NNG;우려/NNG,61,0.7083059548971955,Dovish
36,69, 원한다/VV,105,0.7575794126291744,Dovish
26,68, 숨겨진/VV,94,0.55518687347089,Dovish
133,292, 여자/NNG,425,0.6613685568586314,Dovish
204,458, 반토막/NNG,662,0.6467544767205397,Dovish
117,234, 충실히/MAG,351,0.7260136037696253,Dovish
2188,4590, cp/NNG,6778,0.6921646035067278,Dovish
303,579, 우선주/NNG,882,0.7598691604220951,Dovish
7,18, 금리/NNG;인하/NNG;통화/NNG;완화/NNG,25,0.5646772473763753,Dovish
34,73, 자금/NNG;수요/NNG;증가/NNG,107,0.6762866446073224,Dovish
493,991, 국채/NNG;금리/NNG;하락/NNG,1484,0.7223505684327454,Dovish
2,14, 펀더멘털/NNG;좋/VA;않/VX,16,0.20743245821989298,Dovish
22,52, 악화/NNG;일로/NNG;걷/VV,74,0.614319203189683,Dovish
7,30, 디플레이션/NNG;방지/NNG,37,0.3388063484258252,Dovish
5,15, 신용위험/NNG;회피/NNG,20,0.48400906917975023,Dovish
9,38, 흑자/NNG;도산/NNG,47,0.3439011807329805,Dovish
38,74, 수출/NNG;위축/NNG,112,0.7456355930606964,Dovish
64,128, 경기/NNG;방어/NNG,192,0.7260136037696253,Dovish
127,267, 촉매제/NNG,394,0.6906646268070594,Dovish
12,51, 정책/NNG;금리/NNG;인하/NNG,63,0.34165346059747076,Dovish
64,134, 마침/MAG,198,0.6935055319590451,Dovish
19,42,바람/NNG,61,0.6568694510296611,Dovish
5,12, 핑퐁/NNG,17,0.6050113364746877,Dovish
200,510, 단과/NNG,710,0.569422434329118,Dovish
18,37, 등한시/NNG,55,0.7063916144785545,Dovish
5,20, 낫/NNG,25,0.3630068018848127,Dovish
7,16, 계측/NNG,23,0.6352619032984222,Dovish
145,290, 모은/VV,435,0.7260136037696253,Dovish
34,82, 가릴/VV,116,0.6020600616626163,Dovish
87,168, 지준부리/NNG,255,0.751942661047112,Dovish
7,14, 묻어나/VV,21,0.7260136037696254,Dovish
6,25, 금리/NNG;내리/VV;양적완화/NNG,31,0.34848652980942024,Dovish
10,35, 모기지/NNG;금리/NNG;낮/VV,45,0.41486491643978596,Dovish
66,134, 거품/NNG;꺼지/VV,200,0.7151775798327653,Dovish
18,39, 돈/NNG;늘/VV,57,0.6701664034796543,Dovish
208,513, 돈/NNG;풀/VV,721,0.5887361777157196,Dovish
7,14, 국고채/NNG;발행/NNG;확대/NNG,21,0.7260136037696254,Dovish
5,13, 지으/VV,18,0.5584720028997119,Dovish
141,288, 고강/NNG,429,0.7108883203577582,Dovish
200,546, 파격적/VAX,746,0.5318780979997256,Dovish
11,139, 파격적/VAX;금리/NNG;인하/NNG,150,0.11490862793476084,Dovish
26,97, 신용경색/NNG;해소/NNG,123,0.38920316903113944,Dovish
20,57, 바랬/VV,77,0.5094832307155266,Dovish
122,384, 하한선/NNG,506,0.46132114406194946,Dovish
78,234, 유동성함정/NNG,312,0.48400906917975023,Dovish
34,81, 경계선/NNG,115,0.6094929019300559,Dovish
29,61, 국고채/NNG;금리/NNG;인하/NNG,90,0.6903080166989881,Dovish
16,51,한정/NNG,67,0.4555379474632943,Dovish
22,46, 뜻대로/MAG,68,0.6944477949100765,Dovish
55,115, 고생/NNG,170,0.6944477949100765,Dovish
5,20, 회귀분석/NNG,25,0.3630068018848127,Dovish
12,27, 적자예산/NNG,39,0.6453454255730003,Dovish
7,17, 낙찰/NNG;금리/NNG;하락/NNG,24,0.5978935560455738,Dovish
113,231, 경제/NNG;부양/NNG,344,0.7102990236014516,Dovish
28,70, 유동성/NNG;넘/VV,98,0.5808108830157003,Dovish
29,62, 종용/NNG,91,0.6791740164296496,Dovish
17,50, 제로금리/NNG;양적완화/NNG,67,0.49368925056334534,Dovish
30,61, 여력/NNG;확대/NNG,91,0.7141117414127462,Dovish
9,31, 여력/NNG;확충/NNG,40,0.42155628605978257,Dovish
107,205, 은행/NNG;자본/NNG;확충/NNG,312,0.7578873717399992,Dovish
47,93, 연명/NNG,140,0.7338202016596213,Dovish
18,41, 일산/NNG,59,0.637475359407476,Dovish
281,656, 가결/NNG,937,0.6219811666440999,Dovish
10,24, 저점/NNG;떨어/VV,34,0.6050113364746877,Dovish
99,194, 금융협의회/NNG,293,0.7409829564246693,Dovish
57,109, 금리/NNG;밀리/VV,166,0.759316980089333,Dovish
403,813, 이목/NNG,1216,0.7197625641307726,Dovish
14,50, 자금조정예금/NNG,64,0.40656761811099024,Dovish
9,20, 통안채/NNG;발행/NNG;줄/VV,29,0.6534122433926629,Dovish
550,1065, 가이드라인/NNG,1615,0.7498732057714441,Dovish
94,221, 자본주의/NNG,315,0.6176043326185049,Dovish
5,11, 무대응/NNG,16,0.6600123670632958,Dovish
405,806, 합리/NNG,1211,0.7296166489496236,Dovish
8,17, 골라내/VV,25,0.6833069211949414,Dovish
713,1412, 채권단/NNG,2125,0.73321203893448,Dovish
6,13, 죄수의딜레마/NNG,19,0.6701664034796543,Dovish
1,21, 청산대상/NNG,22,0.06914415273996431,Dovish
7,14, 들어갈지/VV,21,0.7260136037696254,Dovish
22,57, 물려/VV,79,0.5604315537870792,Dovish
13,38, 되돌아올/VV,51,0.49674614994763844,Dovish
63,124, 부실여신/NNG,187,0.7377235006046194,Dovish
79,180, 탐욕/NNG,259,0.6372786077533379,Dovish
30,70, 장기보유/NNG,100,0.6222973746596789,Dovish
56,115, 쪼개/VV,171,0.7070741184538961,Dovish
11,40, 생존자/NNG,51,0.3993074820732939,Dovish
2257,5473, 추경/NNG,7730,0.5987987223490022,Dovish
18,41, 일말/NNG,59,0.637475359407476,Dovish
7,15, 빼먹/VV,22,0.6776126968516504,Dovish
6,19, 공급/NNG;과잉/NNG;완화/NNG,25,0.458534907643974,Dovish
6,18, 디플레이션/NNG;억제/NNG,24,0.4840090691797503,Dovish
11,31, 긍정적/VAX;조짐/NNG,42,0.5152354607397341,Dovish
3,15, 구조조정/NNG;어렵/VA,18,0.2904054415078502,Dovish
24,57, 실업/NNG;증가/NNG,81,0.6113798768586319,Dovish
5,24, 신용경색/NNG;풀/VV,29,0.30250566823734387,Dovish
48,92, 경기/NNG;어렵/VA,140,0.7575794126291744,Dovish
1313,2658,물/NNG,3971,0.7172730336715711,Dovish
13,37, 후원자/NNG,50,0.5101717215678448,Dovish
3,15, 신용증권/NNG,18,0.2904054415078502,Dovish
6,15, 국채/NNG;발행/NNG;증가/NNG;우려/NNG,21,0.5808108830157004,Dovish
12,27, 금융시장/NNG;안전자산/NNG;선호/NNG,39,0.6453454255730003,Dovish
221,458, 기정사실/NNG,679,0.700650683113918,Dovish
49,101, 금리/NNG;인하/NNG;양적완화/NNG,150,0.7044488432616167,Dovish
99,250, 통화/NNG;절하/NNG,349,0.5750027741855434,Dovish
121,294, 레인지장세/NNG,415,0.5976030343954059,Dovish
37,76, 뻔하/VA,113,0.7069079826177932,Dovish
705,1813, 타결/NNG,2518,0.5646327530695928,Dovish
7,20, 금리/NNG;많이/MAG;낮/VA,27,0.5082095226387378,Dovish
55,181, 정책/NNG;모멘텀/NNG,236,0.4412237370975624,Dovish
5,15, 금융시장/NNG;신용위험/NNG,20,0.48400906917975023,Dovish
1253,2928, 편성/NNG,4181,0.6213763972153966,Dovish
3,13, 경기/NNG;침체/NNG;확대/NNG,16,0.33508320173982714,Dovish
10,34, 자금시장/NNG;안정/NNG,44,0.42706682574683846,Dovish
5,21, 흔들린다면/VV,26,0.34572076369982163,Dovish
62,125, 장단기구간/NNG,187,0.7202054949394684,Dovish
8,23, 경기/NNG;침체/NNG;금리/NNG;인하/NNG,31,0.5050529417527828,Dovish
12,31, 신용/NNG;위험/NNG,43,0.5620750480797101,Dovish
346,717, 내정자/NNG,1063,0.7006993219087598,Dovish
73,143, 기댈/VV,216,0.7412446583941631,Dovish
9,21, 맞춘다면/VV,30,0.6222973746596789,Dovish
6,28, 경기/NNG;침체/NNG;우려/NNG;증폭/NNG,34,0.3111486873298395,Dovish
34,82, 단기/NNG;금리/NNG;인하/NNG,116,0.6020600616626163,Dovish
11,77, 유동성함정/NNG;빠지/VV,88,0.20743245821989295,Dovish
166,354, 내수/NNG;진작/NNG,520,0.6808941142698182,Dovish
308,599, 처한/VV,907,0.7466183304208502,Dovish
6,23, 이미/MAG;금리/NNG;내리/VV,29,0.3787897063145872,Dovish
187,364, 국채/NNG;금리/NNG;낮/VA,551,0.7459590324446151,Dovish
566,1266, 마이너스성장/NNG,1832,0.6491685619804233,Dovish
50,96, 세계경제포럼/NNG,146,0.7562641705933597,Dovish
47,91, 고육지책/NNG,138,0.749948118179613,Dovish
765,1990, 조작/NNG,2755,0.5581913637022747,Dovish
11,24, 똑/MAG,35,0.6655124701221565,Dovish
43,94, 짓/NNG,137,0.6642252119594445,Dovish
68,131, 즉시/NNG,199,0.753724046661596,Dovish
40,87, 쯤/NNG,127,0.6675987161100003,Dovish
13,49, 돌아간다는/VV,62,0.3852317081226584,Dovish
16,46, 적정선/NNG,62,0.5050529417527828,Dovish
4,13, 회사채/NNG;금리/NNG;떨어/VV,17,0.44677760231976943,Dovish
9,31, 발행/NNG;쉽/VA;않/VX,40,0.42155628605978257,Dovish
36,94, 금리/NNG;내림/NNG,130,0.5560955262916281,Dovish
35,69, 경제/NNG;최악/NNG,104,0.7365355400561417,Dovish
19,37, 인하/NNG;그치/VV,56,0.7456355930606964,Dovish
27,68, 장기물/NNG;상승/NNG,95,0.5765402147582319,Dovish
226,468, 윤/NNG,694,0.7011926258629715,Dovish
203,445, 인사청문회/NNG,648,0.6623854452370066,Dovish
20,41, 뱅/MAG,61,0.7083059548971955,Dovish
39,85, 보였었/VV,124,0.6662242481650681,Dovish
244,526, 재정/NNG;지출/NNG;확대/NNG,770,0.6735639517862684,Dovish
16,37, 압박감/NNG,53,0.6279036573142706,Dovish
38,83, 짤/VV,121,0.6647835408011028,Dovish
81,156, 소비자/NNG;물가/NNG;하락/NNG,237,0.7539372039146109,Dovish
7,31, 수출/NNG;수입/NNG;감소/NNG,38,0.32787711137983083,Dovish
86,171, 뒤이/VV,257,0.7302592973589215,Dovish
130,253, 초안/NNG,383,0.7461009366802474,Dovish
6,13, 지출/NNG;증대/NNG,19,0.6701664034796543,Dovish
4,24, 추경/NNG;우려/NNG,28,0.2420045345898751,Dovish
95,195, 약점/NNG,290,0.707397870339635,Dovish
786,1523, 불리/VV,2309,0.7493718878042358,Dovish
92,230, 노트/NNG,322,0.5808108830157003,Dovish
243,529, 국외/NNG,772,0.6669992654669904,Dovish
29,58, 경기/NNG;회복/NNG;불확실성/NNG,87,0.7260136037696254,Dovish
17,39, 유동성/NNG;불안/NNG,56,0.6329349366196735,Dovish
23,54, 아직/MAG;위험/NNG,77,0.618456032840792,Dovish
15,31, 소비/NNG;상승/NNG,46,0.7025938100996375,Dovish
1768,4082, 디폴트/NNG,5850,0.6289035039023507,Dovish
9,24, 써온/VV,33,0.5445102028272191,Dovish
19,39, 아깝/VA,58,0.707397870339635,Dovish
31,80, 글로벌/NNG;경기/NNG;침체/NNG;우려/NNG,111,0.5626605429214597,Dovish
13,26, 안전자산/NNG;선호/NNG;하락/NNG,39,0.7260136037696254,Dovish
19,42, 선진국/NNG;경기/NNG;침체/NNG,61,0.6568694510296611,Dovish
5,17, 외환시장/NNG;불안정/NNG,22,0.42706682574683846,Dovish
134,475, 디폴트/NNG;우려/NNG,609,0.4096245174952834,Dovish
3,14, 불안정/NNG;위험/NNG,17,0.3111486873298395,Dovish
439,1652,추경/NNG,2091,0.38585953033276704,Dovish
56,233, 증가량/NNG,289,0.3489850799235968,Dovish
4,16, 묻힌/VV,20,0.36300680188481266,Dovish
23,58, 금융시장/NNG;불안/NNG;해소/NNG,81,0.5758038926448753,Dovish
171,450, 글로벌/NNG;경기/NNG;침체/NNG,621,0.5517703388649153,Dovish
68,132, 우려/NNG;약화/NNG,200,0.7480140160050687,Dovish
23,48, 심각/NNG;아니/VCN,71,0.6957630369458909,Dovish
119,300, 국유화/NNG,419,0.5759707923239028,Dovish
16,32, 파산설/NNG,48,0.7260136037696253,Dovish
5,20, 달러원/NNG;하향/NNG;안정/NNG,25,0.3630068018848127,Dovish
7,27, 손절/NNG;압력/NNG,34,0.37645149825091684,Dovish
6,21, 골라서/VV,27,0.41486491643978596,Dovish
120,232, 발길/NNG,352,0.7510485556237504,Dovish
59,137, 고변동성/NNG,196,0.6253255857285824,Dovish
22,44, 탈출구/NNG,66,0.7260136037696254,Dovish
54,122, 고민거리/NNG,176,0.6427005672714716,Dovish
572,1214, 금융투자/NNG,1786,0.6841512048702235,Dovish
8,16, 동과/NNG,24,0.7260136037696253,Dovish
70,135, 위도/NNG,205,0.7529029965018338,Dovish
23,54, 무용/NNG,77,0.618456032840792,Dovish
282,541, 무조건/MAG,823,0.7568792468134357,Dovish
37,83, 너도나도/MAG,120,0.6472892370958107,Dovish
16,35, 비합리/NNG,51,0.6637838663036575,Dovish
10,20, 측간/NNG,30,0.7260136037696254,Dovish
11,31, 소나/NNG,42,0.5152354607397341,Dovish
47,126, 유리보/NNG,173,0.5416291964630539,Dovish
17,41, 글로벌/NNG;디플레이션/NNG;우려/NNG,58,0.6020600616626163,Dovish
9,21, 채권시장/NNG;수급/NNG;부담/NNG,30,0.6222973746596789,Dovish
6,13, 금융시장/NNG;규제/NNG;강화/NNG,19,0.6701664034796543,Dovish
9,20, 마이너스/NNG;하향/NNG,29,0.6534122433926629,Dovish
14,30, 많/VA;부담/NNG,44,0.6776126968516504,Dovish
30,104, 채권국/NNG,134,0.41885400217478386,Dovish
12,33, 건지/VV,45,0.5280098936506367,Dovish
69,156, 장기물/NNG;금리/NNG;상승/NNG,225,0.6422428033346687,Dovish
35,102, 소매/NNG;판매/NNG;호조/NNG,137,0.4982446300379782,Dovish
3,15, 판매/NNG;소폭/MAG;증가/NNG,18,0.2904054415078502,Dovish
8,20, 기대/NNG;환율/NNG;하락/NNG,28,0.5808108830157003,Dovish
6,15, 역작용/NNG,21,0.5808108830157004,Dovish
78,162, 청사진/NNG,240,0.6991242110374171,Dovish
9,22, 추경/NNG;부담/NNG,31,0.5940111303569663,Dovish
9,20, 끌어가/VV,29,0.6534122433926629,Dovish
21,41, 에둘러/VV,62,0.7437212526420554,Dovish
103,208, 공개시장/NNG,311,0.719032703733379,Dovish
17,39, 뜻밖에/MAG,56,0.6329349366196735,Dovish
3,13, 저울/NNG,16,0.33508320173982714,Dovish
4,12, 맡/NNG,16,0.4840090691797502,Dovish
45,93, 정부보증채/NNG,138,0.7025938100996374,Dovish
6,16, 고여/VV,22,0.5445102028272191,Dovish
10,22, 산업/NNG;생산/NNG;하락/NNG,32,0.6600123670632958,Dovish
4,22, 발행/NNG;수요/NNG;줄/VV,26,0.26400494682531833,Dovish
166,335, 정치/NNG;위험/NNG,501,0.7195119894075093,Dovish
30,62, 생산/NNG;감축/NNG,92,0.7025938100996375,Dovish
15,42, 보여준다면/VV,57,0.5185811455497324,Dovish
16,33, 준용/NNG,49,0.7040131915341822,Dovish
734,1534,파운드/NNG,2268,0.6947770341159126,Dovish
11,24, 하락/NNG;상쇄/NNG,35,0.6655124701221565,Dovish
17,102, 베어마켓/NNG,119,0.24200453458987514,Dovish
66,153, 수입/NNG;물가/NNG;하락/NNG,219,0.6263646777620296,Dovish
5,13, 자금/NNG;조달/NNG;증가/NNG,18,0.5584720028997119,Dovish
4,15, 원달러/NNG;고점/NNG,19,0.3872072553438002,Dovish
6,17, 채권시장/NNG;좋/VA,23,0.5124801908962061,Dovish
43,127,추경안/NNG,170,0.4916312592455731,Dovish
14,28, 여태/MAG,42,0.7260136037696254,Dovish
16,31, 짓눌려/VV,47,0.7494333974396133,Dovish
6,17, 부추키/VV,23,0.5124801908962061,Dovish
88,185, 구름/NNG,273,0.6906940230456977,Dovish
3,14, 나쁜데/VA,17,0.3111486873298395,Dovish
59,117, 공론/NNG,176,0.7322188482462888,Dovish
5,11, 펼친다는/VV,16,0.6600123670632958,Dovish
143,292, 살짝/MAG,435,0.7110955160209345,Dovish
3,15, 깨끗이/MAG,18,0.2904054415078502,Dovish
65,138, 빨간/VA,203,0.68392585862356,Dovish
4,13, 산분/NNG,17,0.44677760231976943,Dovish
8,17, 윤전기/NNG,25,0.6833069211949414,Dovish
17,40, 동태/NNG,57,0.6171115632041816,Dovish
2792,5545, 딜러/NNG,8337,0.7311199212713414,Dovish
307,622, 적수/NNG,929,0.7166758082227492,Dovish
16,34, 지수/NNG;상승/NNG;하락/NNG,50,0.6833069211949414,Dovish
6,18, 미약/NNG;긍정적/VAX,24,0.4840090691797503,Dovish
4,15, 여력/NNG;작/VA,19,0.3872072553438002,Dovish
296,599, 나올지/VV,895,0.7175293045602976,Dovish
44,86, 예상/NNG;개선/NNG,130,0.7428976410665934,Dovish
4,19, 시중/NNG;유동성/NNG;풀/VV,23,0.30568993842931597,Dovish
9,19, 안정/NNG;기대/NNG;높/VA,28,0.687802361465961,Dovish
52,124, 지켜냈/VV,176,0.6089146354196858,Dovish
6,17, 보험기관/NNG,23,0.5124801908962061,Dovish
62,119, 예금이자/NNG,181,0.7565183770372568,Dovish
34,95, 끝난다/VV,129,0.5196728953298372,Dovish
138,286, 미/NNG;국채/NNG;금리/NNG;상승/NNG,424,0.7006285127287295,Dovish
21,66, 초장기물/NNG;금리/NNG;하락/NNG,87,0.46200865694430704,Dovish
22,53, 어우러지/VV,75,0.6027282748276136,Dovish
12,32, 들뜬/VV,44,0.5445102028272191,Dovish
30,74, 완화정책/NNG;효과/NNG,104,0.5886596787321287,Dovish
31,63, 미래/NNG;불확실성/NNG,94,0.7144895783129647,Dovish
10,29, 정책/NNG;불안/NNG,39,0.5006990370825003,Dovish
73,177, 부실/NNG;위험/NNG,250,0.5988586788156233,Dovish
7,39, 여력/NNG;늘/VV,46,0.26062026801986554,Dovish
69,163, 놀랄/VV,232,0.6146618240503577,Dovish
9,21, 돛/NNG,30,0.6222973746596789,Dovish
15,33, 매끄럽/VA,48,0.6600123670632958,Dovish
75,159, 권장/NNG,234,0.6849184941222881,Dovish
16,33, 임금/NNG;감소/NNG,49,0.7040131915341822,Dovish
20,42, 별다른/VA;모멘텀/NNG;없/VA,62,0.6914415273996433,Dovish
113,235, 만남/NNG,348,0.698208827455044,Dovish
68,131, 소명/NNG,199,0.753724046661596,Dovish
45,86, 사용량/NNG,131,0.7597816783635614,Dovish
15,34, 통안채/NNG;금리/NNG;낮/VA,49,0.6406002386202576,Dovish
92,276, 국채교환/NNG,368,0.48400906917975023,Dovish
128,251, 인접/NNG,379,0.7404760261554745,Dovish
165,365, 숏플레이/NNG,530,0.6563958609424011,Dovish
13,25, 감상/NNG,38,0.7550541479204105,Dovish
12,25, 움직여도/VV,37,0.6969730596188405,Dovish
188,401, 자영업/NNG,589,0.6807509102677783,Dovish
35,80, 무턱대고/MAG,115,0.6352619032984222,Dovish
10,41, 자도/NNG,51,0.35415297744859775,Dovish
28,58, 내수/NNG;경기/NNG;침체/NNG,86,0.7009786519155004,Dovish
14,30, 물가/NNG;금융안정/NNG,44,0.6776126968516504,Dovish
5,11, 회복/NNG;최대/NNG,16,0.6600123670632958,Dovish
59,115, 수출/NNG;성장/NNG,174,0.7449530890853547,Dovish
9,31, 수요/NNG;침체/NNG,40,0.42155628605978257,Dovish
5,15, 여긴/VV,20,0.48400906917975023,Dovish
16,32, 안정화/NNG;조짐/NNG,48,0.7260136037696253,Dovish
30,64, 허물/VV,94,0.6806377535340238,Dovish
9,29, 뻔히/MAG,38,0.45062913337425026,Dovish
7,20, 이익/NNG;훼손/NNG,27,0.5082095226387378,Dovish
4,14, 바닥/NNG;지지/NNG,18,0.41486491643978596,Dovish
23,45, 왕복/NNG,68,0.7421472394089503,Dovish
7,15, 달리기/NNG,22,0.6776126968516504,Dovish
77,165, 원점/NNG,242,0.6776126968516504,Dovish
5,11, 급락/NNG;기술적/VAX;상승/NNG,16,0.6600123670632958,Dovish
33,93, 경기/NNG;회복/NNG;미약/NNG,126,0.515235460739734,Dovish
11,25, 미약/NNG;성장/NNG,36,0.6388919713172704,Dovish
215,442, 공언/NNG,657,0.7063028271966943,Dovish
28,60, 기약/NNG,88,0.6776126968516504,Dovish
827,1630,소매/NNG,2457,0.7367033746226751,Dovish
47,118, 소매/NNG;판매/NNG;감소/NNG,165,0.5783498199520745,Dovish
50,97, 마이너스성장률/NNG,147,0.7484676327521912,Dovish
96,186, 위험/NNG;없/VA,282,0.7494333974396133,Dovish
723,1437, 꼽힌다/VV,2160,0.730560661830813,Dovish
11,34, 되돌아간/VV,45,0.46977350832152226,Dovish
69,139, 금리/NNG;매우/MAG;낮/VA,208,0.7207904843180454,Dovish
8,16, 소비/NNG;살/VV;않/VX,24,0.7260136037696253,Dovish
178,348, 주택시장/NNG;회복/NNG,526,0.7427035716723753,Dovish
24,49, 약화/NNG;하락/NNG,73,0.7111969996110616,Dovish
13,32, 채권/NNG;확보/NNG,45,0.5898860530628207,Dovish
111,234, 예상/NNG;작/VA,345,0.6887821369096445,Dovish
7,22, 실물/NNG;경기/NNG;하락/NNG,29,0.4620086569443071,Dovish
27,58, 갇혔/VV,85,0.6759437000613754,Dovish
13,34, 가격/NNG;낙폭/NNG;줄/VV,47,0.55518687347089,Dovish
14,28, 부동산/NNG;바닥/NNG,42,0.7260136037696254,Dovish
6,14, 채권/NNG;듀레이션/NNG;축소/NNG,20,0.622297374659679,Dovish
16,57, 산업/NNG;생산/NNG;상승/NNG,73,0.4075865845724212,Dovish
347,718, 잉여/NNG,1065,0.7017457395767688,Dovish
15,30, 경제/NNG;금리/NNG;오르/VV,45,0.7260136037696253,Dovish
11,26, 어렵/VA;불확실성/NNG,37,0.614319203189683,Dovish
538,1045, 기대/NNG;크/VV,1583,0.7475508494316908,Dovish
5,13, 가격/NNG;낙폭/NNG;축소/NNG,18,0.5584720028997119,Dovish
8,17, 푼다는/VV,25,0.6833069211949414,Dovish
25,52, 퍼붓/VV,77,0.6980900036246398,Dovish
6,12, 진체/NNG,18,0.7260136037696254,Dovish
52,157, 로켓/NNG,209,0.48092620886650345,Dovish
9,20, 냉온/NNG,29,0.6534122433926629,Dovish
64,127, 증식/NNG,191,0.7317302463189925,Dovish
5,12, 쫓아내/VV,17,0.6050113364746877,Dovish
899,1794, 만나/VV,2693,0.7276323631983203,Dovish
41,109, 뿌리/VV,150,0.5461753716432045,Dovish
7,24, 무능력/NNG,31,0.42350793553228144,Dovish
13,29, 자생/NNG,42,0.6509087482072504,Dovish
16,55, 디플레이션/NNG;경기/NNG;침체/NNG,71,0.4224079149205093,Dovish
6,14, 디플레이션/NNG;압력/NNG;완화/NNG,20,0.622297374659679,Dovish
11,25, 가격/NNG;상승/NNG;하락/NNG,36,0.6388919713172704,Dovish
121,239, 자산/NNG;가격/NNG;하락/NNG,360,0.735126745239537,Dovish
26,69, 심각/NNG;경기/NNG;침체/NNG,95,0.5471406868988481,Dovish
56,125, 자산/NNG;가격/NNG;오르/VV,181,0.6505081889775843,Dovish
15,36, 원자재/NNG;급등/NNG,51,0.6050113364746877,Dovish
5,12, 저축/NNG;증대/NNG,17,0.6050113364746877,Dovish
5,11, 주택/NNG;안정/NNG,16,0.6600123670632958,Dovish
15,44, 거품/NNG;없/VA,59,0.49500927529747185,Dovish
56,111, 담보/NNG;잡/VV,167,0.732554266866649,Dovish
3,16, 형벌/NNG,19,0.27225510141360953,Dovish
116,259, 악성/NNG,375,0.6503287879326374,Dovish
8,19, 누누이/MAG,27,0.6113798768586319,Dovish
49,121, 담보채권/NNG,170,0.5880110179291181,Dovish
26,64, 외국인/NNG;투자자금/NNG;이탈/NNG,90,0.5898860530628207,Dovish
47,113, 국채/NNG;금리/NNG;안정/NNG,160,0.6039405199499538,Dovish
12,34, 실업자/NNG;증가/NNG,46,0.5124801908962061,Dovish
120,230, 수요/NNG;위축/NNG,350,0.7575794126291744,Dovish
21,44, 엄밀히/MAG,65,0.6930129854164606,Dovish
29,58, 변동성/NNG;과도/NNG,87,0.7260136037696254,Dovish
7,19, 하단/NNG;낮/VA,26,0.5349573922513029,Dovish
168,351, 오버나이트/NNG,519,0.6949873813863081,Dovish
16,36, 금리/NNG;인상/NNG;기대/NNG;완화/NNG,52,0.6453454255730003,Dovish
5,19, 위직/NNG,24,0.38211242303664494,Dovish
15,54, 디플레이션/NNG;우려/NNG;완화/NNG,69,0.4033408909831252,Dovish
8,27, 미약/NNG;개선/NNG,35,0.4302302837153335,Dovish
374,852, 입찰자/NNG,1226,0.6373922249057274,Dovish
70,197, 경제/NNG;성장률/NNG;하향/NNG,267,0.5159487539479573,Dovish
6,12, 가격/NNG;단기/NNG;급락/NNG,18,0.7260136037696254,Dovish
12,23,해석/NNG,35,0.7575794126291744,Dovish
9,20, 더/VV,29,0.6534122433926629,Dovish
53,121, 공화국/NNG,174,0.6360119173519033,Dovish
20,63, 비극/NNG,83,0.4609610182664288,Dovish
136,269, 장소/NNG,405,0.7341104097596213,Dovish
7,16, 빨려/VV,23,0.6352619032984222,Dovish
39,86, 써서/VV,125,0.6584774545817532,Dovish
63,139, 가짜/NNG,202,0.6581130508990849,Dovish
101,238, 동료/NNG,339,0.6161964200061527,Dovish
262,526, 모/NNG,788,0.7232530957705013,Dovish
17,33, 돈/NNG;많이/MAG;풀/VV,50,0.7480140160050687,Dovish
82,160, 대외/NNG;충격/NNG,242,0.744163943863866,Dovish
157,360, 집값/NNG;오르/VV,517,0.6332451988435066,Dovish
44,86,미채권/NNG,130,0.7428976410665934,Dovish
11,34, 하락/NNG;압력/NNG;줄/VV,45,0.46977350832152226,Dovish
88,173, 코앞/NNG,261,0.7386034350488675,Dovish
13,29, 싸울/VV,42,0.6509087482072504,Dovish
13,32, 예상/NNG;못하/VX;충격/NNG,45,0.5898860530628207,Dovish
21,67, 기업/NNG;실적/NNG;악화/NNG;우려/NNG,88,0.4551130053481234,Dovish
163,377, 연차/NNG,540,0.6277995618803658,Dovish
3265,7386, 비둘기/NNG,10651,0.6418723033598231,Dovish
10,26, 주택가격/NNG;높/VA,36,0.5584720028997119,Dovish
26,62, 손가락/NNG,88,0.6089146354196858,Dovish
12,24, 가리켰/VV,36,0.7260136037696254,Dovish
371,714, 엔유로/NNG,1085,0.7544847254860813,Dovish
89,186, 당한/VV,275,0.6947872122096415,Dovish
8,24, 경기/NNG;우려/NNG;확산/NNG,32,0.4840090691797502,Dovish
11,22, 급락/NNG;환율/NNG;급등/NNG,33,0.7260136037696254,Dovish
43,104, 사리/VV,147,0.6003574031171902,Dovish
12,51, 국의/NNG,63,0.34165346059747076,Dovish
11,30, 흔들려/VV,41,0.5324099760977252,Dovish
64,123, 비상사태/NNG,187,0.7555263518903418,Dovish
6,17, 순저/NNG,23,0.5124801908962061,Dovish
20,49, 글로벌/NNG;금융시장/NNG;안전자산/NNG;선호/NNG,69,0.5926641663425514,Dovish
27,62, 경기/NNG;활력/NNG,89,0.6323344290896737,Dovish
11,22, 금리/NNG;양호/NNG,33,0.7260136037696254,Dovish
319,951, 매입세/NNG,1270,0.48706275415880235,Dovish
100,284, 일어/NNG,384,0.5112771857532573,Dovish
72,141, 기고문/NNG,213,0.7414607017221706,Dovish
21,43, 부작용/NNG;막/VV,64,0.7091295664726573,Dovish
27,65, 방조/NNG,92,0.6031497631316889,Dovish
139,333, 원고/NNG,472,0.6061014469908584,Dovish
25,55, 전망/NNG;부진/NNG,80,0.6600123670632958,Dovish
622,1529, 오퍼/NNG,2151,0.5906873270695971,Dovish
686,1433, 비드/NNG,2119,0.6951086283125792,Dovish
7,18, 실망/NNG;않/VX,25,0.5646772473763753,Dovish
9,18, 소모적/NNG,27,0.7260136037696254,Dovish
7,17, 겸허히/MAG,24,0.5978935560455738,Dovish
28,62, 보증도/NNG,90,0.6557542227596617,Dovish
493,1028, 외화자금/NNG,1521,0.6963515693743684,Dovish
335,693, 공간/NNG,1028,0.7019179141784258,Dovish
6,20, 외화자금/NNG;시장/NNG;안정/NNG,26,0.43560816226177523,Dovish
19,45, 많/VA;금리/NNG;인하/NNG,64,0.6130781542943504,Dovish
7,14, 발행설/NNG,21,0.7260136037696254,Dovish
8,20, 하락/NNG;혼조/NNG,28,0.5808108830157003,Dovish
17,35, 부진/NNG;금리/NNG;상승/NNG,52,0.7052703579476362,Dovish
21,44, 회의감/NNG,65,0.6930129854164606,Dovish
24,59, 롱마인드/NNG,83,0.5906551352702037,Dovish
6,21, 엑시트/NNG,27,0.41486491643978596,Dovish
252,489, 특이/NNG,741,0.7482839597134789,Dovish
499,967, 독립성/NNG,1466,0.749288083311361,Dovish
21,51, 오른쪽/NNG,72,0.5978935560455738,Dovish
6,14, 최고위층/NNG,20,0.622297374659679,Dovish
21,44, 바뀐다면/VV,65,0.6930129854164606,Dovish
129,285, 정책조합/NNG,414,0.6572333676230293,Dovish
5,13, 꺼뜨리/VV,18,0.5584720028997119,Dovish
5,14, 유가/NNG;상승/NNG;환율/NNG;하락/NNG,19,0.5185811455497324,Dovish
11,23, 경기/NNG;전망/NNG;불확실/NNG,34,0.6944477949100765,Dovish
51,103, 금리/NNG;인하/NNG;없/VA,154,0.7189649280048718,Dovish
8,17, 높/VA;가능성/NNG;크/VV,25,0.6833069211949414,Dovish
9,21, 금융시장/NNG;압박/NNG,30,0.6222973746596789,Dovish
63,139, 완화/NNG;효과/NNG,202,0.6581130508990849,Dovish
12,25, 하락/NNG;경고/NNG,37,0.6969730596188405,Dovish
7,14, 지출/NNG;둔화/NNG,21,0.7260136037696254,Dovish
4,17, 수주/NNG;약화/NNG,21,0.3416534605974707,Dovish
256,509, 부양/NNG;효과/NNG,765,0.7302926623380122,Dovish
20,51, 지준/NNG;증가/NNG,71,0.5694224343291179,Dovish
4,19, 통화/NNG;축소/NNG,23,0.30568993842931597,Dovish
19,37, 지준/NNG;감소/NNG,56,0.7456355930606964,Dovish
169,349, 경제/NNG;활력/NNG,518,0.7031306535075456,Dovish
17,33, 많/VA;상승/NNG,50,0.7480140160050687,Dovish
120,233, 거쳐야/VV,353,0.7478251712648503,Dovish
19,50, 한시름/NNG,69,0.5517703388649153,Dovish
66,171, 국민주택채권/NNG,237,0.5604315537870792,Dovish
9,26, 침체/NNG;끝/NNG,35,0.5026248026097407,Dovish
140,285, 전부/NNG,425,0.7132765230017373,Dovish
4,13, 안다는/VV,17,0.44677760231976943,Dovish
84,166, 지우/VV,250,0.7347607556222715,Dovish
9,26, 좋/VA;금리/NNG;인하/NNG,35,0.5026248026097407,Dovish
17,38, 밀려오/VV,55,0.6495911191622965,Dovish
16,33, 미동/NNG,49,0.7040131915341822,Dovish
25,54, 경기/NNG;침체/NNG;벗어나/VV,79,0.6722348183052087,Dovish
59,131, 소매/NNG;판매/NNG;부진/NNG,190,0.6539664522505022,Dovish
253,488, 고점/NNG;높/VV,741,0.7527927940726035,Dovish
13,38, 녀/NNG,51,0.49674614994763844,Dovish
10,33, 재역전/NNG,43,0.44000824470886385,Dovish
7,18, 대출/NNG;수요/NNG;확대/NNG,25,0.5646772473763753,Dovish
4,12, 불안/NNG;부담/NNG,16,0.4840090691797502,Dovish
73,161, 어렵/VA;우려/NNG,234,0.6583725847848778,Dovish
93,225, 착한/VA,318,0.6001712457828903,Dovish
18,49, 머문다면/VV,67,0.5333977497082962,Dovish
117,256, 공황/NNG,373,0.6636218096956732,Dovish
410,789, 소규모/NNG,1199,0.7545388530939072,Dovish
15,44, 릴/NNG,59,0.49500927529747185,Dovish
4,12, 팀플레이/NNG,16,0.4840090691797502,Dovish
19,40, 결단력/NNG,59,0.6897129235811441,Dovish
6,13, 늘어지/VV,19,0.6701664034796543,Dovish
4,12, 발행/NNG;부담/NNG;줄/VV,16,0.4840090691797502,Dovish
30,79, 실적/NNG;좋/VA;않/VX,109,0.5514027370402218,Dovish
36,78, 금융위기/NNG;충격/NNG,114,0.6701664034796543,Dovish
15,38, 경색/NNG;완화/NNG,53,0.5731686345549674,Dovish
9,21, 금리/NNG;안전자산/NNG;선호/NNG,30,0.6222973746596789,Dovish
152,357, 재수주/NNG,509,0.6182300715573281,Dovish
7,17, 신용등급/NNG;전망/NNG;부정적/VAX;안정/NNG;상향/NNG,24,0.5978935560455738,Dovish
5,15, 낮/VA;인식/NNG;확산/NNG,20,0.48400906917975023,Dovish
27,63, 겁먹/VV,90,0.6222973746596789,Dovish
38,73, 가져갔/VV,111,0.7558497792670074,Dovish
26,60, 판매/NNG;급감/NNG,86,0.6292117899336753,Dovish
158,334, 국채선물/NNG;강세/NNG,492,0.6868871221293462,Dovish
239,465, 금리/NNG;인상/NNG;늦/VV,704,0.7463107582836149,Dovish
93,200,확장/NNG,293,0.6751926515057516,Dovish
25,55, 경청/NNG,80,0.6600123670632958,Dovish
6,12, 여겨왔/VV,18,0.7260136037696254,Dovish
17,38, 진짜/NNG,55,0.6495911191622965,Dovish
7,17, 진짜로/MAG,24,0.5978935560455738,Dovish
93,184, 신규물/NNG,277,0.7339050559845126,Dovish
99,210, 일반회계/NNG,309,0.6845271121256468,Dovish
63,121, 아우르/VV,184,0.7560141659088662,Dovish
45,91, 갖춰져/VV,136,0.7180354322996295,Dovish
26,51, 출구전략/NNG;금리/NNG;인상/NNG,77,0.7402491646278533,Dovish
8,25, 실물/NNG;경제/NNG;긍정적/VAX,33,0.46464870641256023,Dovish
14,30, 투자/NNG;매력/NNG;줄/VV,44,0.6776126968516504,Dovish
6,17, 채권/NNG;증가/NNG,23,0.5124801908962061,Dovish
150,326, 금리/NNG;최저/NNG,476,0.6681106783156062,Dovish
33,67, 시안/NNG,100,0.7151775798327653,Dovish
4,14, 가계/NNG;대출/NNG;증가/NNG;억제/NNG,18,0.41486491643978596,Dovish
17,53, 차스닥/NNG,70,0.465744576003156,Dovish
75,282, 키코/NNG,357,0.38617744881363053,Dovish
15,33, 연산/NNG,48,0.6600123670632958,Dovish
34,82, 정관/NNG,116,0.6020600616626163,Dovish
8,18, 출구전략/NNG;우려/NNG;완화/NNG,26,0.6453454255730003,Dovish
6278,12210, 전장/NNG,18488,0.7465869622384451,Dovish
21,46, 장마/VV,67,0.6628819860505275,Dovish
18,46, 민사소송/NNG,64,0.5681845594718807,Dovish
4,20, 구조조정/NNG;한파/NNG,24,0.29040544150785014,Dovish
18968,37448,fed/NNG,56416,0.7354745800204152,Dovish
19,42, 주택시장/NNG;불안/NNG,61,0.6568694510296611,Dovish
33,73, 전동차/NNG,106,0.656395860942401,Dovish
12,24, 호된/VA,36,0.7260136037696254,Dovish
21,55, 댐/NNG,76,0.5544103883331685,Dovish
7,14, 유역/NNG,21,0.7260136037696254,Dovish
40,99, 실망/NNG;하락/NNG,139,0.5866776596118185,Dovish
19,50, 창업판/NNG,69,0.5517703388649153,Dovish
11,33, 위험/NNG;회피/NNG;확산/NNG,44,0.48400906917975023,Dovish
15,43, 유로달러/NNG;급락/NNG,58,0.506521118909041,Dovish
6,12, 헷갈려/VV,18,0.7260136037696254,Dovish
24,48, 거슬러/VV,72,0.7260136037696254,Dovish
96,217, 사회안전망/NNG,313,0.6423714835196686,Dovish
29,71, 빚내/VV,100,0.5930815354737784,Dovish
78,153, 이성/NNG,231,0.7402491646278534,Dovish
79,204, 내몰리/VV,283,0.562304653900004,Dovish
153,317, 성장전략/NNG,470,0.7008207026924459,Dovish
654,1362, 소통/NNG,2016,0.6972289234439575,Dovish
842,1770, 제로/NNG,2612,0.6907383665243215,Dovish
6,12, 달했었/VV,18,0.7260136037696254,Dovish
23,60, 절실히/MAG,83,0.5566104295567127,Dovish
31,63, 오리무중/NNG,94,0.7144895783129647,Dovish
65,172, 분포도/NNG,237,0.548731212151461,Dovish
5,17, 화세/NNG,22,0.42706682574683846,Dovish
38,92, 학대/NNG,130,0.5997503683314297,Dovish
35,70, 경제/NNG;불확실성/NNG;크/VV,105,0.7260136037696254,Dovish
4,12, 다원화/NNG;약세/NNG,16,0.4840090691797502,Dovish
16,36, 많이/MAG;완화/NNG,52,0.6453454255730003,Dovish
36,72, 낮/VA;위험/NNG,108,0.7260136037696254,Dovish
15,47, 나타낼지/VV,62,0.4634129385763566,Dovish
67,150, 발등/NNG,217,0.6485721527008653,Dovish
6,14, 해운선사/NNG,20,0.622297374659679,Dovish
330,841, 신축/NNG,1171,0.5697609732318106,Dovish
10,34, 예상/NNG;상회/NNG;상승/NNG,44,0.42706682574683846,Dovish
20,41, 신용등급/NNG;긍정적/VAX,61,0.7083059548971955,Dovish
68,140, 결정권/NNG,208,0.7052703579476362,Dovish
53,111, 나눌/VV,164,0.6933102882845071,Dovish
17,34, 후광/NNG,51,0.7260136037696254,Dovish
20,48, 덕목/NNG,68,0.6050113364746877,Dovish
166,425, 하한/NNG,591,0.5671447445918015,Dovish
7,16, 펄펄/MAG,23,0.6352619032984222,Dovish
26,71, 연구팀/NNG,97,0.5317282731833876,Dovish
69,152, 바이러스/NNG,221,0.6591439297382126,Dovish
21,43, 부동산/NNG;우려/NNG,64,0.7091295664726573,Dovish
15,34, 포도/NNG,49,0.6406002386202576,Dovish
52,100, 받아들인/VV,152,0.7550541479204105,Dovish
21,42, 소폭/MAG;상승/NNG;그치/VV,63,0.7260136037696254,Dovish
12,25,중기물/NNG,37,0.6969730596188405,Dovish
86,208, 원도/NNG,294,0.6003574031171902,Dovish
32,64, 알려짐/VV,96,0.7260136037696253,Dovish
112,237, 재가동/NNG,349,0.6861900727611648,Dovish
7,27, 오송/NNG,34,0.37645149825091684,Dovish
17,36, 자산재평가/NNG,53,0.6856795146713129,Dovish
29,57, 피소/NNG,86,0.7387506845375135,Dovish
30,70, 낙관론/NNG;확산/NNG,100,0.6222973746596789,Dovish
16,31, 금리/NNG;인상/NNG;멀/VA,47,0.7494333974396133,Dovish
15,33, 상영/NNG,48,0.6600123670632958,Dovish
27,60, 묵인/NNG,87,0.6534122433926628,Dovish
71,140, 매매전략/NNG,211,0.7363852266806201,Dovish
18,48, 금리선물/NNG;시장/NNG;fed/NNG;금리/NNG;인상/NNG,66,0.5445102028272191,Dovish
128,246, 배출/NNG,374,0.7555263518903418,Dovish
25,67, 비유통주/NNG,92,0.5418011968430041,Dovish
63,176, 롱처분/NNG,239,0.5197597390623455,Dovish
170,347, 리더/NNG,517,0.7113677962007856,Dovish
14,66, 액면분할/NNG,80,0.3080057712962047,Dovish
150,312, 전기차/NNG,462,0.6980900036246398,Dovish
1842,3836, opec/NNG,5678,0.6972455986150417,Dovish
12,25, 매출/NNG;예상/NNG;하회/NNG,37,0.6969730596188405,Dovish
191,498, 국감/NNG,689,0.5569020012851343,Dovish
70,150, 유감/NNG,220,0.6776126968516504,Dovish
134,290, 체이스/NNG,424,0.6709367096905503,Dovish
316,620, 홍/NNG,936,0.7400654799716182,Dovish
243,486, 난/VV,729,0.7260136037696253,Dovish
35,76, 경기/NNG;회복/NNG;기대/NNG;높/VV,111,0.6686967403141287,Dovish
99,217, 해안/NNG,316,0.6624455923796583,Dovish
13,29, 밀물/NNG,42,0.6509087482072504,Dovish
85,182, 투어/NNG,267,0.6781445749496501,Dovish
41,89, 섭/NNG,130,0.668911410214711,Dovish
9,28, 지급보/NNG,37,0.46672303099475926,Dovish
5,30, 본안/NNG,35,0.24200453458987511,Dovish
68,155, 지하/NNG,223,0.6370183878236714,Dovish
40,87, 블랙베리/NNG,127,0.6675987161100003,Dovish
35,75, 치킨게임/NNG,110,0.6776126968516504,Dovish
56,143, 쇄도/NNG,199,0.5686260393160703,Dovish
677,1340, 들어왔/VV,2017,0.7335988205254275,Dovish
23,44, 베이시스/NNG;확대/NNG,67,0.7590142221227901,Dovish
7,25, 외환시장/NNG;흔들/VV,32,0.40656761811099024,Dovish
18,77, 척/MAG,95,0.3394349316325521,Dovish
99,227, 프랜차이즈/NNG,326,0.6332629671646953,Dovish
11,32, 아리랑/NNG,43,0.4991343525916174,Dovish
24,66, 집단/NNG;대출/NNG;증가/NNG,90,0.5280098936506367,Dovish
19,37, 실적/NNG;예상/NNG;부진/NNG,56,0.7456355930606964,Dovish
22,44, 위기/NNG;끝/NNG,66,0.7260136037696254,Dovish
422,1223, 담합/NNG,1645,0.5010265589383187,Dovish
508,1054, 중견/NNG,1562,0.6998385402561096,Dovish
242,576, 파고/NNG,818,0.6100530976119769,Dovish
52,102, 항소/NNG,154,0.7402491646278533,Dovish
1286,2531, 하락/NNG;압력/NNG,3817,0.7377743930839495,Dovish
858,1652, 실업보험/NNG,2510,0.7541400387824923,Dovish
997,2016, 청구자/NNG,3013,0.7180908362681712,Dovish
8,22, 금리/NNG;환율/NNG;상승/NNG,30,0.5280098936506367,Dovish
55,144, 대외/NNG;여건/NNG;악화/NNG,199,0.5545937251017972,Dovish
10,35, 가격/NNG;저점/NNG,45,0.41486491643978596,Dovish
257,500, 영/NNG,757,0.746341984675175,Dovish
24,84, 희소성/NNG,108,0.41486491643978596,Dovish
18,36, 쌓일/VV,54,0.7260136037696254,Dovish
9,25, 출모/NNG,34,0.5227297947141304,Dovish
9,20, 채권시장/NNG;외국인/NNG;이탈/NNG,29,0.6534122433926629,Dovish
7,26, 부정적/VAX;전환/NNG,33,0.3909304020297983,Dovish
75,152, 울상/NNG,227,0.7164607931937094,Dovish
515,1083, 자금난/NNG,1598,0.6904838521539375,Dovish
13,27, 두께/NNG,40,0.6991242110374171,Dovish
12,29, 코아/NNG,41,0.6008388444990004,Dovish
33,64, 대중화/NNG,97,0.7487015288874261,Dovish
57,135, 거품/NNG;우려/NNG,192,0.6130781542943503,Dovish
117,229, 엘/NNG,346,0.7418654291794425,Dovish
12,24, 소비/NNG;심리/NNG;부진/NNG,36,0.7260136037696254,Dovish
48,95, 공동개발/NNG,143,0.7336558522303583,Dovish
57,112, 피아/NNG,169,0.7389781324083687,Dovish
133,316, 폐업/NNG,449,0.6111380335529125,Dovish
60,139, 위험/NNG;거래/NNG;증가/NNG,199,0.6267743341896046,Dovish
25,58, 경제/NNG;펀더멘털/NNG;개선/NNG,83,0.6258737963531253,Dovish
34,65, 성장/NNG;가능성/NNG;높/VA,99,0.7595219239436083,Dovish
69,182, 오너/NNG,251,0.5504938314297161,Dovish
1062,2403, 의혹/NNG,3465,0.6417198894742757,Dovish
12,26, 살아난다/VV,38,0.6701664034796543,Dovish
71,152, 공동주택/NNG,223,0.6782495508900449,Dovish
78,242, 최대/NNG;감소/NNG,320,0.46800876937215524,Dovish
11,33, 파산/NNG;우려/NNG,44,0.48400906917975023,Dovish
5,12, 지수/NNG;넘/VV;상승/NNG,17,0.6050113364746877,Dovish
5,12, 국제기관/NNG,17,0.6050113364746877,Dovish
65,128, 덫/NNG,193,0.7373575663285258,Dovish
240,475, 바꿨/VV,715,0.7336558522303583,Dovish
20,48, 안전자산/NNG;선호/NNG;확대/NNG,68,0.6050113364746877,Dovish
12,27, 경제/NNG;강하/VA;회복/NNG,39,0.6453454255730003,Dovish
8,39, 수익/NNG;위험/NNG,47,0.2978517348798463,Dovish
12,26, 채권/NNG;넘/VV,38,0.6701664034796543,Dovish
57,113, 폭주/NNG,170,0.7324385029180291,Dovish
37,82, 햇/XSV,119,0.6551830082799059,Dovish
41,115, 방문객/NNG,156,0.5176792652966025,Dovish
5,11, 미분/NNG,16,0.6600123670632958,Dovish
26,53, 유동성/NNG;축소/NNG;우려/NNG,79,0.7123152338871797,Dovish
13,31, 은행/NNG;실적/NNG;악화/NNG,44,0.6089146354196858,Dovish
11,28, 동업/NNG,39,0.5704392601047057,Dovish
889,2002, 오피스텔/NNG,2891,0.6447813124387582,Dovish
25,72, 족쇄/NNG,97,0.5041761137289066,Dovish
19,47, 회계장부/NNG,66,0.5869897221967184,Dovish
31,61, 유동성/NNG;공급/NNG;늘/VV,92,0.7379154661265046,Dovish
517,993, 경제/NNG;활성화/NNG,1510,0.7559899962716946,Dovish
5,17, 금융위기/NNG;재발/NNG;막/VV,22,0.42706682574683846,Dovish
69,180, 유가/NNG;하락/NNG;압력/NNG,249,0.5566104295567129,Dovish
97,203, 야구/NNG,300,0.6938258085286076,Dovish
8,19, 가론/NNG,27,0.6113798768586319,Dovish
134,273, 활용도/NNG,407,0.7127166513196321,Dovish
7,17, 강제력/NNG,24,0.5978935560455738,Dovish
22,45, 둔갑/NNG,67,0.7098799681303004,Dovish
33,74, 직행/NNG,107,0.6475256466053415,Dovish
8,31, 유신/NNG,39,0.3747166987198067,Dovish
786,1727, 런던/NNG,2513,0.6608531471487268,Dovish
2,14, 양제/NNG,16,0.20743245821989298,Dovish
5,17, 약속어음/NNG,22,0.42706682574683846,Dovish
163,335, 그/VV,498,0.7065087606832773,Dovish
152,413, 우수기업/NNG,565,0.5344022652444701,Dovish
72,246, 와인/NNG,318,0.42498357293831734,Dovish
37,76, 이색/NNG,113,0.7069079826177932,Dovish
20,54, 유가/NNG;하락/NNG;제한/NNG,74,0.5377878546441669,Dovish
13,47, 수입/NNG;급감/NNG,60,0.40162454676617576,Dovish
59,151, 시한폭탄/NNG,210,0.5673483791047403,Dovish
17,41, 의향서/NNG,58,0.6020600616626163,Dovish
128,316, 해임/NNG,444,0.5881629195095699,Dovish
38,75, 도분/NNG,113,0.7356937851532204,Dovish
98,204,상당기간/NNG,302,0.6975424820531695,Dovish
16,35, 채권보상/NNG,51,0.6637838663036575,Dovish
113,218, 원유/NNG;재고/NNG;감소/NNG,331,0.7526563048253915,Dovish
5,13, 저점/NNG;깨/VV;내리/VV,18,0.5584720028997119,Dovish
123,314, 비자금/NNG,437,0.5687877277940377,Dovish
5,11, 순손실/NNG;적자전환/NNG,16,0.6600123670632958,Dovish
63,138, 소득/NNG;줄/VV,201,0.6628819860505275,Dovish
5,11, 접/NNG,16,0.6600123670632958,Dovish
33,84, 양안/NNG,117,0.5704392601047056,Dovish
6,17, 금유/NNG,23,0.5124801908962061,Dovish
102,197,장막/NNG,299,0.7518110414670234,Dovish
29,59, 억대/NNG,88,0.7137082884514961,Dovish
5,12, 텅텅/MAG,17,0.6050113364746877,Dovish
10,26, 비어/NNG,36,0.5584720028997119,Dovish
15,38, 해저/NNG,53,0.5731686345549674,Dovish
12,44, 유연탄/NNG,56,0.3960074202379775,Dovish
44,86, 벌인다/VV,130,0.7428976410665934,Dovish
62,127, 고쳐/VV,189,0.7088636761215241,Dovish
52,100, 통화옵션/NNG,152,0.7550541479204105,Dovish
21,57, 조달청/NNG,78,0.5349573922513029,Dovish
12,26, 흥/NNG,38,0.6701664034796543,Dovish
14,28, 예금채권/NNG,42,0.7260136037696254,Dovish
25,50, 자산운용업/NNG,75,0.7260136037696254,Dovish
37,89, 소득세법/NNG,126,0.6036517604376661,Dovish
30,84, 정직/NNG,114,0.5185811455497324,Dovish
7,22, 돌려서/VV,29,0.4620086569443071,Dovish
23,45, 소비/NNG;부양/NNG,68,0.7421472394089503,Dovish
11,28, 특채/NNG,39,0.5704392601047057,Dovish
314,630, 전담/NNG,944,0.7237087986782932,Dovish
41,90, 연비/NNG,131,0.6614790612123254,Dovish
7,20, 취학/NNG,27,0.5082095226387378,Dovish
11,23, 소자/NNG,34,0.6944477949100765,Dovish
42,84, 모씨/NNG,126,0.7260136037696254,Dovish
126,302, 횡령/NNG,428,0.6058126759931973,Dovish
25,51, 마늘/NNG,76,0.7117780429113975,Dovish
1481,3013, 차액결제선물환/NNG,4494,0.7137246247479689,Dovish
8,19, 파산법원/NNG,27,0.6113798768586319,Dovish
15,37, 황/MAG,52,0.5886596787321287,Dovish
25,73, 부채/NNG;상환/NNG;유예/NNG,98,0.49726959162303114,Dovish
70,223,바이/NNG,293,0.45579329384640166,Dovish
8,19, 곤두세운/VV,27,0.6113798768586319,Dovish
737,1450, 진전/NNG,2187,0.7380303806596055,Dovish
23,51, 마스터/NNG,74,0.6548357994784856,Dovish
52,106, 상보/NNG,158,0.7123152338871797,Dovish
5,34, 디폴트/NNG;우려/NNG;완화/NNG,39,0.21353341287341923,Dovish
133,309,방/NNG,442,0.6249825844748231,Dovish
53,119, 소임/NNG,172,0.646701193273784,Dovish
29,63, 양태/NNG,92,0.6683934764863217,Dovish
37,84, 골몰/NNG,121,0.63958341284467,Dovish
39,79, 변해/VV,118,0.7168235581522884,Dovish
11,22, 사이드/NNG,33,0.7260136037696254,Dovish
4,18, 깍/VV,22,0.32267271278650017,Dovish
4,14, 날까/VV,18,0.41486491643978596,Dovish
35,122, 마진콜/NNG,157,0.41656518249076874,Dovish
11,22, 친다/VV,33,0.7260136037696254,Dovish
6,12, 맞춰온/VV,18,0.7260136037696254,Dovish
126,244, 운명/NNG,370,0.7498173284833837,Dovish
8,21, 내가격/NNG,29,0.5531532219197145,Dovish
9,55, 튤립/NNG,64,0.2376044521427865,Dovish
83,184, 잃어버린/VV,267,0.6549905338356403,Dovish
140,276, 충격파/NNG,416,0.7365355400561417,Dovish
20,41, 아르/NNG,61,0.7083059548971955,Dovish
15,39, 금리/NNG;인상/NNG;우려/NNG;확산/NNG,54,0.5584720028997118,Dovish
6,22, 민간/NNG;소비/NNG;확대/NNG,28,0.3960074202379775,Dovish
7,28, 경기/NNG;침체/NNG;회복/NNG,35,0.3630068018848127,Dovish
11,26, 이자/NNG;지급/NNG;부담/NNG,37,0.614319203189683,Dovish
13,27, 경제/NNG;심리/NNG;개선/NNG,40,0.6991242110374171,Dovish
23,55, 글로벌/NNG;침체/NNG,78,0.6072113776982321,Dovish
47,95, 주택/NNG;거품/NNG,142,0.7183713553088924,Dovish
13,25, 과도/NNG;부담/NNG,38,0.7550541479204105,Dovish
14,28, 자본/NNG;줄/VV,42,0.7260136037696254,Dovish
14,28, 가격/NNG;줄/VV,42,0.7260136037696254,Dovish
11,22, 위협/NNG;없/VA,33,0.7260136037696254,Dovish
39,109, 펜/NNG,148,0.5195326705874383,Dovish
24,65, 직급/NNG,89,0.5361331227837235,Dovish
66,134, 해외/NNG;투자/NNG;확대/NNG,200,0.7151775798327653,Dovish
5,11, 성장/NNG;전망/NNG;성장/NNG,16,0.6600123670632958,Dovish
29,71, 안정성/NNG;강화/NNG,100,0.5930815354737784,Dovish
100,194,차익실현/NNG,294,0.7484676327521912,Dovish
12,25, 경기/NNG;회복/NNG;약하/VA,37,0.6969730596188405,Dovish
15,30, 조이/NNG,45,0.7260136037696253,Dovish
17,45, 행정소송/NNG,62,0.5485436117370504,Dovish
52,108, 불사/NNG,160,0.6991242110374171,Dovish
1345,2679, 불황/NNG,4024,0.7289946226727482,Dovish
15,45, 경총/NNG,60,0.48400906917975023,Dovish
1321,3978, 탈퇴/NNG,5299,0.48218399727484923,Dovish
75,149, 합작/NNG,224,0.7308861782915692,Dovish
224,436, 조합원/NNG,660,0.7459956295614499,Dovish
15,37, 기대/NNG;회복/NNG,52,0.5886596787321287,Dovish
10,25, 지수/NNG;악화/NNG,35,0.5808108830157004,Dovish
5,15, 사외이사제도/NNG,20,0.48400906917975023,Dovish
4,19, 층간/NNG,23,0.30568993842931597,Dovish
25,85, 소음/NNG,110,0.4270668257468385,Dovish
10,38, 위험자산/NNG;회피/NNG;강화/NNG,48,0.38211242303664494,Dovish
43,98, 고용/NNG;충격/NNG,141,0.6371139788182427,Dovish
64,125, 위조/NNG,189,0.7434379302600964,Dovish
6,18, 고소장/NNG,24,0.4840090691797503,Dovish
42,122, 경질/NNG,164,0.49987821898892243,Dovish
9,19,용지/NNG,28,0.687802361465961,Dovish
129,251, 국토/NNG,380,0.7462609951098143,Dovish
4,12, 플래닝/NNG,16,0.4840090691797502,Dovish
14,27, 하락/NNG;안전자산/NNG;선호/NNG,41,0.7529029965018337,Dovish
9,22, 흥청망청/MAG,31,0.5940111303569663,Dovish
18,138, 정관변경/NNG,156,0.1893948531572936,Dovish
5,12, 청과/NNG,17,0.6050113364746877,Dovish
8,16, 원유/NNG;수입/NNG;감소/NNG,24,0.7260136037696253,Dovish
21,47, 신용등급/NNG;전망/NNG;안정/NNG;부정적/VAX;하향/NNG,68,0.6487781140068993,Dovish
59,137, 세계/NNG;경제/NNG;불안/NNG,196,0.6253255857285824,Dovish
46,100, 매달/NNG,146,0.6679325154680553,Dovish
193,369, 나와야/VV,562,0.759461384973104,Dovish
157,361, 배후/NNG,518,0.6314910570184553,Dovish
13,33, 클로징/NNG,46,0.572010718121523,Dovish
12,25, 자금/NNG;확대/NNG,37,0.6969730596188405,Dovish
9,21, 설립안/NNG,30,0.6222973746596789,Dovish
297,570, 공모주/NNG,867,0.756582597612557,Dovish
16,94, 구제계획/NNG,110,0.24715356724072354,Dovish
4,12, 전망/NNG;상향/NNG;상승/NNG,16,0.4840090691797502,Dovish
17,72,롤오버/NNG,89,0.34283975733565647,Dovish
47,131, 현금배당/NNG,178,0.5209563263690442,Dovish
264,582, 국채/NNG;가격/NNG;상승/NNG,846,0.6586515168219281,Dovish
210,406, 고용시장/NNG;개선/NNG,616,0.7510485556237505,Dovish
113,266, 달러원/NNG;급등/NNG,379,0.6168386257591554,Dovish
11,36, 시프트/NNG,47,0.44367498008143774,Dovish
5,17, 부도날/VV,22,0.42706682574683846,Dovish
92,188, 보호주의/NNG,280,0.7105665058170801,Dovish
56,125, 폐막/NNG,181,0.6505081889775843,Dovish
104,221, 쿼드러플위칭데이/NNG,325,0.6833069211949416,Dovish
83,191, 랜드마크/NNG,274,0.6309856451610357,Dovish
29,75, 세계/NNG;경제/NNG;위험/NNG,104,0.5614505202485103,Dovish
4,19, 우려/NNG;소폭/MAG;상승/NNG,23,0.30568993842931597,Dovish
25,74, 따질/VV,99,0.4905497322767739,Dovish
45,96, 동떨어진/VV,141,0.6806377535340237,Dovish
13,34, 경기/NNG;약세/NNG,47,0.55518687347089,Dovish
5,14, 기웃/MAG,19,0.5185811455497324,Dovish
85,178, 최다/NNG,263,0.6933837788811029,Dovish
576,1331, 산유량/NNG,1907,0.6283754106255511,Dovish
25,52, 예상/NNG;넘/VV;호조/NNG,77,0.6980900036246398,Dovish
44,88, 빚더미/NNG,132,0.7260136037696254,Dovish
78,221, 순이익/NNG;줄/VV,299,0.5124801908962062,Dovish
61,146, 금융지주회사/NNG,207,0.606668901780098,Dovish
43,88, 언론인/NNG,131,0.709513294593043,Dovish
13,38, 내구재/NNG;수주/NNG;증가/NNG,51,0.49674614994763844,Dovish
10,44, 원회/NNG,54,0.3300061835316479,Dovish
10,36, 겨/NNG,46,0.4033408909831252,Dovish
21,42, 노린다/VV,63,0.7260136037696254,Dovish
42,89, 배당락/NNG,131,0.6852263226589722,Dovish
10,31, 금명간/NNG,41,0.46839587339975836,Dovish
5,19, 채권시장/NNG;국채/NNG;금리/NNG;상승/NNG,24,0.38211242303664494,Dovish
8,17, 전망/NNG;힘입/VV;상승/NNG,25,0.6833069211949414,Dovish
60,118, 장내거래/NNG,178,0.7383189190877547,Dovish
76,148, 움직여야/VV,224,0.7456355930606964,Dovish
35,75, 차인/VV,110,0.6776126968516504,Dovish
36,79, 금리/NNG;인상/NNG;기대/NNG;높/VV,115,0.6616832844482663,Dovish
6,16, 자금/NNG;시중/NNG;풀/VV,22,0.5445102028272191,Dovish
66,133, 인플레이션/NNG;하락/NNG,199,0.7205548548691018,Dovish
7,24, 우려/NNG;시기상조/NNG,31,0.42350793553228144,Dovish
22,49, 석화/NNG,71,0.6519305829768064,Dovish
65,138, 게이트/NNG,203,0.68392585862356,Dovish
15,44, 전문경영인/NNG,59,0.49500927529747185,Dovish
123,240, 민자사업/NNG,363,0.7441639438638661,Dovish
7,28, 차석/NNG,35,0.3630068018848127,Dovish
4,15, 화기/NNG,19,0.3872072553438002,Dovish
10,26, 일관제철소/NNG,36,0.5584720028997119,Dovish
19,49, 유가/NNG;원유/NNG;재고/NNG;증가/NNG,68,0.5630309580254238,Dovish
8,29, 성수/NNG,37,0.4005592296660002,Dovish
6,15, 물량/NNG;쏟/VV;하락/NNG,21,0.5808108830157004,Dovish
54,109, 지친/VV,163,0.7193529285056839,Dovish
40,85, 재취업/NNG,125,0.6833069211949416,Dovish
20,54, 스티프닝/NNG;압력/NNG,74,0.5377878546441669,Dovish
8,21, 금리/NNG;억제/NNG,29,0.5531532219197145,Dovish
5,13, 건설/NNG;감소/NNG,18,0.5584720028997119,Dovish
15,58, 입찰액/NNG,73,0.3755242778118752,Dovish
9,23, 낭보/NNG,32,0.5681845594718807,Dovish
5,12, 성실공시/NNG,17,0.6050113364746877,Dovish
5,24, 청도/NNG,29,0.30250566823734387,Dovish
77,175, 개량/NNG,252,0.6388919713172704,Dovish
11,24, 안전통화/NNG;선호/NNG,35,0.6655124701221565,Dovish
19,39, 단지도/VA,58,0.707397870339635,Dovish
56,115, 내려졌/VV,171,0.7070741184538961,Dovish
19,39, 실적/NNG;기대/NNG;높/VA,58,0.707397870339635,Dovish
69,199, 세계/NNG;경기/NNG;둔화/NNG;우려/NNG,268,0.5034667202020519,Dovish
3,13, 가현/NNG,16,0.33508320173982714,Dovish
119,230, 사망자/NNG,349,0.7512662508572645,Dovish
50,114, 조합장/NNG,164,0.6368540383944082,Dovish
37,87, 출전/NNG,124,0.6175288124017504,Dovish
305,686, 농가/NNG,991,0.6455806097659934,Dovish
11,25, 지역난방/NNG,36,0.6388919713172704,Dovish
12,26, 늘려라/VV,38,0.6701664034796543,Dovish
8,16, 오자/NNG,24,0.7260136037696253,Dovish
10,24, 경영전략회의/NNG,34,0.6050113364746877,Dovish
14,30, 마틴루터킹데이/NNG,44,0.6776126968516504,Dovish
59,134, 위례/NNG,193,0.6393254122747447,Dovish
56,116, 밀착/NNG,172,0.7009786519155004,Dovish
11,22, 기대/NNG;증시/NNG;강세/NNG,33,0.7260136037696254,Dovish
7,14, 메사/NNG,21,0.7260136037696254,Dovish
14,27, 실적/NNG;부진/NNG;급락/NNG,41,0.7529029965018337,Dovish
17,38, 매출/NNG;신장/NNG,55,0.6495911191622965,Dovish
20,56, 인하/NNG;압박/NNG,76,0.5185811455497324,Dovish
128,254, 광역/NNG,382,0.7317302463189925,Dovish
301,582, 협력사/NNG,883,0.750962524861365,Dovish
5,11, 수율/NNG,16,0.6600123670632958,Dovish
15,47, 합의서/NNG,62,0.4634129385763566,Dovish
26,59, 차역/NNG,85,0.6398763965427208,Dovish
9,24, 획/NNG,33,0.5445102028272191,Dovish
5,12, 대출/NNG;프로그램/NNG;확대/NNG,17,0.6050113364746877,Dovish
14,30, 유가/NNG;증시/NNG;강세/NNG,44,0.6776126968516504,Dovish
172,362, 변동성지수/NNG,534,0.6899134798252794,Dovish
9,19, 세계/NNG;경기/NNG;회복/NNG;둔화/NNG,28,0.687802361465961,Dovish
15,34, 글로벌/NNG;주식시장/NNG;상승/NNG,49,0.6406002386202576,Dovish
6,18, 회사채/NNG;시장/NNG;살/VV,24,0.4840090691797503,Dovish
77,182, 반성/NNG,259,0.614319203189683,Dovish
136,297, 경제/NNG;위험/NNG,433,0.664901347560061,Dovish
187,441, 위기극복/NNG,628,0.6157122172558728,Dovish
36,72, 소매점/NNG,108,0.7260136037696254,Dovish
7,16, 채권/NNG;빠지/VV,23,0.6352619032984222,Dovish
307,618, 협정/NNG,925,0.721314486593123,Dovish
22,70, 증가수/NNG,92,0.4563514080837645,Dovish
5,13, 저점/NNG;인식/NNG;강하/VA,18,0.5584720028997119,Dovish
718,1399, 원장/NNG,2117,0.7452148213103518,Dovish
7,15, 신규/NNG;주택/NNG;판매/NNG;부진/NNG,22,0.6776126968516504,Dovish
52,124, 예상/NNG;약하/VA,176,0.6089146354196858,Dovish
79,151, 시초가/NNG,230,0.7596698635470253,Dovish
20,48, 국채선물/NNG;가격/NNG;하락/NNG;압력/NNG,68,0.6050113364746877,Dovish
21,48, 재수/NNG,69,0.6352619032984221,Dovish
20,51, 주실/NNG,71,0.5694224343291179,Dovish
93,205, 강연회/NNG,298,0.6587245380543918,Dovish
10,21, 경제/NNG;부진/NNG;우려/NNG,31,0.6914415273996433,Dovish
39,95, 국채/NNG;금리/NNG;급락/NNG,134,0.5960953799371661,Dovish
4,13, 성장/NNG;최저/NNG,17,0.44677760231976943,Dovish
40,79, 따랐/VV,119,0.7352036493869625,Dovish
104,224, 구입자금/NNG,328,0.6741554892146522,Dovish
162,342, 디딤돌/NNG,504,0.687802361465961,Dovish
5,16, 동의어/NNG,21,0.4537585023560159,Dovish
6,19, 손바닥/NNG,25,0.458534907643974,Dovish
26,50, 금리/NNG;인상/NNG;우호적/VAX,76,0.7550541479204105,Dovish
19,40, 채권/NNG;거품/NNG,59,0.6897129235811441,Dovish
6,14, 임금/NNG;떨어/VV,20,0.622297374659679,Dovish
5,14, 신규/NNG;주문/NNG;감소/NNG,19,0.5185811455497324,Dovish
31,69, 가계/NNG;부채/NNG;줄/VV,100,0.6523600497640113,Dovish
6,18, 고용/NNG;활성화/NNG,24,0.4840090691797503,Dovish
9,24, 이자/NNG;상승/NNG,33,0.5445102028272191,Dovish
110,277, 부동산/NNG;활성화/NNG,387,0.5766173026329154,Dovish
797,1754, 리보/NNG,2551,0.6597865931635021,Dovish
16,34, 출발선/NNG,50,0.6833069211949414,Dovish
13,29, 위기/NNG;확대/NNG,42,0.6509087482072504,Dovish
23,58, 기업/NNG;재고/NNG;증가/NNG,81,0.5758038926448753,Dovish
22,48, 우회전/NNG,70,0.6655124701221565,Dovish
9,31, 경기/NNG;변동성/NNG;확대/NNG,40,0.42155628605978257,Dovish
139,276, 소비/NNG;부진/NNG,415,0.7312745719128835,Dovish
388,750, 고용/NNG;증가/NNG,1138,0.7511820753669723,Dovish
170,344, 불발/NNG,514,0.7175715851211414,Dovish
47,104, 자국/NNG;통화/NNG;약세/NNG,151,0.6562046034071614,Dovish
4,13, 미/NNG;국채시장/NNG;강세/NNG,17,0.44677760231976943,Dovish
48,113, 지수/NNG;약세/NNG,161,0.6167903182467614,Dovish
1027,2172, 노동시장/NNG,3199,0.6865708757563586,Dovish
116,230, 노동시장/NNG;개선/NNG,346,0.7323267655415352,Dovish
32,62, 열거/NNG,94,0.7494333974396133,Dovish
965,1983, bis/NNG,2948,0.7066093067450212,Dovish
27,60, 단칸/NNG,87,0.6534122433926628,Dovish
8,23, 재무/NNG;건전성/NNG;우려/NNG,31,0.5050529417527828,Dovish
63,133, 원리금/NNG;상환/NNG;부담/NNG,196,0.6878023614659609,Dovish
8,17, 기업/NNG;비용/NNG;증가/NNG,25,0.6833069211949414,Dovish
4,18, 순수출/NNG;감소/NNG,22,0.32267271278650017,Dovish
99,210, 경기/NNG;진작/NNG,309,0.6845271121256468,Dovish
12,28, 금리/NNG;역사적/VAX;저점/NNG,40,0.622297374659679,Dovish
102,296, 중간선거/NNG,398,0.5003607269223094,Dovish
27,54, 빠짐없이/MAG,81,0.7260136037696253,Dovish
18,37, 숨가쁘/VA,55,0.7063916144785545,Dovish
43,84, 교감/NNG,127,0.7432996419546165,Dovish
25,64, 의문시/NNG,89,0.5671981279450199,Dovish
5,11, 가격/NNG;급등/NNG;상승/NNG,16,0.6600123670632958,Dovish
10,23, 가격/NNG;부진/NNG,33,0.6313161771909785,Dovish
14,30, 어렵/VA;성장/NNG,44,0.6776126968516504,Dovish
17,36, 양적완화/NNG;금리/NNG;인하/NNG,53,0.6856795146713129,Dovish
58,158, 통화전쟁/NNG,216,0.5330226458055478,Dovish
26,52, 공공자금관리기금/NNG,78,0.7260136037696254,Dovish
22,45, 불통/NNG,67,0.7098799681303004,Dovish
8,16, crs/NNG;금리/NNG;내리/VV,24,0.7260136037696253,Dovish
7,14, 구조적/VAX;침체/NNG,21,0.7260136037696254,Dovish
6,13, 기대/NNG;제한적/VAX,19,0.6701664034796543,Dovish
4,19, 위험/NNG;작/VV,23,0.30568993842931597,Dovish
12,30, 비판/NNG;많/VA,42,0.5808108830157004,Dovish
16,32, 주문/NNG;줄/VV,48,0.7260136037696253,Dovish
2535,5021,고용/NNG,7556,0.7330987793491338,Dovish
514,1054, 배당금/NNG,1568,0.7081043497866936,Dovish
4,15, 수요/NNG;경계/NNG,19,0.3872072553438002,Dovish
7,21, 기대/NNG;늘/VV,28,0.4840090691797503,Dovish
5,11, 이탈/NNG;가능성/NNG;크/VV,16,0.6600123670632958,Dovish
36,75,소통/NNG,111,0.6969730596188404,Dovish
6,14, 상방/NNG;위험/NNG;하방/NNG;위험/NNG,20,0.622297374659679,Dovish
6,13, 직진/NNG,19,0.6701664034796543,Dovish
85,181, 내수/NNG;살/VV,266,0.6818912300598692,Dovish
19,37, 금리/NNG;인상/NNG;서두/NNG;필요/NNG;없/VA,56,0.7456355930606964,Dovish
3,20, 뒷면/NNG,23,0.21780408113088762,Dovish
4,13, 역내/NNG;성장/NNG,17,0.44677760231976943,Dovish
5,12, 정책/NNG;불확실/NNG,17,0.6050113364746877,Dovish
11,24, 양적완화/NNG;불확실성/NNG,35,0.6655124701221565,Dovish
8,17, 비예금성부채/NNG,25,0.6833069211949414,Dovish
57,122, 거리/XSV,179,0.6784061543421089,Dovish
59,128, 사용료/NNG,187,0.6692937909751234,Dovish
114,221, 논평/NNG,335,0.7490095097713783,Dovish
62,160, 산업/NNG;생산/NNG;감소/NNG,222,0.5626605429214597,Dovish
10,26, 스티프닝/NNG;되돌/VV,36,0.5584720028997119,Dovish
6,18, 주문/NNG;급감/NNG,24,0.4840090691797503,Dovish
5,27, 통화/NNG;절하/NNG;자제/NNG,32,0.26889392732208345,Dovish
10,31, 실효수익률/NNG,41,0.46839587339975836,Dovish
13,38, 공멸/NNG,51,0.49674614994763844,Dovish
56,114, 독특/NNG,170,0.7132765230017372,Dovish
9,18, 카운터/NNG,27,0.7260136037696254,Dovish
115,265, 힐/NNG,380,0.630125014592505,Dovish
11,24, 성장/NNG;부담/NNG,35,0.6655124701221565,Dovish
9,21, 성장/NNG;마이너스/NNG,30,0.6222973746596789,Dovish
13,30, 변동성/NNG;안정/NNG,43,0.6292117899336753,Dovish
7,15, 채권시장/NNG;낮/VA,22,0.6776126968516504,Dovish
7,16, 출경/NNG,23,0.6352619032984222,Dovish
115,233, 인플레이션/NNG;낮/VA,348,0.7166657891288148,Dovish
36,71, 손발/NNG,107,0.7362391474846905,Dovish
4,19, 뿌리치/VV,23,0.30568993842931597,Dovish
8,16, 경제/NNG;활동/NNG;부진/NNG,24,0.7260136037696253,Dovish
6,14, 금리/NNG;상단/NNG;지지/NNG,20,0.622297374659679,Dovish
13,29, 경제/NNG;장기/NNG;침체/NNG,42,0.6509087482072504,Dovish
14,34, 우려/NNG;발목/NNG;잡/VV,48,0.5978935560455738,Dovish
5,12, 회복/NNG;불씨/NNG;살/VV,17,0.6050113364746877,Dovish
28,61, 이자비용/NNG;감소/NNG,89,0.6665042919852299,Dovish
6,17, 가격/NNG;충격/NNG,23,0.5124801908962061,Dovish
5,16, 둔화/NNG;우려/NNG;완화/NNG,21,0.4537585023560159,Dovish
97,206, 얼굴/NNG,303,0.6837215491811036,Dovish
714,1937, 엔저/NNG,2651,0.5352335705642877,Dovish
47,108, 사회기반시설/NNG,155,0.6319007292068961,Dovish
1173,2511, 현물환/NNG,3684,0.6783066166640945,Dovish
14,30, 커지/NNG,44,0.6776126968516504,Dovish
53,131, 조망/NNG,184,0.5874613893097732,Dovish
9,19, 자전거래/NNG,28,0.687802361465961,Dovish
3,14, 채등/NNG,17,0.3111486873298395,Dovish
15,31, 전반기/NNG,46,0.7025938100996375,Dovish
10,24, 양적완화/NNG;경기/NNG;부양/NNG,34,0.6050113364746877,Dovish
4,12, 금융위기/NNG;경기/NNG;회복/NNG,16,0.4840090691797502,Dovish
15,41, 재정/NNG;건전성/NNG;훼손/NNG,56,0.5312294661728967,Dovish
8,34, 장기물/NNG;발행/NNG;축소/NNG,42,0.3416534605974707,Dovish
28,56, 자국/NNG;통화/NNG;하락/NNG,84,0.7260136037696254,Dovish
14,30, 작/VA;않/VX;부담/NNG,44,0.6776126968516504,Dovish
7,30, 글로벌/NNG;금융안정/NNG,37,0.3388063484258252,Dovish
288,584, 양적완화/NNG;종료/NNG,872,0.7160682119371649,Dovish
11,23, 유동성/NNG;이탈/NNG,34,0.6944477949100765,Dovish
18,41, 내수/NNG;확충/NNG,59,0.637475359407476,Dovish
73,171, 지출/NNG;확대/NNG,244,0.619871264037224,Dovish
6,16, 통화/NNG;선호/NNG,22,0.5445102028272191,Dovish
34,69, 수입/NNG;확대/NNG,103,0.7154916674831091,Dovish
22,43, 수출/NNG;부양/NNG,65,0.7428976410665934,Dovish
17,37, 수요/NNG;안정/NNG,54,0.6671476358964126,Dovish
9,18, 통화/NNG;높/VA,27,0.7260136037696254,Dovish
71,137, 초읽기/NNG,208,0.7525104506225315,Dovish
64,134, 관리자/NNG,198,0.6935055319590451,Dovish
171,338, 자민/NNG,509,0.7346054807373132,Dovish
12,23, 채권/NNG;수요/NNG;늘/VV,35,0.7575794126291744,Dovish
150,293, 자본/NNG;통제/NNG,443,0.7433586386719714,Dovish
18,44, 하락/NNG;넘/VV,62,0.5940111303569663,Dovish
26,54, 용자/NNG,80,0.6991242110374171,Dovish
58,122, 수일/NNG,180,0.6903080166989881,Dovish
55,108, 추진계획/NNG,163,0.7394583001357296,Dovish
7,14, 세계/NNG;경제/NNG;성장/NNG;견인/NNG,21,0.7260136037696254,Dovish
15,33, 건전성/NNG;관리/NNG;강화/NNG,48,0.6600123670632958,Dovish
41,79, 경제/NNG;거품/NNG,120,0.7535837406216365,Dovish
29,78, 과도/NNG;위험/NNG,107,0.5398562694697214,Dovish
9,34, 채권/NNG;금리/NNG;상승/NNG;약세/NNG,43,0.3843601431721546,Dovish
9,30, 국을/NNG,39,0.43560816226177523,Dovish
275,618, 테너/NNG,893,0.6461286117690841,Dovish
156,446, 탕감/NNG,602,0.507883956000276,Dovish
14,27, 글로벌/NNG;경제/NNG;위험/NNG,41,0.7529029965018337,Dovish
67,132, 긴장/NNG;완화/NNG,199,0.7370138098873469,Dovish
9,22, 과세안/NNG,31,0.5940111303569663,Dovish
4,13, 시스템/NNG;위험/NNG;줄/VV,17,0.44677760231976943,Dovish
7,19, 세의/NNG,26,0.5349573922513029,Dovish
126,257, 해선/XSV,383,0.7118888254861697,Dovish
78,164, 디스인플레이션/NNG,242,0.6905983060247657,Dovish
33,66, 기업/NNG;투자/NNG;위축/NNG,99,0.7260136037696253,Dovish
13,26, 유동성/NNG;과도/NNG,39,0.7260136037696254,Dovish
9,22, 생산/NNG;급감/NNG,31,0.5940111303569663,Dovish
8,19, 예금회전율/NNG,27,0.6113798768586319,Dovish
16,32, 수식/NNG,48,0.7260136037696253,Dovish
9,19, 유로존/NNG;재정/NNG;적자/NNG,28,0.687802361465961,Dovish
82,162, 출구전략/NNG;우려/NNG,244,0.7349767346803615,Dovish
5,17, 부작용/NNG;방지/NNG,22,0.42706682574683846,Dovish
30,62, 불린/VV,92,0.7025938100996375,Dovish
8,16, 여전/NNG;불확실성/NNG,24,0.7260136037696253,Dovish
6,13, 채권/NNG;악재/NNG,19,0.6701664034796543,Dovish
85,188, 정치/NNG;불안정/NNG,273,0.6565016629831719,Dovish
45,87, 분대/NNG,132,0.7510485556237504,Dovish
37,98, 산불/NNG,135,0.54821435386686,Dovish
25,50, 서해/NNG,75,0.7260136037696254,Dovish
59,120, 경기/NNG;회복/NNG;모멘텀/NNG,179,0.7139133770401316,Dovish
14,49, 물가/NNG;상승률/NNG;떨어/VV,63,0.4148649164397859,Dovish
4,23, 내구재/NNG;주문/NNG;줄/VV,27,0.2525264708763914,Dovish
27,75, 단기/NNG;성장/NNG,102,0.5227297947141303,Dovish
45,94, 정책/NNG;완화/NNG,139,0.695119407864535,Dovish
29,68, 면역/NNG,97,0.6192468973329157,Dovish
17,39, 일어난다/VV,56,0.6329349366196735,Dovish
23,54, 재조명/NNG,77,0.618456032840792,Dovish
30,66, 금융자본/NNG,96,0.6600123670632958,Dovish
127,286, 화답/NNG,413,0.6447813124387582,Dovish
45,94, 성장/NNG;전망/NNG;하향/NNG,139,0.695119407864535,Dovish
4,12, 지출/NNG;완만/NNG;증가/NNG,16,0.4840090691797502,Dovish
1564,3984, 유럽연합/NNG,5548,0.5700227290641035,Dovish
39,80, 시중/NNG;유동성/NNG;확대/NNG,119,0.7078632636753848,Dovish
7,27, 개선/NNG;기대/NNG;높/VV,34,0.37645149825091684,Dovish
31,61, 혈안/NNG,92,0.7379154661265046,Dovish
16,38, 전망/NNG;하단/NNG,54,0.6113798768586319,Dovish
19,38, 뒤처진/VV,57,0.7260136037696254,Dovish
25,64, 앞뒤/NNG,89,0.5671981279450199,Dovish
3,15, 대여자/NNG,18,0.2904054415078502,Dovish
5,11, 투자/NNG;감축/NNG,16,0.6600123670632958,Dovish
4,13, 투자/NNG;플러스/NNG,17,0.44677760231976943,Dovish
4,19, 정한다는/VV,23,0.30568993842931597,Dovish
9,19, 산업/NNG;생산/NNG;회복/NNG,28,0.687802361465961,Dovish
13,27, 성장/NNG;상승/NNG,40,0.6991242110374171,Dovish
15,29, 예상/NNG;인상/NNG,44,0.7510485556237504,Dovish
476,954,시작/NNG,1430,0.7244915626715758,Dovish
58,157, 롱포지션청산/NNG,215,0.5364176945049461,Dovish
299,670, 비차익/NNG,969,0.6479942314242328,Dovish
40,87, 규범/NNG,127,0.6675987161100003,Dovish
286,574, 대출심사/NNG,860,0.7234839396449925,Dovish
6,21, 은행/NNG;순이익/NNG;감소/NNG,27,0.41486491643978596,Dovish
14,27, 재무/NNG;건전성/NNG;높/VV,41,0.7529029965018337,Dovish
31,63, 원상회복/NNG,94,0.7144895783129647,Dovish
5,12, 도입안/NNG,17,0.6050113364746877,Dovish
518,1118, 실수요자/NNG,1636,0.6727639476791877,Dovish
401,799, 국채/NNG;금리/NNG;오르/VV,1200,0.7287395622318393,Dovish
6,12, 위험자산/NNG;확대/NNG,18,0.7260136037696254,Dovish
16,35, 수요/NNG;낮/VA,51,0.6637838663036575,Dovish
2,23, 총액/NNG;대출/NNG;한도/NNG;줄/VV,25,0.1262632354381957,Dovish
7,15, 순화/NNG,22,0.6776126968516504,Dovish
65,168, 포용/NNG,233,0.56179624101221,Dovish
3,14, 인내력/NNG,17,0.3111486873298395,Dovish
10,24, 공공부분/NNG,34,0.6050113364746877,Dovish
4,13, 실업률/NNG;소폭/MAG;하락/NNG,17,0.44677760231976943,Dovish
7,19, 금리/NNG;스티프닝/NNG,26,0.5349573922513029,Dovish
27,52, 수요/NNG;확충/NNG,79,0.7539372039146109,Dovish
6,12, 지수/NNG;후퇴/NNG,18,0.7260136037696254,Dovish
340,652, 역마진/NNG,992,0.7571921020910203,Dovish
75,203, 부증/NNG,278,0.5364632540169646,Dovish
249,545, 커뮤니케이션/NNG,794,0.6634032562885751,Dovish
65,158, 통화신용정책보고서/NNG,223,0.5973529651269069,Dovish
113,217, 금융안전망/NNG,330,0.7561247670596098,Dovish
15,35, 간접지원/NNG,50,0.6222973746596789,Dovish
19,41, 수익/NNG;낮/VA,60,0.6728906571523358,Dovish
26,53, 임시회의/NNG,79,0.7123152338871797,Dovish
6,14, 대외/NNG;수지/NNG;흑자/NNG,20,0.622297374659679,Dovish
253,544, 역풍/NNG,797,0.6752994182121883,Dovish
48,95, 다수당/NNG,143,0.7336558522303583,Dovish
30,69, 영동/NNG,99,0.6313161771909785,Dovish
11,33, 글로벌/NNG;시장/NNG;불안/NNG,44,0.48400906917975023,Dovish
22,56, 금융파생상품/NNG,78,0.5704392601047057,Dovish
6,16, 문사/NNG,22,0.5445102028272191,Dovish
79,155, 맵/NNG,234,0.7400654799716182,Dovish
38,81, 액티브펀드/NNG,119,0.6811979492159449,Dovish
121,331, 대출보증/NNG,452,0.5308014867439558,Dovish
147,289, 나눔/VV,436,0.7385743927621795,Dovish
5,15, 증편/NNG,20,0.48400906917975023,Dovish
15,29, 방문자/NNG,44,0.7510485556237504,Dovish
204,399, 조화/NNG,603,0.7423898504711959,Dovish
184,402, 절약/NNG,586,0.6646094681274182,Dovish
17,67, 변호/NNG,84,0.36842481385324277,Dovish
8,18, 가격/NNG;반대/NNG,26,0.6453454255730003,Dovish
17,36, 앞당겨졌/VV,53,0.6856795146713129,Dovish
70,181, 말미암/VV,251,0.5615574835787158,Dovish
12,30, 금리/NNG;인상/NNG;가능성/NNG;완전히/MAG;배제/NNG,42,0.5808108830157004,Dovish
74,164, 경제/NNG;하방/NNG;위험/NNG,238,0.6551830082799059,Dovish
10,22, 단기/NNG;물가/NNG;상승/NNG,32,0.6600123670632958,Dovish
9,21, 현물/NNG;금리/NNG;오르/VV,30,0.6222973746596789,Dovish
5,12, 국고채/NNG;넘/VV,17,0.6050113364746877,Dovish
15,38, 위기/NNG;증폭/NNG,53,0.5731686345549674,Dovish
7,17, 기대/NNG;위축/NNG,24,0.5978935560455738,Dovish
187,399,레벨/NNG,586,0.6805240295985961,Dovish
12,24, 어렵사리/MAG,36,0.7260136037696254,Dovish
14,28, 가시밭길/NNG,42,0.7260136037696254,Dovish
6,13, 한기/NNG,19,0.6701664034796543,Dovish
33,68, 매도금액/NNG,101,0.7046602624822833,Dovish
14,28, 역공/NNG,42,0.7260136037696254,Dovish
3,15, 호조/NNG;물가/NNG;상승/NNG,18,0.2904054415078502,Dovish
9,20, 불안사태/NNG,29,0.6534122433926629,Dovish
4,12, 약화/NNG;fed/NNG;금리/NNG;인상/NNG,16,0.4840090691797502,Dovish
487,966, 가계/NNG;부채/NNG;증가/NNG,1453,0.7320261387904918,Dovish
6,19, 채권시장/NNG;비둘기/NNG,25,0.458534907643974,Dovish
322,649, 노인/NNG,971,0.7204202786250211,Dovish
50,101, 스크린/NNG,151,0.7188253502669558,Dovish
7,17, 꾸미/VV,24,0.5978935560455738,Dovish
21,41, 냄새/NNG,62,0.7437212526420554,Dovish
8,24, 지독/NNG,32,0.4840090691797502,Dovish
52,144, 달러부채/NNG,196,0.5243431582780628,Dovish
254,536, 줄/NNG,790,0.6880875199906151,Dovish
6,12, 불어/NNG,18,0.7260136037696254,Dovish
6,12, 제품/NNG;가격/NNG;인하/NNG,18,0.7260136037696254,Dovish
6,13, 인상/NNG;충격/NNG,19,0.6701664034796543,Dovish
86,172, 지출/NNG;줄/VV,258,0.7260136037696253,Dovish
6,12, 돈/NNG;작/VA,18,0.7260136037696254,Dovish
6,18, 불만족/NNG,24,0.4840090691797503,Dovish
22,43, 도우/NNG,65,0.7428976410665934,Dovish
37,72, 꿈틀거리/VV,109,0.7461806483187817,Dovish
4,16, 안락/NNG,20,0.36300680188481266,Dovish
25,73, 드리운/VV,98,0.49726959162303114,Dovish
16,33, 가격/NNG;밀/VV;오르/VV,49,0.7040131915341822,Dovish
10,22, 임금/NNG;압력/NNG,32,0.6600123670632958,Dovish
71,148, 기대/NNG;약하/VA,219,0.696580619833019,Dovish
11,22, 되돌려야/VV,33,0.7260136037696254,Dovish
12,33, 회장직/NNG,45,0.5280098936506367,Dovish
74,149, 빌/VV,223,0.7211410292476816,Dovish
9,27, 상장잔액/NNG,36,0.4840090691797503,Dovish
7,21, 물가/NNG;상승/NNG;압력/NNG;강화/NNG,28,0.4840090691797503,Dovish
5,13, 재무/NNG;건전성/NNG;양호/NNG,18,0.5584720028997119,Dovish
14,27, 경제/NNG;성장률/NNG;개선/NNG,41,0.7529029965018337,Dovish
13,30, 낙찰/NNG;금리/NNG;상승/NNG,43,0.6292117899336753,Dovish
11,24, 경제/NNG;회복/NNG;미약/NNG,35,0.6655124701221565,Dovish
17,43, 비둘기/NNG;매파/NNG,60,0.5740572680969132,Dovish
15,36, 위험/NNG;증폭/NNG,51,0.6050113364746877,Dovish
7,18, 높/VA;완화/NNG,25,0.5646772473763753,Dovish
434,876, 토론/NNG,1310,0.719383342547985,Dovish
14,34, 낙찰/NNG;금리/NNG;낮/VA,48,0.5978935560455738,Dovish
77,168, 물가/NNG;상승/NNG;둔화/NNG,245,0.6655124701221566,Dovish
2,16, 복성/NNG,18,0.18150340094240633,Dovish
5,11, 부로/NNG,16,0.6600123670632958,Dovish
38,125, 비농업/NNG;고용/NNG;늘/VV,163,0.44141627109193227,Dovish
18,49, 채무국/NNG,67,0.5333977497082962,Dovish
11,30, 스테이/NNG,41,0.5324099760977252,Dovish
13,43, 어우러져/VV,56,0.43898496972116885,Dovish
14,32, 줄인다면/VV,46,0.6352619032984222,Dovish
8,32, 순찰/NNG,40,0.36300680188481266,Dovish
418,862, 썼/VV,1280,0.704115281614161,Dovish
9,18, 일궈/VV,27,0.7260136037696254,Dovish
37,79, 산물/NNG,116,0.6800633756829403,Dovish
30,60, 몰수/NNG,90,0.7260136037696253,Dovish
125,250, 증서/NNG,375,0.7260136037696254,Dovish
43,92, 선원/NNG,135,0.678664890480302,Dovish
9,19, 최저/NNG;금리/NNG;인상/NNG,28,0.687802361465961,Dovish
5,12, 금리/NNG;하락/NNG;가속/NNG,17,0.6050113364746877,Dovish
11,29, 주택시장/NNG;부양/NNG,40,0.5507689407907503,Dovish
248,510, 수상/NNG,758,0.7060838185681063,Dovish
146,298, 찬반/NNG,444,0.7113958802037941,Dovish
3,13, 고용/NNG;증가/NNG;확대/NNG,16,0.33508320173982714,Dovish
16,32, 다수/NNG;금리/NNG;인상/NNG,48,0.7260136037696253,Dovish
57,114, 미뤄졌/VV,171,0.7260136037696253,Dovish
6,13, 외감/NNG,19,0.6701664034796543,Dovish
11,25, 럭/NNG,36,0.6388919713172704,Dovish
53,102, 일시불/NNG,155,0.7544847254860813,Dovish
8,16, 가계/NNG;대출/NNG;증가/NNG;확대/NNG,24,0.7260136037696253,Dovish
6,19, 부동산/NNG;장기/NNG;침체/NNG,25,0.458534907643974,Dovish
22,44, 하락/NNG;가능성/NNG;낮/VA,66,0.7260136037696254,Dovish
28,71, 대출/NNG;위험/NNG,99,0.5726304480436482,Dovish
52,119, 비농업/NNG;고용자수/NNG;증가/NNG,171,0.6344992839667315,Dovish
20,39, 동떨어져/VV,59,0.7446293371996158,Dovish
35,67, 동종/NNG,102,0.7585216755802057,Dovish
9,20, 경기/NNG;둔화/NNG;우려/NNG;증폭/NNG,29,0.6534122433926629,Dovish
14,27, 회사채/NNG;시장/NNG;위축/NNG,41,0.7529029965018337,Dovish
259,541, 경기/NNG;활성화/NNG,800,0.695147960725815,Dovish
4,22, 불안/NNG;공포/NNG,26,0.26400494682531833,Dovish
14,27, 전망/NNG;불안/NNG,41,0.7529029965018337,Dovish
9,24, 가격/NNG;부담/NNG;덜/VV,33,0.5445102028272191,Dovish
29,60, 뒤바뀌/VV,89,0.7018131503106378,Dovish
80,157, 뱅크런/NNG,237,0.739886475179236,Dovish
30,58, 단편/NNG,88,0.7510485556237504,Dovish
56,108, 실용/NNG,164,0.7529029965018337,Dovish
5,12, 봐온/VV,17,0.6050113364746877,Dovish
7,15, 휘젓/VV,22,0.6776126968516504,Dovish
8,17, 낮/VA;양적완화/NNG,25,0.6833069211949414,Dovish
10,22, 작/VA;악재/NNG,32,0.6600123670632958,Dovish
6,12, 부채/NNG;크/VV,18,0.7260136037696254,Dovish
4,17, 채권/NNG;금리/NNG;최저/NNG,21,0.3416534605974707,Dovish
861,1654,더/MAG,2515,0.7558618051337938,Dovish
49,101, 합의점/NNG,150,0.7044488432616167,Dovish
48,102, 사채시장/NNG,150,0.6833069211949415,Dovish
561,1095, 중도금/NNG,1656,0.7439153090680546,Dovish
62,164, 커뮤니티/NNG,226,0.5489371150453266,Dovish
318,611, 여론조사/NNG,929,0.7557195613706739,Dovish
6,15, 자라나/VV,21,0.5808108830157004,Dovish
13,36, 뜰/VV,49,0.5243431582780628,Dovish
33,76, 퍼질/VV,109,0.6304854980104642,Dovish
6,14, 위기/NNG;가능성/NNG;낮/VA,20,0.622297374659679,Dovish
7,17, 정책/NNG;영향/NNG;줄/VV,24,0.5978935560455738,Dovish
14,30, 금융시장/NNG;공포/NNG,44,0.6776126968516504,Dovish
6,13, 중국시장/NNG;성장/NNG,19,0.6701664034796543,Dovish
110,272, 경제/NNG;성장률/NNG;전망/NNG;하향/NNG,382,0.5872168854019029,Dovish
30,59, 최우량/NNG,89,0.7383189190877547,Dovish
10,21, 재정/NNG;건전성/NNG;양호/NNG,31,0.6914415273996433,Dovish
31,66, 라이트/NNG,97,0.682012779298739,Dovish
10,40, 주택/NNG;판매가격/NNG;증가/NNG,50,0.3630068018848127,Dovish
4,14, 부동산/NNG;투자/NNG;확대/NNG,18,0.41486491643978596,Dovish
6,27, 현금/NNG;유동성/NNG;확보/NNG,33,0.32267271278650017,Dovish
31,76, 긴축/NNG;반대/NNG,107,0.5922742557067997,Dovish
243,496, 난항/NNG,739,0.711376232725883,Dovish
784,1684,부채/NNG,2468,0.6760031655052094,Dovish
5,14, 천조/NNG,19,0.5185811455497324,Dovish
11,36, 개인부문/NNG,47,0.44367498008143774,Dovish
11,23, 측력/NNG,34,0.6944477949100765,Dovish
99,452, 그리스사태/NNG,551,0.31803250784598636,Dovish
37,73, 덤/NNG,110,0.7359589956020861,Dovish
31,61, 체감/NNG;경기/NNG;개선/NNG,92,0.7379154661265046,Dovish
161,311, 가계/NNG;부채/NNG;급증/NNG,472,0.7516925415235349,Dovish
71,162, 유로존/NNG;우려/NNG,233,0.6363822946622643,Dovish
258,660,커브/NNG,918,0.5676106356744344,Dovish
37,86, 내려놓/VV,123,0.6247093799878172,Dovish
32,71, 체/NNG,103,0.6544347977641692,Dovish
11,25, 안전자산/NNG;선호/NNG;높/VV,36,0.6388919713172704,Dovish
6,26, 예상/NNG;달리/MAG;증가/NNG,32,0.33508320173982714,Dovish
4,14, 패치/NNG,18,0.41486491643978596,Dovish
24,54, 외부압력/NNG,78,0.6453454255730003,Dovish
39,76, 얕/VA,115,0.7451192249214577,Dovish
1250,2470, 월세/NNG,3720,0.7348315827627787,Dovish
137,266, 체험/NNG,403,0.7478485993717193,Dovish
9,20, 끌어와/VV,29,0.6534122433926629,Dovish
146,290, 중개인/NNG,436,0.7310205941404504,Dovish
6,12, 배면/NNG,18,0.7260136037696254,Dovish
15,34, 뺏기/VV,49,0.6406002386202576,Dovish
16,31, 귀한/VA,47,0.7494333974396133,Dovish
27,63, 사업가/NNG,90,0.6222973746596789,Dovish
29,63, 파트타임/NNG,92,0.6683934764863217,Dovish
4,16, 마지못해/VA,20,0.36300680188481266,Dovish
123,290, 학부/NNG,413,0.6158598156114753,Dovish
12,25, 막다른/VA,37,0.6969730596188405,Dovish
38,78, 만병통치약/NNG,116,0.707397870339635,Dovish
12,27, 하룻밤/NNG,39,0.6453454255730003,Dovish
27,53, 잠자/VV,80,0.7397119736520712,Dovish
47,105, 미끼/NNG,152,0.6499550357556646,Dovish
14,45, 배워야/VV,59,0.45174179790110025,Dovish
6,17, 물리학/NNG,23,0.5124801908962061,Dovish
22,48, 학문/NNG,70,0.6655124701221565,Dovish
3,19, 신용등급/NNG;하향/NNG;경고/NNG,22,0.229267453821987,Dovish
5,11, 가격/NNG;인상/NNG;억제/NNG,16,0.6600123670632958,Dovish
19,37, 중소기업/NNG;부담/NNG,56,0.7456355930606964,Dovish
28,73, 소득/NNG;오르/VV,101,0.5569419426177948,Dovish
9,25, 작/VA;위험/NNG,34,0.5227297947141304,Dovish
14,27, 불확실성/NNG;안전자산/NNG;선호/NNG,41,0.7529029965018337,Dovish
356,782, 대출/NNG;금리/NNG;인하/NNG,1138,0.6610251737646717,Dovish
424,876, 정치/NNG;불확실성/NNG,1300,0.702807689493884,Dovish
24,59, 유로존/NNG;안정/NNG,83,0.5906551352702037,Dovish
7,24, 열심/NNG,31,0.42350793553228144,Dovish
16,33, 주식처분/NNG,49,0.7040131915341822,Dovish
14,29, 약정금액/NNG,43,0.7009786519155004,Dovish
115,223, 교착/NNG,338,0.7488032684619454,Dovish
18,36, 완강/NNG,54,0.7260136037696254,Dovish
6,15, 완강히/MAG,21,0.5808108830157004,Dovish
7,16, 부채한도/NNG;협상/NNG;불확실성/NNG,23,0.6352619032984222,Dovish
45,100, 부정적/VAX;파급효과/NNG,145,0.6534122433926629,Dovish
13,25, 자산/NNG;확보/NNG,38,0.7550541479204105,Dovish
12,32, 디폴트/NNG;막/VV,44,0.5445102028272191,Dovish
19,43, 거친/VA,62,0.6415934172847853,Dovish
5,11, 내거/VV,16,0.6600123670632958,Dovish
28,59, 트릴/NNG,87,0.6890976578152377,Dovish
54,111, 개선책/NNG,165,0.7063916144785544,Dovish
140,362, 분할상환대출/NNG,502,0.5615574835787158,Dovish
12,27, 라이프사이클/NNG,39,0.6453454255730003,Dovish
73,145, 안전장치/NNG,218,0.7310205941404504,Dovish
17,44, 부정행위/NNG,61,0.5610105120038015,Dovish
338,647, 담보인정비율/NNG,985,0.7585551717902115,Dovish
128,251, 금리체계/NNG,379,0.7404760261554745,Dovish
37,72, 죄/NNG,109,0.7461806483187817,Dovish
7,20, 외칠/VV,27,0.5082095226387378,Dovish
13,36, 되갚/VV,49,0.5243431582780628,Dovish
42,101, 거짓/NNG,143,0.6038132942242429,Dovish
37,84, 말라/VV,121,0.63958341284467,Dovish
244,481, 꼴/NNG,725,0.7365792903109714,Dovish
12,26, 왠지/MAG,38,0.6701664034796543,Dovish
47,177, 가계/NNG;부채/NNG;구조/NNG;개선/NNG,224,0.3855665466347163,Dovish
16,39, 가계/NNG;대출/NNG;구조/NNG;개선/NNG,55,0.5957034697596926,Dovish
5,14, 하락/NNG;압력/NNG;확대/NNG,19,0.5185811455497324,Dovish
23,50, 원금/NNG;상환/NNG;부담/NNG,73,0.6679325154680553,Dovish
20,48, 국채시장/NNG;불안/NNG,68,0.6050113364746877,Dovish
19,44, 자금/NNG;안정/NNG,63,0.6270117487101311,Dovish
208,423, 제언/NNG,631,0.7139991942509791,Dovish
12,29, 떠오른다/VV,41,0.6008388444990004,Dovish
33,66, 겹쳐지/VV,99,0.7260136037696253,Dovish
32,76, 대침체/NNG,108,0.6113798768586319,Dovish
85,232, 유권자/NNG,317,0.5319927269001565,Dovish
12,26, 치사/NNG,38,0.6701664034796543,Dovish
17,38, 경기/NNG;불확실성/NNG;크/VV,55,0.6495911191622965,Dovish
9,22, 입찰가격/NNG,31,0.5940111303569663,Dovish
5,11, 회사채/NNG;투자심리/NNG;위축/NNG,16,0.6600123670632958,Dovish
74,148, 영리/NNG,222,0.7260136037696254,Dovish
22,45, 벼/NNG,67,0.7098799681303004,Dovish
17,42, 마이너스/NNG;하락/NNG,59,0.5877252982896968,Dovish
6,12, 위축/NNG;방지/NNG,18,0.7260136037696254,Dovish
27,52, 조유/NNG,79,0.7539372039146109,Dovish
38,90, 경기/NNG;회복/NNG;부진/NNG,128,0.6130781542943504,Dovish
18,45, 조짐/VV,63,0.5808108830157004,Dovish
6,18, 활성화/NNG;대책/NNG;금리/NNG;인하/NNG,24,0.4840090691797503,Dovish
29,73, 대출/NNG;수요/NNG;줄/VV,102,0.5768327262827161,Dovish
12,23, 시중/NNG;금리/NNG;높/VA,35,0.7575794126291744,Dovish
3055,6106,가계/NNG,9161,0.726489210454047,Dovish
4,14, 제시은행/NNG,18,0.41486491643978596,Dovish
17,36, 수건/NNG,53,0.6856795146713129,Dovish
11,25, 쥐어짜/VV,36,0.6388919713172704,Dovish
7,33, 대출계획/NNG,40,0.3080057712962047,Dovish
39,76, 잦아든/VV,115,0.7451192249214577,Dovish
10,28, 국고채/NNG;금리/NNG;최저/NNG,38,0.5185811455497324,Dovish
7,25, 하락/NNG;우려/NNG;크/VV,32,0.40656761811099024,Dovish
30,60, 여력/NNG;크/VV,90,0.7260136037696253,Dovish
44,93, 전수조사/NNG,137,0.6869806143196454,Dovish
13,31, 감익/NNG,44,0.6089146354196858,Dovish
6,21, 분란/NNG,27,0.41486491643978596,Dovish
17,51, 글로벌/NNG;안전자산/NNG;선호/NNG;강화/NNG,68,0.4840090691797503,Dovish
46,88, 단기/NNG;변동성/NNG;확대/NNG,134,0.7590142221227901,Dovish
6,30, 침체/NNG;공포/NNG,36,0.2904054415078502,Dovish
106,300, 공무원연금/NNG,406,0.5130496133305353,Dovish
83,196, 공적연금/NNG,279,0.614889072580397,Dovish
7,14, 안전자산/NNG;수요/NNG;높/VA,21,0.7260136037696254,Dovish
60,141, 위험/NNG;피하/VV,201,0.6178839181018088,Dovish
3,14, 신용경색/NNG;풀/VV;않/VX,17,0.3111486873298395,Dovish
24,73, 기대/NNG;증폭/NNG,97,0.4773788079581099,Dovish
17,35, 일방/NNG,52,0.7052703579476362,Dovish
6,15, 신용등급/NNG;하락/NNG;우려/NNG,21,0.5808108830157004,Dovish
15,33, 파란불/NNG,48,0.6600123670632958,Dovish
7,18, 부채/NNG;문제/NNG;확산/NNG,25,0.5646772473763753,Dovish
10,26, 살아갈/VV,36,0.5584720028997119,Dovish
35,72, 아직/MAG;금리/NNG;인하/NNG,107,0.7058465592204692,Dovish
8,18, 유동성/NNG;잡/VV,26,0.6453454255730003,Dovish
15,35, 은행/NNG;건전성/NNG;악화/NNG,50,0.6222973746596789,Dovish
12,23, 여력/NNG;축소/NNG,35,0.7575794126291744,Dovish
98,204, 취합/NNG,302,0.6975424820531695,Dovish
28,59, 카/VV,87,0.6890976578152377,Dovish
15,63, 역리/NNG,78,0.3457207636998216,Dovish
15,41, 우려/NNG;경계/NNG,56,0.5312294661728967,Dovish
45,107, 몰/NNG,152,0.610665648030526,Dovish
32,77, 처방전/NNG,109,0.6034398784578704,Dovish
1,17, 위험자산/NNG;가격/NNG;회복/NNG,18,0.08541336514936768,Dovish
11,34,메시지/NNG,45,0.46977350832152226,Dovish
14,29, 알맹이/NNG,43,0.7009786519155004,Dovish
61,126, 파급경로/NNG,187,0.702965552856304,Dovish
16,35, 비농업/NNG;신규/NNG;고용/NNG;증가/NNG,51,0.6637838663036575,Dovish
23,63, 글로벌/NNG;성장/NNG;둔화/NNG,86,0.5301051710063931,Dovish
9,22, 기대/NNG;걸/VV;어렵/VA,31,0.5940111303569663,Dovish
29,58, 유로존/NNG;불확실성/NNG,87,0.7260136037696254,Dovish
37,104, 수요/NNG;진작/NNG,141,0.5165866026822334,Dovish
147,317, 인선/NNG,464,0.6733375378809774,Dovish
293,688, 사퇴/NNG,981,0.6183778660014542,Dovish
48,116, 내몰릴/VV,164,0.6008388444990004,Dovish
27,67, 정치/NNG;불확실성/NNG;완화/NNG,94,0.5851452925904443,Dovish
22,43, 평준/NNG,65,0.7428976410665934,Dovish
25,61, 건전성/NNG;우려/NNG,86,0.5950931178439552,Dovish
8,23, 기대/NNG;양호/NNG,31,0.5050529417527828,Dovish
56,128, 점할/VV,184,0.6352619032984222,Dovish
16,32, 저축률/NNG;상승/NNG,48,0.7260136037696253,Dovish
161,311, 리스크온/NNG,472,0.7516925415235349,Dovish
10,22, 글로벌/NNG;금융위기/NNG;충격/NNG,32,0.6600123670632958,Dovish
11,24, 경기/NNG;전망/NNG;부정적/VAX,35,0.6655124701221565,Dovish
8,28, 위기/NNG;금리/NNG;인상/NNG,36,0.41486491643978596,Dovish
17,37, 만약/NNG;금리/NNG;인하/NNG,54,0.6671476358964126,Dovish
6,19, 수요/NNG;충격/NNG,25,0.458534907643974,Dovish
7,15,미션/NNG,22,0.6776126968516504,Dovish
57,116, 이념/NNG,173,0.7134961278425629,Dovish
32,67, 미션/NNG,99,0.6935055319590451,Dovish
9,20, 결점/NNG,29,0.6534122433926629,Dovish
6,28, 성장/NNG;경로/NNG;하방/NNG;위험/NNG,34,0.3111486873298395,Dovish
32,67, 당분간/MAG;금리/NNG;인하/NNG,99,0.6935055319590451,Dovish
13,61, 연금기금/NNG,74,0.30944842127885674,Dovish
4,20, 공적금융기관/NNG,24,0.29040544150785014,Dovish
26,72, 중개회사/NNG,98,0.5243431582780628,Dovish
36,111, 선제/NNG;금리/NNG;인하/NNG,147,0.47092774298570295,Dovish
22,47, 하단/NNG;막/VV,69,0.6796723099119898,Dovish
36,76, 환손실/NNG,112,0.687802361465961,Dovish
47,97, 부의효과/NNG,144,0.7035595747870597,Dovish
9,19, 세계/NNG;경제/NNG;성장/NNG;하방/NNG;위험/NNG,28,0.687802361465961,Dovish
128,245, 우울/NNG,373,0.7586101329184657,Dovish
119,290, 암울/NNG,409,0.5958318541281753,Dovish
10,21, 전도/NNG,31,0.6914415273996433,Dovish
8,16, 유로존/NNG;신용등급/NNG;강등/NNG,24,0.7260136037696253,Dovish
18,36, 세븐/NNG,54,0.7260136037696254,Dovish
10,20, 부양책/NNG;기대/NNG;높/VV,30,0.7260136037696254,Dovish
11,25, 자산/NNG;가격/NNG;높/VV,36,0.6388919713172704,Dovish
5,23, 안정/NNG;위험/NNG,28,0.3156580885954893,Dovish
42,113, 유로안정화기구/NNG,155,0.5396915284659162,Dovish
10,24, 결로/NNG,34,0.6050113364746877,Dovish
49,108, 마중물/NNG,157,0.6587901219391046,Dovish
23,45, 기호/NNG,68,0.7421472394089503,Dovish
66,144, 글로벌/NNG;위험자산/NNG;선호/NNG,210,0.6655124701221565,Dovish
7,14, 불확실성/NNG;경기/NNG;둔화/NNG,21,0.7260136037696254,Dovish
8,17, 경제/NNG;부진/NNG;일시적/VAX,25,0.6833069211949414,Dovish
7,16, 주택/NNG;경기/NNG;상승/NNG,23,0.6352619032984222,Dovish
83,177, 학력/NNG,260,0.6808941142698182,Dovish
15,31, 볼모/NNG,46,0.7025938100996375,Dovish
5,11, 은행/NNG;위험/NNG;회피/NNG,16,0.6600123670632958,Dovish
27,54, 낮/VA;금리/NNG;인하/NNG,81,0.7260136037696253,Dovish
20,43, 우려/NNG;강화/NNG,63,0.6753614918787213,Dovish
7,30, 주택시장/NNG;긍정적/VAX,37,0.3388063484258252,Dovish
26,53, 노동시장/NNG;회복/NNG,79,0.7123152338871797,Dovish
20,39, 주택시장/NNG;상승/NNG,59,0.7446293371996158,Dovish
5,18, 세계/NNG;금융시장/NNG;위험/NNG,23,0.4033408909831252,Dovish
4,16, 금융시장/NNG;위험/NNG;선호/NNG,20,0.36300680188481266,Dovish
11,27, 리보/NNG;하락/NNG,38,0.5915666401085836,Dovish
11,28, 다가/VV,39,0.5704392601047057,Dovish
11,41, 청산소/NNG,52,0.38956827519345755,Dovish
7,34, 여력/NNG;약하/VA,41,0.2989467780227869,Dovish
22,46, 채권시장/NNG;상승/NNG,68,0.6944477949100765,Dovish
6,12,비우호적/VAX,18,0.7260136037696254,Dovish
25,49, 장기물/NNG;선호/NNG,74,0.7408302079281892,Dovish
11,26, 자신/NNG;약하/VA,37,0.614319203189683,Dovish
4,14, 금리/NNG;인하/NNG;가능성/NNG;차단/NNG,18,0.41486491643978596,Dovish
116,354, 다중채무자/NNG,470,0.47580552563433076,Dovish
14,32, 무용론/NNG,46,0.6352619032984222,Dovish
113,260, 질의응답/NNG,373,0.6310733632766744,Dovish
23,47, 졌/VV,70,0.7105665058170801,Dovish
9,23, 유로존/NNG;경제/NNG;개선/NNG,32,0.5681845594718807,Dovish
18,39, 금리/NNG;인하/NNG;완화/NNG,57,0.6701664034796543,Dovish
22,67, 리알/NNG,89,0.47678505322184356,Dovish
81,168, 노후자금/NNG,249,0.7000845464921388,Dovish
6,17, 퇴직급여보장법/NNG,23,0.5124801908962061,Dovish
16,43, 다양/NNG;위험/NNG,59,0.540289193502977,Dovish
16,32, 통화정책/NNG;경기/NNG;부양/NNG,48,0.7260136037696253,Dovish
4,16, 채권시장/NNG;약세/NNG;되돌/VV,20,0.36300680188481266,Dovish
4,18, 콜/NNG;금리/NNG;하락/NNG,22,0.32267271278650017,Dovish
43,97, 고덕/NNG,140,0.6436821641668844,Dovish
34,87, 위험/NNG;회피/NNG;강화/NNG,121,0.5674589086935004,Dovish
10,22, 쉽/NNG,32,0.6600123670632958,Dovish
11,24, 일진일퇴/NNG,35,0.6655124701221565,Dovish
161,308, 영구/NNG,469,0.7590142221227901,Dovish
38,95, 구제금융기금/NNG,133,0.5808108830157004,Dovish
9,25, 조성계획/NNG,34,0.5227297947141304,Dovish
58,135, 전입/NNG,193,0.6238339113872337,Dovish
10,34, 영통/NNG,44,0.42706682574683846,Dovish
7,14, 들어옴/VV,21,0.7260136037696254,Dovish
21,59, 금인/NNG,80,0.5168232433614283,Dovish
30,59, 소비자/NNG;물가/NNG;상승률/NNG;둔화/NNG,89,0.7383189190877547,Dovish
12,32, 실업률/NNG;하향/NNG,44,0.5445102028272191,Dovish
6,15, 주택/NNG;개선/NNG,21,0.5808108830157004,Dovish
18,35, 방어벽/NNG,53,0.7467568495916148,Dovish
12,27, 오랫동안/MAG,39,0.6453454255730003,Dovish
4,15, 경제/NNG;실망/NNG,19,0.3872072553438002,Dovish
17,38, 나침반/NNG,55,0.6495911191622965,Dovish
7,15, 신용/NNG;증가/NNG;둔화/NNG,22,0.6776126968516504,Dovish
24,63, 신용등급/NNG;전망/NNG;상향/NNG,87,0.5531532219197146,Dovish
71,158, 경기/NNG;침체/NNG;막/VV,229,0.6524932388309292,Dovish
11,49, 글로벌/NNG;금융시장/NNG;위험/NNG;회피/NNG,60,0.3259652914884032,Dovish
5,11, fed/NNG;시장/NNG;불안/NNG,16,0.6600123670632958,Dovish
6,19, 내수/NNG;긍정적/VAX,25,0.458534907643974,Dovish
23,54, 국채/NNG;하락/NNG,77,0.618456032840792,Dovish
141,332, 전망/NNG;낮/VV,473,0.6166742056115493,Dovish
25,75, 천선/NNG,100,0.4840090691797503,Dovish
83,167, 불황형/NNG,250,0.7216662169207055,Dovish
10,34, 진동/NNG,44,0.42706682574683846,Dovish
23,44, 무역/NNG;적자/NNG;감소/NNG,67,0.7590142221227901,Dovish
9,27, 우려/NNG;금리/NNG;내리/VV,36,0.4840090691797503,Dovish
64,140, 불황형/NNG;흑자/NNG,204,0.6637838663036575,Dovish
8,18, 수출/NNG;최대/NNG,26,0.6453454255730003,Dovish
11,35, 둔화/NNG;낮/VA,46,0.4563514080837645,Dovish
49,94, 나타난다고/VV,143,0.7569077996747159,Dovish
6,23, 대통령실/NNG,29,0.3787897063145872,Dovish
9,20, 검사역/NNG,29,0.6534122433926629,Dovish
98,220, 상임/NNG,318,0.6468121197220299,Dovish
5,15, 하행/NNG,20,0.48400906917975023,Dovish
4,15, 경제/NNG;성장/NNG;훼손/NNG,19,0.3872072553438002,Dovish
7,31, 비둘기/NNG;아니/VCN,38,0.32787711137983083,Dovish
320,732, 세월/NNG,1052,0.6347659923668856,Dovish
5,21, 빚잔치/NNG,26,0.34572076369982163,Dovish
40,108, 글로벌/NNG;금융시장/NNG;불확실성/NNG,148,0.5377878546441669,Dovish
15,30, 비보장/NNG,45,0.7260136037696253,Dovish
53,107, 노벨경제학상/NNG,160,0.7192284299026196,Dovish
107,282, 수상자/NNG,389,0.5509464936407795,Dovish
47,118, 비보장형/NNG,165,0.5783498199520745,Dovish
2,17, 소득/NNG;불안/NNG,19,0.17082673029873535,Dovish
4,18, 구조/NNG;벗어나/VV,22,0.32267271278650017,Dovish
87,181, 성장/NNG;그치/VV,268,0.6979357295906896,Dovish
5,11, 유가/NNG;상승/NNG;인플레이션/NNG;압력/NNG,16,0.6600123670632958,Dovish
8,28, 유로존/NNG;경기/NNG;침체/NNG;우려/NNG,36,0.41486491643978596,Dovish
9,18, 재정위기/NNG;우려/NNG;확산/NNG,27,0.7260136037696254,Dovish
64,123, 이전/NNG;금리/NNG;인상/NNG,187,0.7555263518903418,Dovish
16,48, 실물/NNG;경기/NNG;위축/NNG,64,0.4840090691797502,Dovish
4,13, 우려/NNG;경기/NNG;부양/NNG,17,0.44677760231976943,Dovish
17,50, 투자/NNG;회피/NNG,67,0.49368925056334534,Dovish
2617,5059,유로존/NNG,7676,0.7511277331745837,Dovish
29,68, 워크/NNG,97,0.6192468973329157,Dovish
7,17, 누/NNG,24,0.5978935560455738,Dovish
54,106, 아슬아슬/MAG,160,0.7397119736520712,Dovish
63,128, 데뷔/NNG,191,0.7146696412107251,Dovish
19,38,쏟아진/VV,57,0.7260136037696254,Dovish
148,522, 잔류/NNG,670,0.41168587493450026,Dovish
116,248, 당선자/NNG,364,0.6791740164296496,Dovish
59,115, 무력화/NNG,174,0.7449530890853547,Dovish
15,35, 예상/NNG;달리/MAG;하락/NNG,50,0.6222973746596789,Dovish
21,41, 금리/NNG;하락/NNG;강세/NNG,62,0.7437212526420554,Dovish
7,19, 가격/NNG;낙폭/NNG;확대/NNG,26,0.5349573922513029,Dovish
30,69, 기업/NNG;신용위험/NNG,99,0.6313161771909785,Dovish
33,104, 유로존/NNG;이탈/NNG,137,0.46073940239226224,Dovish
267,515, 투기지역/NNG,782,0.7527985716756892,Dovish
16,39, 비둘기/NNG;성향/NNG;강하/VA,55,0.5957034697596926,Dovish
10,24, 소비/NNG;투자/NNG;감소/NNG,34,0.6050113364746877,Dovish
36,79, 경제/NNG;마이너스성장/NNG,115,0.6616832844482663,Dovish
13,33, 위기/NNG;악화/NNG,46,0.572010718121523,Dovish
10,20, 국채/NNG;금리/NNG;상회/NNG,30,0.7260136037696254,Dovish
12,31, 물가/NNG;상승률/NNG;높/VV,43,0.5620750480797101,Dovish
7,15, 상하/VV,22,0.6776126968516504,Dovish
4,15, 불확실성/NNG;경기/NNG;회복/NNG,19,0.3872072553438002,Dovish
20,39, 파열음/NNG,59,0.7446293371996158,Dovish
14,27, 역방향/NNG,41,0.7529029965018337,Dovish
7,22, 거시/NNG;건전성/NNG;강화/NNG,29,0.4620086569443071,Dovish
11,23, 짧아지/VV,34,0.6944477949100765,Dovish
105,237, 규명/NNG,342,0.6433031932135921,Dovish
93,201, 시리/NNG,294,0.671833484085325,Dovish
313,666, 소비세/NNG,979,0.6824091831228011,Dovish
32,62, 금리/NNG;인하/NNG;기대/NNG;높/VV,94,0.7494333974396133,Dovish
17,43, 부진/NNG;금리/NNG;인하/NNG,60,0.5740572680969132,Dovish
22,47, 제로쿠폰/NNG,69,0.6796723099119898,Dovish
40,122, 리자/NNG,162,0.4760744942751642,Dovish
80,158, 나와도/VV,238,0.7352036493869625,Dovish
97,188, 서로/NNG,285,0.7491842506984433,Dovish
41,89, 구제금융자금/NNG,130,0.668911410214711,Dovish
128,246, 극우/NNG,374,0.7555263518903418,Dovish
5,25, 나치/NNG,30,0.2904054415078502,Dovish
3,14, 시장법/NNG,17,0.3111486873298395,Dovish
73,160, 유럽의회/NNG,233,0.6624874134397832,Dovish
30,67, 어젠/NNG,97,0.6501614362116048,Dovish
130,530, 유로그룹/NNG,660,0.35615761694358977,Dovish
6,22, 구제금융/NNG;조건/NNG;완화/NNG,28,0.3960074202379775,Dovish
3,16, 고용창출/NNG;확대/NNG,19,0.27225510141360953,Dovish
5,11, 어떻게/MAG;성장/NNG,16,0.6600123670632958,Dovish
17,36, 불가능/NNG;않/VX,53,0.6856795146713129,Dovish
14,27, 성장/NNG;없/VA,41,0.7529029965018337,Dovish
22,64, 유로존/NNG;탈퇴/NNG;우려/NNG,86,0.4991343525916174,Dovish
60,126, 지수/NNG;상승/NNG;제한/NNG,186,0.6914415273996432,Dovish
23,49, 경제/NNG;비관/NNG,72,0.681563791293934,Dovish
6,16, 언더워터/NNG,22,0.5445102028272191,Dovish
5,29, 에퀴티/NNG,34,0.25034951854125015,Dovish
24,48, 경제/NNG;많/VA,72,0.7260136037696254,Dovish
213,469, 환차손/NNG,682,0.6594494567289135,Dovish
254,590, 중도상환수수료/NNG,844,0.6251100181609657,Dovish
21,45, 사전채무조정/NNG,66,0.6776126968516504,Dovish
48,113, 유량/NNG,161,0.6167903182467614,Dovish
44,98, 둠/NNG,142,0.6519305829768064,Dovish
52,121, 증상/NNG,173,0.624011692496207,Dovish
19,41, 가계/NNG;소득/NNG;감소/NNG,60,0.6728906571523358,Dovish
14,29, 총선/NNG;불확실성/NNG,43,0.7009786519155004,Dovish
15,41, 현충일/NNG,56,0.5312294661728967,Dovish
9,29, 연합체/NNG,38,0.45062913337425026,Dovish
14,29, 성장/NNG;하향/NNG;위험/NNG,43,0.7009786519155004,Dovish
19,41, 인하/NNG;없/VA,60,0.6728906571523358,Dovish
17,45, 금융감독기구/NNG,62,0.5485436117370504,Dovish
5,47, 공동기금/NNG,52,0.15447097952545222,Dovish
17,49, 본궤도/NNG,66,0.5037645413911687,Dovish
17,63, 금리/NNG;인상/NNG;경제/NNG;회복/NNG,80,0.39181686552646455,Dovish
5,22, 위기/NNG;최악/NNG,27,0.3300061835316479,Dovish
14,27, 파산/NNG;막/VV,41,0.7529029965018337,Dovish
108,220, 모자란/VV,328,0.7128133564283595,Dovish
22,52, 매치/NNG,74,0.614319203189683,Dovish
31,65, 회의론/NNG,96,0.6925052835956428,Dovish
25,49, 예상/NNG;하향/NNG,74,0.7408302079281892,Dovish
14,32, 마스터플랜/NNG,46,0.6352619032984222,Dovish
12,24, 소비자/NNG;물가/NNG;마이너스/NNG,36,0.7260136037696254,Dovish
5,12, 금융시장/NNG;환호/NNG,17,0.6050113364746877,Dovish
5,20, 유로존/NNG;금융안정/NNG,25,0.3630068018848127,Dovish
218,490, 가뭄/NNG,708,0.646003941313381,Dovish
16,58, 글로벌/NNG;금융시장/NNG;위험/NNG,74,0.4005592296660002,Dovish
5,28, 담보/NNG;조건/NNG;완화/NNG,33,0.2592905727748662,Dovish
5,16, 들어섬/VV,21,0.4537585023560159,Dovish
10,26, 시킨/VV,36,0.5584720028997119,Dovish
5,26, 안정/NNG;성공/NNG,31,0.27923600144985594,Dovish
90,194, 오바마케어/NNG,284,0.673620869476972,Dovish
5,17, 학실/NNG,22,0.42706682574683846,Dovish
24,53, 결승/NNG,77,0.6575217543573967,Dovish
17,41, 푀/NNG,58,0.6020600616626163,Dovish
13,26, 원한/VV,39,0.7260136037696254,Dovish
26,56, 젼/NNG,82,0.6741554892146522,Dovish
85,172, 아트/NNG,257,0.7175715851211414,Dovish
6,14, 고용/NNG;부진/NNG;우려/NNG,20,0.622297374659679,Dovish
8,24, 정책/NNG;효과/NNG;높/VV,32,0.4840090691797502,Dovish
7,33, 투자/NNG;소극적/VAX,40,0.3080057712962047,Dovish
56,152, 구제기금/NNG,208,0.5349573922513029,Dovish
8,17, 개발기금/NNG,25,0.6833069211949414,Dovish
20,44, 자주/NNG,64,0.6600123670632958,Dovish
8,17, 장력/NNG,25,0.6833069211949414,Dovish
10,30, 유로존/NNG;위기/NNG;우려/NNG,40,0.48400906917975023,Dovish
9,24, 해외/NNG;수요/NNG;부진/NNG,33,0.5445102028272191,Dovish
3,13, 기대/NNG;우위/NNG,16,0.33508320173982714,Dovish
149,300, 응방/NNG,449,0.7211735130778278,Dovish
65,198, 잔금대출/NNG,263,0.47667559843460244,Dovish
24,46, 미달사태/NNG,70,0.7575794126291744,Dovish
9,21, 기대/NNG;감소/NNG,30,0.6222973746596789,Dovish
729,1394,위기/NNG,2123,0.759345648705964,Dovish
6,14, 대출/NNG;여력/NNG;확대/NNG,20,0.622297374659679,Dovish
5,14, 위기/NNG;차단/NNG,19,0.5185811455497324,Dovish
3015,6034,유로/NNG,9049,0.7255323219640109,Dovish
73,172, 재정/NNG;안정/NNG,245,0.6162673613393332,Dovish
40,132, 지하경제/NNG,172,0.44000824470886385,Dovish
12,25, 시당/NNG,37,0.6969730596188405,Dovish
12,25, 튼실/NNG,37,0.6969730596188405,Dovish
5,70, 할금/MAG,75,0.10371622910994649,Dovish
231,460, 침해/NNG,691,0.7291701846555804,Dovish
16,32, 민족주의/NNG,48,0.7260136037696253,Dovish
5,32, 극우파/NNG,37,0.22687925117800795,Dovish
29,71, 잠재웠/VV,100,0.5930815354737784,Dovish
6,12, 유로뱅크/NNG,18,0.7260136037696254,Dovish
11,39, 채권시장/NNG;외국인/NNG;자금/NNG;이탈/NNG,50,0.4095461354597887,Dovish
18,52, 거품/NNG;붕괴/NNG;우려/NNG,70,0.5026248026097407,Dovish
5,18, 구조개혁/NNG;성장/NNG,23,0.4033408909831252,Dovish
9,21, 재정/NNG;성장/NNG,30,0.6222973746596789,Dovish
63,150, 경제/NNG;심각/NNG,213,0.6098514271664853,Dovish
96,197, 실업률/NNG;낮/VA,293,0.7075868625571985,Dovish
22,44,유리/NNG,66,0.7260136037696254,Dovish
8,18, 글로벌/NNG;안전자산/NNG;선호/NNG;약화/NNG,26,0.6453454255730003,Dovish
4,17, 경기/NNG;부양/NNG;기대/NNG;높/VA,21,0.3416534605974707,Dovish
6,12, 환경기준/NNG,18,0.7260136037696254,Dovish
10,29, 좁힌/VV,39,0.5006990370825003,Dovish
7,30, 금리/NNG;대출/NNG;금리/NNG;인하/NNG,37,0.3388063484258252,Dovish
8,18, 경기/NNG;금리/NNG;인하/NNG,26,0.6453454255730003,Dovish
7,26, 이자/NNG;수입/NNG;감소/NNG,33,0.3909304020297983,Dovish
22,55, 이자/NNG;상환/NNG;부담/NNG,77,0.5808108830157003,Dovish
8,24, 금리/NNG;인하/NNG;제약/NNG,32,0.4840090691797502,Dovish
7,22, 심리/NNG;제약/NNG,29,0.4620086569443071,Dovish
36,81, 한방/NNG,117,0.6453454255730005,Dovish
448,947, 취약계층/NNG,1395,0.6869146662910077,Dovish
7,32, 경기/NNG;하향/NNG;위험/NNG,39,0.3176309516492111,Dovish
8,19, 부채/NNG;해소/NNG,27,0.6113798768586319,Dovish
17,34, 고점/NNG;낮/VA,51,0.7260136037696254,Dovish
7,22, 금리/NNG;인하/NNG;위험/NNG,29,0.4620086569443071,Dovish
69,185,깜짝/MAG,254,0.5415669044335585,Dovish
74,143, 가게/NNG,217,0.7513986948105215,Dovish
6,16, 국제/NNG;금융시장/NNG;불안/NNG;완화/NNG,22,0.5445102028272191,Dovish
62,151, 깜짝/MAG;금리/NNG;인하/NNG,213,0.5961966017710831,Dovish
26,63, 가계/NNG;부채/NNG;증가/NNG;우려/NNG,89,0.5992493237463574,Dovish
6,16, 금리/NNG;인하/NNG;강세/NNG,22,0.5445102028272191,Dovish
23,51, 성장/NNG;친화/NNG,74,0.6548357994784856,Dovish
17,34, 경감/NNG;효과/NNG,51,0.7260136037696254,Dovish
79,161, 급선회/NNG,240,0.7124853999726759,Dovish
13,34, 자금액/NNG,47,0.55518687347089,Dovish
12,25, 국채/NNG;금리/NNG;소폭/MAG;상승/NNG,37,0.6969730596188405,Dovish
38,98, 통안채/NNG;금리/NNG;내리/VV,136,0.5630309580254238,Dovish
105,204, 헌/XSV,309,0.7473669450569673,Dovish
7,17, 예정가/NNG,24,0.5978935560455738,Dovish
21,48, 근로소득세/NNG,69,0.6352619032984221,Dovish
5,13, 당세/NNG,18,0.5584720028997119,Dovish
15,44, 재정정책/NNG;불확실성/NNG,59,0.49500927529747185,Dovish
5,11, 심각/NNG;부정적/VAX,16,0.6600123670632958,Dovish
13,36, 선가/NNG,49,0.5243431582780628,Dovish
33,65, 살린/VV,98,0.7371830438276197,Dovish
14,35, 군함/NNG,49,0.5808108830157003,Dovish
15,31, 수주/NNG;호조/NNG,46,0.7025938100996375,Dovish
21,46, 위험/NNG;취약/NNG,67,0.6628819860505275,Dovish
66,147,만나/VV,213,0.6519305829768064,Dovish
22,48, 끌어낼/VV,70,0.6655124701221565,Dovish
38,76, 도화선/NNG,114,0.7260136037696254,Dovish
17,33, 경지/NNG,50,0.7480140160050687,Dovish
5,19, 경제/NNG;성장/NNG;강화/NNG,24,0.38211242303664494,Dovish
6,21, 세계/NNG;경제/NNG;악화/NNG,27,0.41486491643978596,Dovish
48,102, 금세/MAG,150,0.6833069211949415,Dovish
5,13, 세계/NNG;성장률/NNG;하향/NNG,18,0.5584720028997119,Dovish
205,406,국채시장/NNG,611,0.7331664471565182,Dovish
219,484, 국채/NNG;가격/NNG;하락/NNG,703,0.6570123108493718,Dovish
7,18, 슬/MAG,25,0.5646772473763753,Dovish
26,52, 퇴직급여/NNG,78,0.7260136037696254,Dovish
56,110, 상속세/NNG,166,0.7392138511108913,Dovish
454,876, 사기/NNG,1330,0.752534648656187,Dovish
8,16, 서비스경제/NNG,24,0.7260136037696253,Dovish
12,37, 유동성/NNG;공급/NNG;금리/NNG;인하/NNG,49,0.47092774298570295,Dovish
7,20, 정책/NNG;효과/NNG;제한적/VAX,27,0.5082095226387378,Dovish
19,44, 교역/NNG;감소/NNG,63,0.6270117487101311,Dovish
6,13, 둔화/NNG;방지/NNG,19,0.6701664034796543,Dovish
1080,2145,저금리/NNG,3225,0.7310906219778045,Dovish
18,35, 소비자/NNG;물가/NNG;상승률/NNG;하락/NNG,53,0.7467568495916148,Dovish
60,115, 달린/VV,175,0.7575794126291744,Dovish
17,71, 지준부리/NNG;인하/NNG,88,0.347668486312215,Dovish
6,15, 두들겨/VV,21,0.5808108830157004,Dovish
57,137, 도비/NNG,194,0.6041281082462576,Dovish
20,42, 플래시/NNG,62,0.6914415273996433,Dovish
29,59, 금리/NNG;인하/NNG;가능성/NNG;배제/NNG,88,0.7137082884514961,Dovish
10,27, 경제주체/NNG;심리/NNG;회복/NNG,37,0.5377878546441669,Dovish
17,38, 유동성/NNG;위기/NNG;빠지/VV,55,0.6495911191622965,Dovish
15,43, 경기/NNG;심각/NNG,58,0.506521118909041,Dovish
62,133, 신용등급/NNG;낮/VV,195,0.6768848636649138,Dovish
23,45, 운운/NNG,68,0.7421472394089503,Dovish
7,27, 묻어났/VV,34,0.37645149825091684,Dovish
5,36, 금리/NNG;인하/NNG;가계/NNG;부채/NNG;증가/NNG,41,0.2016704454915626,Dovish
15,33, 인하/NNG;기대/NNG;약화/NNG,48,0.6600123670632958,Dovish
6,13, 약하/VA;금리/NNG;인하/NNG,19,0.6701664034796543,Dovish
6,17, 길/VA;지지/NNG;않/VX,23,0.5124801908962061,Dovish
16,32, 핵심/NNG;위험/NNG,48,0.7260136037696253,Dovish
13,39, 소비자/NNG;물가/NNG;상승률/NNG;최저/NNG,52,0.4840090691797503,Dovish
14,28, 경기/NNG;회복/NNG;불씨/NNG;살/VV,42,0.7260136037696254,Dovish
7,21, 높/VA;경기/NNG;부양/NNG,28,0.4840090691797503,Dovish
5,14, 경기/NNG;위축/NNG;막/VV,19,0.5185811455497324,Dovish
3,13, 근원/NNG;인플레이션/NNG;소폭/MAG;하락/NNG,16,0.33508320173982714,Dovish
5,11, 인플레이션/NNG;우려/NNG;금리/NNG;인하/NNG,16,0.6600123670632958,Dovish
6,12, 금리/NNG;경기/NNG;둔화/NNG,18,0.7260136037696254,Dovish
7,15, 예상/NNG;인하/NNG,22,0.6776126968516504,Dovish
6,19, 싱크/NNG,25,0.458534907643974,Dovish
5,11, 초록/NNG,16,0.6600123670632958,Dovish
6,14, 경제/NNG;회복/NNG;제약/NNG,20,0.622297374659679,Dovish
7,19, 제사/NNG,26,0.5349573922513029,Dovish
221,465,위험자산/NNG,686,0.6901032534756439,Dovish
10,22, 위험자산/NNG;약세/NNG,32,0.6600123670632958,Dovish
10,30, 국제/NNG;곡물/NNG;가격/NNG;급등/NNG,40,0.48400906917975023,Dovish
18,38, 살펴본다/VV,56,0.687802361465961,Dovish
14,33, 합쳐도/VV,47,0.6160115425924094,Dovish
8,27, 외채/NNG;많/VA,35,0.4302302837153335,Dovish
64,125, 아랑곳/NNG,189,0.7434379302600964,Dovish
100,194, 공제회/NNG,294,0.7484676327521912,Dovish
21,48, 투자/NNG;가격/NNG;높/VA,69,0.6352619032984221,Dovish
74,162, 부당이득/NNG,236,0.6632716873944726,Dovish
58,173, 집단소송/NNG,231,0.48680680946402627,Dovish
9,25, 민법/NNG,34,0.5227297947141304,Dovish
91,203, 실무자/NNG,294,0.6509087482072503,Dovish
8,18, 선물옵션시장/NNG,26,0.6453454255730003,Dovish
83,200, 금전/NNG,283,0.6025912911287891,Dovish
21,53, 식물/NNG,74,0.575331535062722,Dovish
23,58, 주택부금/NNG,81,0.5758038926448753,Dovish
6,15, 가계/NNG;대출/NNG;금리/NNG;인하/NNG,21,0.5808108830157004,Dovish
18,56, 자금/NNG;조달/NNG;비용/NNG;상승/NNG,74,0.46672303099475926,Dovish
5,13, 자산/NNG;건전성/NNG;확보/NNG,18,0.5584720028997119,Dovish
434,980,구제금융/NNG,1414,0.6430406204816683,Dovish
19,47, 제각각/MAG,66,0.5869897221967184,Dovish
18,63, 밋/NNG,81,0.41486491643978596,Dovish
21,46, 금융위기/NNG;최악/NNG,67,0.6628819860505275,Dovish
6,12, 내수/NNG;악영향/NNG,18,0.7260136037696254,Dovish
108,213, 경기/NNG;나쁘/VA,321,0.7362391474846905,Dovish
41,116, 연례회의/NNG,157,0.5132165130095628,Dovish
29,111, 국채/NNG;금리/NNG;마이너스/NNG,140,0.3793584596273718,Dovish
38,77, 채권/NNG;금리/NNG;낮/VA,115,0.7165848556687212,Dovish
5,16, 성장/NNG;악화/NNG,21,0.4537585023560159,Dovish
5,18, 래퍼/NNG,23,0.4033408909831252,Dovish
39,76, 돌려야/VV,115,0.7451192249214577,Dovish
34,67, 미뤄진/VV,101,0.7368496277064855,Dovish
26,61, 베일/NNG,87,0.6188968425577135,Dovish
25,53, 기권/NNG,78,0.6849184941222882,Dovish
8,28, 글로벌/NNG;경제/NNG;부진/NNG,36,0.41486491643978596,Dovish
6,25, 정부조달/NNG,31,0.34848652980942024,Dovish
2,25, 파임/NNG,27,0.11616217660314006,Dovish
74,160, 장학/NNG,234,0.6715625834869035,Dovish
56,154, 기업/NNG;실적/NNG;우려/NNG,210,0.5280098936506367,Dovish
10,20, 신용등급/NNG;회복/NNG,30,0.7260136037696254,Dovish
247,484,이벤트/NNG,731,0.7410138848392458,Dovish
18,46, 정책/NNG;긍정적/VAX,64,0.5681845594718807,Dovish
9,20, 예상/NNG;반대/NNG,29,0.6534122433926629,Dovish
69,141, 퍼/VV,210,0.7105665058170803,Dovish
6,14, 주택가격/NNG;고점/NNG,20,0.622297374659679,Dovish
22,48, 실업률/NNG;급등/NNG,70,0.6655124701221565,Dovish
5,13, 정책/NNG;확장/NNG,18,0.5584720028997119,Dovish
7,14, 세계/NNG;경제/NNG;침체/NNG;빠지/VV,21,0.7260136037696254,Dovish
6,12, 선진국/NNG;재정/NNG;긴축/NNG,18,0.7260136037696254,Dovish
15,36, 경제/NNG;위기/NNG;우려/NNG,51,0.6050113364746877,Dovish
7,15, 국채/NNG;발행/NNG;감소/NNG,22,0.6776126968516504,Dovish
10,21, 경제/NNG;역성장/NNG,31,0.6914415273996433,Dovish
6,14, 성장/NNG;감소/NNG,20,0.622297374659679,Dovish
6,13, 저버린/VV,19,0.6701664034796543,Dovish
6,15, 글로벌/NNG;위험자산/NNG;강세/NNG,21,0.5808108830157004,Dovish
7,33, 총액/NNG;한도/NNG;대출/NNG;확대/NNG,40,0.3080057712962047,Dovish
27,52, 강력/NNG;경기/NNG;부양/NNG,79,0.7539372039146109,Dovish
7,25, 남겨둬야/VV,32,0.40656761811099024,Dovish
23,51, 수출/NNG;내수/NNG;부진/NNG,74,0.6548357994784856,Dovish
8,26, 지수/NNG;금리/NNG;인하/NNG,34,0.44677760231976943,Dovish
6,18, 불안/NNG;금리/NNG;인하/NNG,24,0.4840090691797503,Dovish
16,44, 통화/NNG;방어/NNG,60,0.5280098936506367,Dovish
27,59, 앞당긴/VV,86,0.6644870271789792,Dovish
17,51, 금리/NNG;인하/NNG;부작용/NNG,68,0.4840090691797503,Dovish
28,54, 부진/NNG;성장/NNG,82,0.7529029965018337,Dovish
26,56, 패스/NNG,82,0.6741554892146522,Dovish
17,33, 금리/NNG;인하/NNG;불확실성/NNG,50,0.7480140160050687,Dovish
33,66, 확약/NNG,99,0.7260136037696253,Dovish
12,29, 청산가치/NNG,41,0.6008388444990004,Dovish
9,22, 우려/NNG;국채/NNG;금리/NNG;상승/NNG,31,0.5940111303569663,Dovish
8,18, 유로존/NNG;위기/NNG;해소/NNG,26,0.6453454255730003,Dovish
13,29, 국채/NNG;금리/NNG;낮/VV,42,0.6509087482072504,Dovish
46,90, 종자/NNG,136,0.7421472394089503,Dovish
40,94, 움/NNG,134,0.6178839181018089,Dovish
153,335, 사과/NNG,488,0.6631646649358369,Dovish
10,21, 전망/NNG;밝/VA;못하/VX,31,0.6914415273996433,Dovish
9,40, 선택적디폴트/NNG,49,0.32670612169633145,Dovish
13,26, 국제/NNG;신용등급/NNG;상향/NNG,39,0.7260136037696254,Dovish
235,481, 불어넣/VV,716,0.7094103820617962,Dovish
12,25, 내수/NNG;수출/NNG;부진/NNG,37,0.6969730596188405,Dovish
21,55, 세계/NNG;경제/NNG;성장률/NNG;전망/NNG;하향/NNG,76,0.5544103883331685,Dovish
4,13, 부진/NNG;마이너스/NNG,17,0.44677760231976943,Dovish
17,38, 거용/NNG,55,0.6495911191622965,Dovish
9,18, 실물/NNG;경기/NNG;부양/NNG,27,0.7260136037696254,Dovish
7,19, 유로존/NNG;마이너스성장/NNG,26,0.5349573922513029,Dovish
13,27, 세계/NNG;교역/NNG;신장/NNG,40,0.6991242110374171,Dovish
5,18, 불확실성/NNG;부정적/VAX,23,0.4033408909831252,Dovish
12,28, 가계/NNG;대출/NNG;감소/NNG,40,0.622297374659679,Dovish
117,226, 소비/NNG;진작/NNG,343,0.7517132003632404,Dovish
6,13, 기업/NNG;실적/NNG;부진/NNG;하락/NNG,19,0.6701664034796543,Dovish
12,24, 원화/NNG;강세/NNG;막/VV,36,0.7260136037696254,Dovish
6,18, 인하/NNG;기대/NNG;약하/VA,24,0.4840090691797503,Dovish
12,24, 영토분쟁/NNG,36,0.7260136037696254,Dovish
8,19, 재정상황/NNG;악화/NNG,27,0.6113798768586319,Dovish
62,154, fed/NNG;완화/NNG,216,0.584582382256062,Dovish
5,13, 전망/NNG;위협/NNG,18,0.5584720028997119,Dovish
731,1550,정치/NNG,2281,0.6847947669104467,Dovish
109,245, 현직/NNG,354,0.646003941313381,Dovish
21,41, 정치/NNG;경제/NNG;불확실성/NNG,62,0.7437212526420554,Dovish
13,26, 단기물/NNG;금리/NNG;인하/NNG,39,0.7260136037696254,Dovish
26,51, 미약/NNG;경기/NNG;회복/NNG,77,0.7402491646278533,Dovish
5,16, 약하/VA;경기/NNG;회복/NNG,21,0.4537585023560159,Dovish
116,252, 기술금융/NNG,368,0.6683934764863217,Dovish
20,49, 방지책/NNG,69,0.5926641663425514,Dovish
6,19, 주택시장/NNG;지수/NNG;상승/NNG,25,0.458534907643974,Dovish
7,17, 공기업/NNG;투자/NNG;확대/NNG,24,0.5978935560455738,Dovish
3,15, 예상/NNG;경제/NNG;성장/NNG,18,0.2904054415078502,Dovish
7,28, 하방/NNG;위험/NNG;우세/NNG,35,0.3630068018848127,Dovish
12,26, 일시적/VAX;회복/NNG,38,0.6701664034796543,Dovish
5,16, 인하/NNG;파급효과/NNG,21,0.4537585023560159,Dovish
11,25, 유로존/NNG;부진/NNG,36,0.6388919713172704,Dovish
10,64,미매각/NNG,74,0.22687925117800795,Dovish
2100,4140,성장률/NNG,6240,0.7365355400561417,Dovish
24,73, 목상/NNG,97,0.4773788079581099,Dovish
15,39, 위험/NNG;선호/NNG;강화/NNG,54,0.5584720028997118,Dovish
7,21, 성장/NNG;침체/NNG,28,0.4840090691797503,Dovish
33,64, 성장/NNG;부양/NNG,97,0.7487015288874261,Dovish
101,243, 공포지수/NNG,344,0.6035174813228985,Dovish
8,28, 물가/NNG;압력/NNG;높/VV,36,0.41486491643978596,Dovish
6,13, 두건/NNG,19,0.6701664034796543,Dovish
10,22, 수익자부담/NNG,32,0.6600123670632958,Dovish
14,29, 선불/NNG,43,0.7009786519155004,Dovish
24,48, 인하/NNG;압력/NNG,72,0.7260136037696254,Dovish
40,78, 결정일/NNG,118,0.7446293371996158,Dovish
5,18, 당무/NNG,23,0.4033408909831252,Dovish
48,113, 통행/NNG,161,0.6167903182467614,Dovish
10,40, 세계/NNG;경제/NNG;둔화/NNG;우려/NNG,50,0.3630068018848127,Dovish
124,244, 미/NNG;국채/NNG;금리/NNG;하락/NNG,368,0.7379154661265046,Dovish
1,18, 탈퇴/NNG;우려/NNG;완화/NNG,19,0.08066817819662504,Dovish
29,62, 경제/NNG;여건/NNG;악화/NNG,91,0.6791740164296496,Dovish
7,19, 차입/NNG;여건/NNG;악화/NNG,26,0.5349573922513029,Dovish
9,20, 소비/NNG;여력/NNG;확대/NNG,29,0.6534122433926629,Dovish
12,30, 자금/NNG;유입/NNG;줄/VV,42,0.5808108830157004,Dovish
4,15, 수입관세/NNG;인하/NNG,19,0.3872072553438002,Dovish
80,156, 계단/NNG,236,0.7446293371996158,Dovish
14,27, 이뤄짐에/VV,41,0.7529029965018337,Dovish
35,71, 뒤지/VV,106,0.7157880600545603,Dovish
15,47, 선거일/NNG,62,0.4634129385763566,Dovish
129,330, 경제민주화/NNG,459,0.5676106356744344,Dovish
232,448, 인권/NNG,680,0.751942661047112,Dovish
21,42, 힐링/NNG,63,0.7260136037696254,Dovish
7,18, 산법/NNG,25,0.5646772473763753,Dovish
3,14, 불확실성/NNG;강세/NNG,17,0.3111486873298395,Dovish
17,34, 경제/NNG;견인/NNG,51,0.7260136037696254,Dovish
98,204, 대타협/NNG,302,0.6975424820531695,Dovish
160,327, 실업률/NNG;떨어/VV,487,0.7104720281537619,Dovish
12,30, 발간/VA,42,0.5808108830157004,Dovish
7,14, 세계/NNG;경기/NNG;성장/NNG,21,0.7260136037696254,Dovish
5,11, 인플레이션/NNG;상회/NNG,16,0.6600123670632958,Dovish
10,46, 국채입찰/NNG;실망/NNG,56,0.3156580885954893,Dovish
82,176, 국민행복기금/NNG,258,0.6765126762398782,Dovish
17,35, 집합/NNG,52,0.7052703579476362,Dovish
23,50, 소지자/NNG,73,0.6679325154680553,Dovish
7,17, 환청/NNG,24,0.5978935560455738,Dovish
10,25, 구권/NNG,35,0.5808108830157004,Dovish
48,93, 가계/NNG;대출/NNG;부실/NNG,141,0.7494333974396133,Dovish
23,51, 성장동력/NNG;확충/NNG,74,0.6548357994784856,Dovish
44,249, 협상안/NNG,293,0.25658312101095193,Dovish
12,55, 베어링/NNG,67,0.316805936190382,Dovish
101,194, 궁금증/NNG,295,0.7559523090797131,Dovish
13,41, 위험군/NNG,54,0.4603988706831771,Dovish
26,64, 기울어져/VV,90,0.5898860530628207,Dovish
6,17, 강력/NNG;통화/NNG;완화/NNG,23,0.5124801908962061,Dovish
15,32, 비관/NNG;않/VX,47,0.6806377535340238,Dovish
11,29, 아이디/NNG,40,0.5507689407907503,Dovish
37,89, 참모/NNG,126,0.6036517604376661,Dovish
13,26, 사방/NNG,39,0.7260136037696254,Dovish
13,26, 사병/NNG,39,0.7260136037696254,Dovish
32,88, 모하메드/NNG,120,0.5280098936506367,Dovish
46,90, 선명/NNG,136,0.7421472394089503,Dovish
10,35, 군단/NNG,45,0.41486491643978596,Dovish
7,14, 겹겹이/MAG,21,0.7260136037696254,Dovish
8,38, 허비/NNG,46,0.30568993842931597,Dovish
32,63, 무용지물/NNG,95,0.7375376292262861,Dovish
15,29, 재정/NNG;불확실성/NNG,44,0.7510485556237504,Dovish
12,23, 통화정책/NNG;성장/NNG;회복/NNG,35,0.7575794126291744,Dovish
5,11, 절상/NNG;완화/NNG,16,0.6600123670632958,Dovish
68,132, 채권/NNG;가격/NNG;강세/NNG,200,0.7480140160050687,Dovish
1301,2532, 사들이/VV,3833,0.746085069908596,Dovish
54,214,부채한도/NNG,268,0.36639938881831563,Dovish
96,218, 매일/NNG,314,0.6394248253383857,Dovish
205,489, 신조/NNG,694,0.60872306246533,Dovish
36,132, 디폴트/NNG;빠지/VV,168,0.3960074202379775,Dovish
9,18, 투자/NNG;넘/VV,27,0.7260136037696254,Dovish
5,15, 부양책/NNG;경기/NNG;회복/NNG,20,0.48400906917975023,Dovish
27,53, 아직/MAG;불확실성/NNG,80,0.7397119736520712,Dovish
55,107, 톰/NNG,162,0.7463691253706429,Dovish
10,34, 과학자/NNG,44,0.42706682574683846,Dovish
8,28, 직업군/NNG,36,0.41486491643978596,Dovish
90,178, 보스턴/NNG,268,0.7341710599917559,Dovish
38,101, 불안해하/VV,139,0.5463072662028865,Dovish
5,15, 괴로운/VA,20,0.48400906917975023,Dovish
5,16, 부진/NNG;원화/NNG;강세/NNG,21,0.4537585023560159,Dovish
22,59, 우려/NNG;점차/MAG;크/VV,81,0.5414338739976867,Dovish
15,29, 빨리/MAG;성장/NNG,44,0.7510485556237504,Dovish
53,152, 자산/NNG;매입/NNG;종료/NNG,205,0.5062989605235546,Dovish
341,829, 경제/NNG;살/VV,1170,0.5972753652242274,Dovish
19,82, 신고자/NNG,101,0.3364453285761679,Dovish
6,14, 금융위기/NNG;안전자산/NNG;선호/NNG,20,0.622297374659679,Dovish
25,56, 가계/NNG;대출/NNG;확대/NNG,81,0.6482264319371656,Dovish
5,11, 명언/NNG,16,0.6600123670632958,Dovish
10,20, 일찍이/MAG,30,0.7260136037696254,Dovish
4,12, 일개/NNG,16,0.4840090691797502,Dovish
8,18, 귀족/NNG,26,0.6453454255730003,Dovish
5,11, 무디/NNG,16,0.6600123670632958,Dovish
35,78, 번졌/VV,113,0.6515506700496638,Dovish
26,63, 냈으며/VV,89,0.5992493237463574,Dovish
18,36, 군불/NNG,54,0.7260136037696254,Dovish
22,51, 들이대/VV,73,0.6263646777620296,Dovish
5,12, 노린다면/VV,17,0.6050113364746877,Dovish
4,19, 가계/NNG;부채/NNG;잠재/NNG;위험/NNG,23,0.30568993842931597,Dovish
6,14, 채권/NNG;평가손실/NNG;우려/NNG,20,0.622297374659679,Dovish
19,37, 원화/NNG;강세/NNG;우려/NNG,56,0.7456355930606964,Dovish
25,56, 무제한/NNG;양적완화/NNG,81,0.6482264319371656,Dovish
54,216, fed/NNG;양적완화/NNG;종료/NNG,270,0.36300680188481266,Dovish
7,15, 둔화/NNG;금리/NNG;인하/NNG,22,0.6776126968516504,Dovish
10,22, 버텨왔/VV,32,0.6600123670632958,Dovish
9,24, 자국/NNG;경기/NNG;부양/NNG,33,0.5445102028272191,Dovish
433,1247, 새누리당/NNG,1680,0.5041922861784247,Dovish
212,427, 지사/NNG,639,0.7209128056166773,Dovish
53,114, 기초생활수급자/NNG,167,0.6750652806980727,Dovish
9,18, 부딪칠/VV,27,0.7260136037696254,Dovish
8,23, 불확실성/NNG;점증/NNG,31,0.5050529417527828,Dovish
32,63, 금융시장/NNG;우려/NNG,95,0.7375376292262861,Dovish
7,27, 임금/NNG;줄/VV,34,0.37645149825091684,Dovish
8,26, 지켜져야/VV,34,0.44677760231976943,Dovish
61,153, 남녀/NNG,214,0.5789128082346033,Dovish
4,14, 사라진다고/VV,18,0.41486491643978596,Dovish
5,17,꺾/VV,22,0.42706682574683846,Dovish
124,252, 호실적/NNG,376,0.7144895783129647,Dovish
40,80, 들어선다/VV,120,0.7260136037696254,Dovish
9,18, 금리/NNG;인하/NNG;재정/NNG;지출/NNG;확대/NNG,27,0.7260136037696254,Dovish
31,91, 금리/NNG;인하/NNG;기대/NNG;살/VV,122,0.49464663113974483,Dovish
4,16, 불안/NNG;확산/NNG;차단/NNG,20,0.36300680188481266,Dovish
6,15, 어렵/VA;추세/NNG,21,0.5808108830157004,Dovish
69,171, 전망/NNG;내리/VV,240,0.5859057153228556,Dovish
20,40, 하락/NNG;늘/VV,60,0.7260136037696254,Dovish
149,314, 여/VV,463,0.6890192800106635,Dovish
181,395, 할지/VV,576,0.665359302695201,Dovish
11,29, 득과실/NNG,40,0.5507689407907503,Dovish
5,12, 수요/NNG;압력/NNG;약화/NNG,17,0.6050113364746877,Dovish
18,76, 추경/NNG;편성/NNG;금리/NNG;인하/NNG,94,0.3439011807329805,Dovish
2,20, 대내외/NNG;금리갭/NNG;축소/NNG,22,0.14520272075392507,Dovish
10,31, 금리/NNG;인하/NNG;소극적/VAX,41,0.46839587339975836,Dovish
60,127, 받아들여야/VV,187,0.6859971059240555,Dovish
24,49, 필사/NNG,73,0.7111969996110616,Dovish
9,26, 대원칙/NNG,35,0.5026248026097407,Dovish
13,26, 어긋난다/VV,39,0.7260136037696254,Dovish
71,140, 자유무역/NNG,211,0.7363852266806201,Dovish
4,13, 위조지폐/NNG,17,0.44677760231976943,Dovish
2,21, 현안회의/NNG,23,0.13828830547992862,Dovish
5,20, 일생/NNG,25,0.3630068018848127,Dovish
136,267, 업그레이드/NNG,403,0.7396093641398431,Dovish
33,66, 경제/NNG;성장/NNG;부진/NNG,99,0.7260136037696253,Dovish
12,23, 최대/NNG;높/VA,35,0.7575794126291744,Dovish
103,285, 수출/NNG;줄/VV,388,0.5247677276369924,Dovish
27,60, 결정배경/NNG,87,0.6534122433926628,Dovish
3,20, 경제/NNG;성장/NNG;전망/NNG;하향/NNG,23,0.21780408113088762,Dovish
5,13, 가격/NNG;모멘텀/NNG,18,0.5584720028997119,Dovish
10,21, 법질서/NNG,31,0.6914415273996433,Dovish
71,161, 금산분리/NNG,232,0.6403349797222784,Dovish
4,17, 전속고발권/NNG,21,0.3416534605974707,Dovish
183,366, 감사원/NNG,549,0.7260136037696254,Dovish
152,403, 창조경제/NNG,555,0.5476628673597175,Dovish
30,84, 장려금/NNG,114,0.5185811455497324,Dovish
29,62, 중증/NNG,91,0.6791740164296496,Dovish
7,16, 감도/NNG,23,0.6352619032984222,Dovish
20,43, 성장/NNG;잠재력/NNG;저하/NNG,63,0.6753614918787213,Dovish
25,54, 오성/NNG,79,0.6722348183052087,Dovish
7,17, 양도소득/NNG,24,0.5978935560455738,Dovish
6,33, 중앙청/NNG,39,0.26400494682531833,Dovish
38,81, 산소/NNG,119,0.6811979492159449,Dovish
13,27, 미비점/NNG,40,0.6991242110374171,Dovish
14,30, 다목/NNG,44,0.6776126968516504,Dovish
105,223, 금리/NNG;인하/NNG;기대/NNG;크/VV,328,0.6836899407696024,Dovish
19,47, 글로벌/NNG;경기/NNG;부양/NNG,66,0.5869897221967184,Dovish
7,25, 유로존/NNG;정치/NNG;위험/NNG,32,0.40656761811099024,Dovish
5,11, 위험/NNG;유동성/NNG;위험/NNG,16,0.6600123670632958,Dovish
9,19, 수주/NNG;회복/NNG,28,0.687802361465961,Dovish
17,46, 높/VA;경계/NNG,63,0.5366187506123319,Dovish
13,35,토빈세/NNG,48,0.5393243913717217,Dovish
6,19, 토빈/NNG,25,0.458534907643974,Dovish
169,383, 협의체/NNG,552,0.6407117443188861,Dovish
69,136, 아내/NNG,205,0.7366902744132964,Dovish
26,66, 마당/NNG,92,0.572010718121523,Dovish
7,14, 미룬다/VV,21,0.7260136037696254,Dovish
14,31, 교묘/NNG,45,0.6557542227596617,Dovish
98,226, 출장/NNG,324,0.629640116543569,Dovish
262,504, 만난/VV,766,0.7548236674112772,Dovish
7,38, 정책/NNG;공조/NNG;차원/NNG;금리/NNG;인하/NNG,45,0.26747869612565145,Dovish
3,24, 녹여/VV,27,0.18150340094240636,Dovish
49,96, 사록/NNG,145,0.7411388871814926,Dovish
20,60, 퇴조/NNG,80,0.48400906917975023,Dovish
38,73, 투자/NNG;선호/NNG,111,0.7558497792670074,Dovish
270,673,인하/NNG,943,0.5825369183292685,Dovish
4,21, 추경/NNG;경기/NNG;부양/NNG,25,0.27657661095985725,Dovish
6,19, 늦/VA;금리/NNG;인하/NNG,25,0.458534907643974,Dovish
43,98, 좌초/NNG,141,0.6371139788182427,Dovish
218,424, 역세권/NNG,642,0.7465611585932941,Dovish
10,23, 따라다니/VV,33,0.6313161771909785,Dovish
296,597, 사업비/NNG,893,0.7199330878251562,Dovish
5,11, 출자회사/NNG,16,0.6600123670632958,Dovish
11,40, 역마진/NNG;부담/NNG,51,0.3993074820732939,Dovish
44,94, 부동산/NNG;경기/NNG;활성화/NNG,138,0.6796723099119898,Dovish
25,93, 추경/NNG;금리/NNG;인하/NNG,118,0.3903298944997986,Dovish
6,16, 물가/NNG;안정/NNG;저해/NNG,22,0.5445102028272191,Dovish
26,53, 블랙스완/NNG,79,0.7123152338871797,Dovish
33,69, 역마진/NNG;우려/NNG,102,0.6944477949100764,Dovish
13,26, 맞바꾸/VV,39,0.7260136037696254,Dovish
335,659, 경제부/NNG,994,0.7381321919964325,Dovish
61,118, 물음/NNG,179,0.750624234405884,Dovish
89,253, 자진/NNG,342,0.5107921797272463,Dovish
11,28, 경제컨트롤타워/NNG,39,0.5704392601047057,Dovish
5,15, 비집/VV,20,0.48400906917975023,Dovish
64,139, 현장방문/NNG,203,0.6685592898022449,Dovish
8,19, 자금/NNG;위험/NNG,27,0.6113798768586319,Dovish
90,176, 불확실성/NNG;증폭/NNG,266,0.7425139129462078,Dovish
90,177,더욱/MAG,267,0.7383189190877546,Dovish
9,20, 화방/NNG,29,0.6534122433926629,Dovish
29,68, 투자/NNG;수요/NNG;늘/VV,97,0.6192468973329157,Dovish
32,76, 대부업/NNG;고금리/NNG,108,0.6113798768586319,Dovish
16,38, 대출/NNG;고금리/NNG,54,0.6113798768586319,Dovish
7,17, 장기물/NNG;강하/VA,24,0.5978935560455738,Dovish
77,164, 금리/NNG;인하/NNG;압력/NNG,241,0.6817444815885507,Dovish
8,21, 금리/NNG;전망/NNG;낮/VA,29,0.5531532219197145,Dovish
17,47, 최대/NNG;인하/NNG,64,0.5252013303865376,Dovish
17,42, 숏재료/NNG,59,0.5877252982896968,Dovish
6,13, 염/NNG,19,0.6701664034796543,Dovish
120,276, 중위험중수익/NNG,396,0.6313161771909785,Dovish
48,104, 우하향/NNG,152,0.6701664034796543,Dovish
13,27, 기대/NNG;훼손/NNG,40,0.6991242110374171,Dovish
11,29, 하단/NNG;밑돌/VV,40,0.5507689407907503,Dovish
608,1220,날/NNG,1828,0.7236332312982495,Dovish
6,18, 시대정신/NNG,24,0.4840090691797503,Dovish
16,43, 연극/NNG,59,0.540289193502977,Dovish
24,55, 초빙/NNG,79,0.633611872380764,Dovish
13,29, 장미/NNG,42,0.6509087482072504,Dovish
8,18, 정치/NNG;금리/NNG;인하/NNG,26,0.6453454255730003,Dovish
61,244, 엔저현상/NNG,305,0.3630068018848127,Dovish
69,157, 임대인/NNG,226,0.6381520848420912,Dovish
187,465, 임차인/NNG,652,0.5839335221716987,Dovish
16,32, 추상/NNG,48,0.7260136037696253,Dovish
9,25, 금리/NNG;낮/VV;경기/NNG;부양/NNG,34,0.5227297947141304,Dovish
11,28, 전월세/NNG;가격/NNG;상승/NNG,39,0.5704392601047057,Dovish
9,38, 부양책/NNG;금리/NNG;인하/NNG,47,0.3439011807329805,Dovish
21,44, 소비/NNG;투자/NNG;위축/NNG,65,0.6930129854164606,Dovish
4,12, 신용/NNG;여건/NNG;악화/NNG,16,0.4840090691797502,Dovish
14,32, 이자/NNG;부담/NNG;경감/NNG,46,0.6352619032984222,Dovish
5,18, 다수/NNG;금리/NNG;인하/NNG,23,0.4033408909831252,Dovish
6,15, 수출기업/NNG;피해/NNG,21,0.5808108830157004,Dovish
3,19, 캐리/NNG;부담/NNG,22,0.229267453821987,Dovish
15,33, 슈퍼추경/NNG,48,0.6600123670632958,Dovish
34,69, 실적치/NNG,103,0.7154916674831091,Dovish
5,16, 소비자/NNG;물가/NNG;상승률/NNG;전망/NNG;낮/VV,21,0.4537585023560159,Dovish
13,63, 경기/NNG;부양책/NNG;금리/NNG;인하/NNG,76,0.2996246618731787,Dovish
36,111, 단의/NNG,147,0.47092774298570295,Dovish
23,60, 국고채/NNG;금리/NNG;낮/VA,83,0.5566104295567127,Dovish
35,77, 롱재료/NNG,112,0.6600123670632958,Dovish
20,48, 냉철/NNG,68,0.6050113364746877,Dovish
10,21, 실망/NNG;약세/NNG,31,0.6914415273996433,Dovish
93,187, 추궁/NNG,280,0.7221311780810177,Dovish
11,23, 서려/VV,34,0.6944477949100765,Dovish
6,17, 산업단지공단/NNG,23,0.5124801908962061,Dovish
22,43, 달러엔/NNG;환율/NNG;급등/NNG,65,0.7428976410665934,Dovish
46,89, 단기/NNG;위험/NNG,135,0.7504859724360172,Dovish
21,60, 국채/NNG;가격/NNG;상승/NNG;지지/NNG,81,0.5082095226387378,Dovish
7,24, 과도/NNG;금리/NNG;인하/NNG,31,0.42350793553228144,Dovish
14,39, 기만/NNG,53,0.5212405360397311,Dovish
56,125, 자식/NNG,181,0.6505081889775843,Dovish
20,53, 덩어리/NNG,73,0.5479347952978305,Dovish
14,27, 일어난다면/VV,41,0.7529029965018337,Dovish
8,23, 성장/NNG;쉽/VA;않/VX,31,0.5050529417527828,Dovish
17,35, 자산/NNG;선호/NNG,52,0.7052703579476362,Dovish
15,30, 후진국/NNG,45,0.7260136037696253,Dovish
29,56, 줄여왔/VV,85,0.751942661047112,Dovish
6,13, 국제업무지구개발사업/NNG,19,0.6701664034796543,Dovish
67,132, 울리/VV,199,0.7370138098873469,Dovish
5,14, 강경/NNG;매파/NNG,19,0.5185811455497324,Dovish
5,12, 주택시장정상화종합대책/NNG,17,0.6050113364746877,Dovish
46,105, 유휴생산능력/NNG,151,0.6361262052076717,Dovish
6,12,대립/NNG,18,0.7260136037696254,Dovish
16,45, 퇴/NNG,61,0.5162763404584002,Dovish
6,14, 퇴로/NNG,20,0.622297374659679,Dovish
8,42, 예상밖/NNG;금리/NNG;인하/NNG,50,0.27657661095985725,Dovish
7,15, 재정/NNG;경기/NNG;부양/NNG,22,0.6776126968516504,Dovish
5,13, 더/NNG,18,0.5584720028997119,Dovish
21,47, 퍼즐/NNG,68,0.6487781140068993,Dovish
47,140, 문/VV,187,0.4874662768167485,Dovish
14,30, 환변동성/NNG,44,0.6776126968516504,Dovish
120,365, 하우스푸어/NNG,485,0.47737880795810983,Dovish
8,19, 루프/NNG,27,0.6113798768586319,Dovish
42,139, 시장안정화조치/NNG,181,0.4387420339327232,Dovish
14,29, 자본/NNG;유출입/NNG;변동성/NNG;확대/NNG,43,0.7009786519155004,Dovish
4,21, 양적완화/NNG;축소/NNG;종료/NNG,25,0.27657661095985725,Dovish
36,94, 유로존/NNG;경제/NNG;회복/NNG,130,0.5560955262916281,Dovish
13,49, 금리/NNG;인하/NNG;우려/NNG,62,0.3852317081226584,Dovish
15,32, 소비/NNG;투자/NNG;회복/NNG,47,0.6806377535340238,Dovish
24,52, 기업/NNG;투자/NNG;촉진/NNG,76,0.6701664034796543,Dovish
20,43, 통화정책/NNG;성장/NNG,63,0.6753614918787213,Dovish
12,23, 저조/NNG;성장/NNG,35,0.7575794126291744,Dovish
21,54, 회복/NNG;미약/NNG,75,0.5646772473763753,Dovish
10,31, 정책/NNG;개선/NNG,41,0.46839587339975836,Dovish
22,56, 성별/NNG,78,0.5704392601047057,Dovish
26,67, 변심/NNG,93,0.5634732447167242,Dovish
31,63, 지날/VV,94,0.7144895783129647,Dovish
25,76, 교황/NNG,101,0.4776405287958062,Dovish
9,28, 소용없/VA,37,0.46672303099475926,Dovish
62,169, 순방/NNG,231,0.5326963719966482,Dovish
19,56, 국빈/NNG,75,0.4926520882722459,Dovish
5,16, 정치/NNG;금리/NNG;인하/NNG;압박/NNG,21,0.4537585023560159,Dovish
10,27, 금리/NNG;내리/VV;아니/VCN,37,0.5377878546441669,Dovish
8,17, 국채/NNG;늘/VV,25,0.6833069211949414,Dovish
73,140, 영하/NNG,213,0.7571284725026094,Dovish
26,52, 지회/NNG,78,0.7260136037696254,Dovish
10,34, 금리/NNG;인하/NNG;긍정적/VAX,44,0.42706682574683846,Dovish
65,143, 채권/NNG;금리/NNG;내리/VV,208,0.6600123670632958,Dovish
1098,2216,런던/NNG,3314,0.719461134421524,Dovish
3,17, 머스트/NNG,20,0.25624009544810306,Dovish
7,23, 받아들인다면/VV,30,0.441921324033685,Dovish
30,88, 직종/NNG,118,0.49500927529747185,Dovish
15,32, 묻히/VV,47,0.6806377535340238,Dovish
13,63, 산단/VV,76,0.2996246618731787,Dovish
385,1284, 아베노믹스/NNG,1669,0.43538198979954174,Dovish
8,23, 채권/NNG;금리/NNG;변동성/NNG;확대/NNG,31,0.5050529417527828,Dovish
11,30, 우려/NNG;목소리/NNG;높/VV,41,0.5324099760977252,Dovish
4,17, 출구전략/NNG;양적완화/NNG,21,0.3416534605974707,Dovish
6,14, 기업/NNG;투자심리/NNG;회복/NNG,20,0.622297374659679,Dovish
377,739, 자산/NNG;매입/NNG;축소/NNG,1116,0.7407500098001321,Dovish
13,32, 가계/NNG;소비/NNG;증가/NNG,45,0.5898860530628207,Dovish
13,40, 망각/NNG,53,0.4719088424502565,Dovish
5,11, 저널리스트/NNG,16,0.6600123670632958,Dovish
6,12, 그만둔/VV,18,0.7260136037696254,Dovish
10,26, 과오/NNG,36,0.5584720028997119,Dovish
9,25, 재무장/NNG,34,0.5227297947141304,Dovish
8,19, 지낼/VV,27,0.6113798768586319,Dovish
9,19, 들으면/VV,28,0.687802361465961,Dovish
37,84, 유착/NNG,121,0.63958341284467,Dovish
2,232, 구제금융법안/NNG,234,0.012517475927062507,Dovish
52,101, 불릴/VV,153,0.7475783642776341,Dovish
6,13, 풍미/NNG,19,0.6701664034796543,Dovish
17,34, 낸다고/VV,51,0.7260136037696254,Dovish
132,259, 생계/NNG,391,0.7400293104061046,Dovish
13,41, fed/NNG;출구전략/NNG;우려/NNG,54,0.4603988706831771,Dovish
11,26, 전처/NNG,37,0.614319203189683,Dovish
1909,3825, 테이퍼링/NNG,5734,0.7246849514228574,Dovish
13,29, 보주/NNG,42,0.6509087482072504,Dovish
13,30, 싫어하/VV,43,0.6292117899336753,Dovish
16,58, 친분/NNG,74,0.4005592296660002,Dovish
22,50, 금리/NNG;오르/VV;금리/NNG;상승/NNG,72,0.6388919713172704,Dovish
59,118, 외환시장/NNG;변동성/NNG;확대/NNG,177,0.7260136037696254,Dovish
6,13, 위험/NNG;빠지/VV;않/VX,19,0.6701664034796543,Dovish
1111,2381, 양적완화/NNG;축소/NNG,3492,0.6775313849542661,Dovish
18,50, 대출/NNG;낮/VA,68,0.5227297947141304,Dovish
10,20, 숨겨져/VV,30,0.7260136037696254,Dovish
9,18, 할부리스사/NNG,27,0.7260136037696254,Dovish
19,46, 요주의/NNG,65,0.5997503683314297,Dovish
15,40, 양적완화/NNG;축소/NNG;금리/NNG;인상/NNG,55,0.544510202827219,Dovish
13,25, 금리/NNG;인하/NNG;기대/NNG;강하/VA,38,0.7550541479204105,Dovish
2,14, 부채/NNG;상환능력/NNG;의구심/NNG,16,0.20743245821989298,Dovish
5,15, 경제/NNG;양적완화/NNG;축소/NNG,20,0.48400906917975023,Dovish
14,35, 한미/NNG;금리갭/NNG;축소/NNG,49,0.5808108830157003,Dovish
11,29, 국채/NNG;금리/NNG;약세/NNG,40,0.5507689407907503,Dovish
7,21, 경기/NNG;개선/NNG;자신/NNG,28,0.4840090691797503,Dovish
16,42, 금리/NNG;인하/NNG;상승/NNG,58,0.5531532219197145,Dovish
10,20, 금리/NNG;인하/NNG;미루/VV,30,0.7260136037696254,Dovish
5,14, 금융시장/NNG;작/VV;않/VX,19,0.5185811455497324,Dovish
4,16, 불확실성/NNG;부진/NNG,20,0.36300680188481266,Dovish
10,30, 구조조정/NNG;성공/NNG,40,0.48400906917975023,Dovish
2,14, 대출자산/NNG;확대/NNG,16,0.20743245821989298,Dovish
17,34, 수익성/NNG;감소/NNG,51,0.7260136037696254,Dovish
16,46, 경기/NNG;충격/NNG,62,0.5050529417527828,Dovish
4,13, 실적/NNG;정체/NNG,17,0.44677760231976943,Dovish
16,34, 불화/NNG,50,0.6833069211949414,Dovish
26,52, 밸/NNG,78,0.7260136037696254,Dovish
16,36, 전망/NNG;소폭/MAG;하향/NNG,52,0.6453454255730003,Dovish
7,20, 경제/NNG;잠재/NNG;위험/NNG,27,0.5082095226387378,Dovish
7,14, 우려/NNG;양적완화/NNG;축소/NNG,21,0.7260136037696254,Dovish
18,39, 파죽지세/NNG,57,0.6701664034796543,Dovish
13,26, 선진국/NNG;양적완화/NNG;축소/NNG,39,0.7260136037696254,Dovish
28,71, 이뤄진다는/VV,99,0.5726304480436482,Dovish
50,115, 심장/NNG,165,0.6313161771909787,Dovish
28,58, 채권시장/NNG;변동성/NNG;크/VV,86,0.7009786519155004,Dovish
6,28, 금리/NNG;인하/NNG;성장/NNG,34,0.3111486873298395,Dovish
15,35, 스필오버/NNG,50,0.6222973746596789,Dovish
9,36, 핑크/NNG,45,0.3630068018848127,Dovish
19,55, 가든/NNG,74,0.5016093989681049,Dovish
31,85, 신상/NNG,116,0.5295628639260798,Dovish
15,38, 정확도/NNG,53,0.5731686345549674,Dovish
109,245, 국채/NNG;금리/NNG;높/VA,354,0.646003941313381,Dovish
7,19, 위험/NNG;점차/MAG;크/VV,26,0.5349573922513029,Dovish
51,100, 켜진/VV,151,0.740533875845018,Dovish
70,162, 즉시연금/NNG,232,0.6274191637515282,Dovish
5,19, 상환능력/NNG;개선/NNG,24,0.38211242303664494,Dovish
34,80, 세목/NNG,114,0.6171115632041816,Dovish
10,26, 하락/NNG;변동성/NNG;확대/NNG,36,0.5584720028997119,Dovish
5,11, 수출/NNG;불확실성/NNG,16,0.6600123670632958,Dovish
10,22, 기업/NNG;투자/NNG;회복/NNG,32,0.6600123670632958,Dovish
15,33, 깜짝/MAG;성장/NNG,48,0.6600123670632958,Dovish
4,12, 건주/NNG,16,0.4840090691797502,Dovish
4,13, 채권/NNG;금리/NNG;마이너스/NNG,17,0.44677760231976943,Dovish
22,48, 훈장/NNG,70,0.6655124701221565,Dovish
895,1791,선진국/NNG,2686,0.7256082360399941,Dovish
6,17, 우려/NNG;안정/NNG,23,0.5124801908962061,Dovish
11,27, 갈린/VV,38,0.5915666401085836,Dovish
37,72, 즐비/NNG,109,0.7461806483187817,Dovish
38,91, 여왕/NNG,129,0.6063410317196872,Dovish
5,14, 주택/NNG;금융시장/NNG;안정/NNG,19,0.5185811455497324,Dovish
150,336, 단기/NNG;금리/NNG;인상/NNG,486,0.6482264319371656,Dovish
11,30, 실업률/NNG;안정/NNG,41,0.5324099760977252,Dovish
139,283, 통용/NNG,422,0.7131865082966639,Dovish
8,21, 경질유/NNG,29,0.5531532219197145,Dovish
117,250, 사료/NNG,367,0.6795487331283694,Dovish
19,40, fed/NNG;경제/NNG;개선/NNG,59,0.6897129235811441,Dovish
13,32, 비용/NNG;크/VV,45,0.5898860530628207,Dovish
276,741, 포워드가이던스/NNG,1017,0.5408360449134052,Dovish
7,25, 종료/NNG;금리/NNG;인상/NNG,32,0.40656761811099024,Dovish
19,52, 글로벌/NNG;위험/NNG;회피/NNG,71,0.5305484027547263,Dovish
295,614,과정/NNG,909,0.6976352218633208,Dovish
8,29, 이탈/NNG;없/VA,37,0.4005592296660002,Dovish
98,194, 금리자유화/NNG,292,0.7334982800971473,Dovish
15,42, 신흥국/NNG;경제/NNG;둔화/NNG,57,0.5185811455497324,Dovish
6,14, 대외/NNG;충격/NNG;흡수/NNG,20,0.622297374659679,Dovish
12,33, 출구전략/NNG;불확실성/NNG,45,0.5280098936506367,Dovish
7,14, 가격/NNG;부양/NNG,21,0.7260136037696254,Dovish
13,28, 휴식기/NNG,41,0.6741554892146522,Dovish
11,22,팁/NNG,33,0.7260136037696254,Dovish
24,49, 착실히/MAG,73,0.7111969996110616,Dovish
23,48, 계급/NNG,71,0.6957630369458909,Dovish
4,13, 광기/NNG,17,0.44677760231976943,Dovish
10,20, 몰려올/VV,30,0.7260136037696254,Dovish
3,21, 섀도/NNG,24,0.20743245821989298,Dovish
144,329, 연합회/NNG,473,0.6355377443332891,Dovish
9,18, 폐/NNG,27,0.7260136037696254,Dovish
241,490, 고급/NNG,731,0.7141603204427744,Dovish
11,22, 연료/NNG;가격/NNG;인상/NNG,33,0.7260136037696254,Dovish
10,25, 부정적/VAX;영향/NNG;없/VA,35,0.5808108830157004,Dovish
5,11, 인상/NNG;지우/VV;없/VA,16,0.6600123670632958,Dovish
6,13, 외화/NNG;확보/NNG,19,0.6701664034796543,Dovish
30,71, 유혈사태/NNG,101,0.6135326229039088,Dovish
176,345, 사무총장/NNG,521,0.7407443145707482,Dovish
20,48, 중재안/NNG,68,0.6050113364746877,Dovish
172,342, 리스크오프/NNG,514,0.7302592973589215,Dovish
13,31, 금융시장/NNG;위험/NNG;회피/NNG,44,0.6089146354196858,Dovish
7,15, 통화정책/NNG;불확실성/NNG;높/VA,22,0.6776126968516504,Dovish
146,410, 신흥국지수/NNG,556,0.5170633470749527,Dovish
5,16, 글로벌/NNG;금융위기/NNG;양적완화/NNG,21,0.4537585023560159,Dovish
3,13, 둔화/NNG;양적완화/NNG;축소/NNG,16,0.33508320173982714,Dovish
3,13, 강하/VA;양적완화/NNG,16,0.33508320173982714,Dovish
11,28, 부동산/NNG;강세/NNG,39,0.5704392601047057,Dovish
55,127, fed/NNG;양적완화/NNG;축소/NNG;우려/NNG,182,0.6288306804303843,Dovish
6,13, 국채/NNG;금리/NNG;양적완화/NNG,19,0.6701664034796543,Dovish
18,38, 소비/NNG;지출/NNG;확대/NNG,56,0.687802361465961,Dovish
6,19, 금융위기/NNG;안정/NNG,25,0.458534907643974,Dovish
18,49,페이지/NNG,67,0.5333977497082962,Dovish
9,20, 담보/NNG;확보/NNG,29,0.6534122433926629,Dovish
36,80, 묶이/VV,116,0.6534122433926629,Dovish
7,15, 금융시장/NNG;부진/NNG,22,0.6776126968516504,Dovish
40,81, 금리/NNG;플러스/NNG,121,0.7170504728588893,Dovish
9,19, 서비스업/NNG;고용/NNG;증가/NNG,28,0.687802361465961,Dovish
40,88, 저항력/NNG,128,0.6600123670632958,Dovish
87,181, 외무/NNG,268,0.6979357295906896,Dovish
8,16, 성장/NNG;둔화/NNG;우려/NNG;완화/NNG,24,0.7260136037696253,Dovish
83,160, 신흥국/NNG;금융/NNG;불안/NNG,243,0.7532391139109863,Dovish
3,17, 예상/NNG;양적완화/NNG,20,0.25624009544810306,Dovish
133,282, 공직/NNG,415,0.6848213425628381,Dovish
5,11, 마피아/NNG,16,0.6600123670632958,Dovish
54,107, 국민당/NNG,161,0.7327987776366313,Dovish
17,37, 예감/NNG,54,0.6671476358964126,Dovish
5,11, 뜬금없이/MAG,16,0.6600123670632958,Dovish
4,15, 깊/VA;침체/NNG;빠지/VV,19,0.3872072553438002,Dovish
106,209,우량/NNG,315,0.7364348516706248,Dovish
6,21, 불확실성/NNG;약화/NNG,27,0.41486491643978596,Dovish
63,190, 후보자/NNG,253,0.48146165302617266,Dovish
67,143, 탈락/NNG,210,0.6803204398960125,Dovish
39,87, 주간지/NNG,126,0.6509087482072504,Dovish
11,27, 행적/NNG,38,0.5915666401085836,Dovish
14,30, 경기/NNG;회복/NNG;촉진/NNG,44,0.6776126968516504,Dovish
14,29, 테이퍼링/NNG;지연/NNG,43,0.7009786519155004,Dovish
6,22, 자신/NNG;약화/NNG,28,0.3960074202379775,Dovish
9,26, 자산/NNG;매입/NNG;속도/NNG;줄/VV,35,0.5026248026097407,Dovish
10,20, 해상운송/NNG,30,0.7260136037696254,Dovish
22,43, 임할/VV,65,0.7428976410665934,Dovish
190,379, 긴밀/NNG,569,0.7279292069457987,Dovish
107,213, 일임/NNG,320,0.7294221183413138,Dovish
11,26, 신탁재산/NNG,37,0.614319203189683,Dovish
22,50, 유대/NNG,72,0.6388919713172704,Dovish
23,59, 책임져야/VV,82,0.5660445046339452,Dovish
5,55, 부채한도/NNG;증액/NNG;실패/NNG,60,0.13200247341265917,Dovish
7,19, 선진국/NNG;경제/NNG;성장/NNG,26,0.5349573922513029,Dovish
57,116, fed/NNG;불확실성/NNG,173,0.7134961278425629,Dovish
7,17, 한계기업/NNG;부실/NNG,24,0.5978935560455738,Dovish
7,17, 우려/NNG;둔화/NNG,24,0.5978935560455738,Dovish
35,165,폐쇄/NNG,200,0.30800577129620477,Dovish
8,25, 폐쇄/NNG;우려/NNG,33,0.46464870641256023,Dovish
19,49, 조기경보/NNG,68,0.5630309580254238,Dovish
8,16, 장회/NNG,24,0.7260136037696253,Dovish
8,27, 신흥국/NNG;성장/NNG;약화/NNG,35,0.4302302837153335,Dovish
4,13, 부진/NNG;탈피/NNG,17,0.44677760231976943,Dovish
8,17, 회복/NNG;미흡/NNG,25,0.6833069211949414,Dovish
8,18, 호조/NNG;부진/NNG,26,0.6453454255730003,Dovish
18,45, 변동성/NNG;제한적/VAX,63,0.5808108830157004,Dovish
37,97, 정쟁/NNG,134,0.5538660482366214,Dovish
4,33, 티파티/NNG,37,0.17600329788354555,Dovish
5,14, 자금/NNG;유입/NNG;막/VV,19,0.5185811455497324,Dovish
161,326,연방정부/NNG,487,0.7171054613920839,Dovish
7,20, 의료장비/NNG,27,0.5082095226387378,Dovish
67,132, 헬스/NNG,199,0.7370138098873469,Dovish
9,33, 가격/NNG;불확실성/NNG,42,0.3960074202379775,Dovish
6,31, 금리/NNG;커브/NNG;스티프닝/NNG,37,0.28103752403985505,Dovish
58,151, 마이너스/NNG;떨어/VV,209,0.557732304882626,Dovish
113,227, 부치/VV,340,0.7228153059556623,Dovish
6,16, 낮/VA;물가/NNG;상승률/NNG;우려/NNG,22,0.5445102028272191,Dovish
18,45, 수요/NNG;오르/VV,63,0.5808108830157004,Dovish
15,31,숏포지션/NNG,46,0.7025938100996375,Dovish
32,68, 서열/NNG,100,0.6833069211949414,Dovish
16,33, 스튜디오/NNG,49,0.7040131915341822,Dovish
7,15, 투자일임업/NNG,22,0.6776126968516504,Dovish
28,55, 악영향/NNG;우려/NNG,83,0.7392138511108913,Dovish
183,381,수요예측/NNG,564,0.6974303910227897,Dovish
44,106,한계/NNG,150,0.6027282748276136,Dovish
17,34, 실업률/NNG;하락/NNG;최저/NNG,51,0.7260136037696254,Dovish
18,35, 잡힌다/VV,53,0.7467568495916148,Dovish
20,48, 배운/VV,68,0.6050113364746877,Dovish
20,63, 칸막이/NNG,83,0.4609610182664288,Dovish
23,59, 실적/NNG;하락/NNG,82,0.5660445046339452,Dovish
7,17, 치우칠/VV,24,0.5978935560455738,Dovish
5,11, 용경/NNG,16,0.6600123670632958,Dovish
6,21, 소비/NNG;투자심리/NNG;개선/NNG,27,0.41486491643978596,Dovish
4,15, 제조업/NNG;생산/NNG;늘/VV,19,0.3872072553438002,Dovish
31,62, 주택시장/NNG;호조/NNG,93,0.7260136037696255,Dovish
7,16, 신용/NNG;경계/NNG,23,0.6352619032984222,Dovish
11,25, 성장/NNG;활력/NNG,36,0.6388919713172704,Dovish
16,31, 풀타임/NNG,47,0.7494333974396133,Dovish
31,71, 예상시기/NNG,102,0.6339837103340391,Dovish
59,117, 문단/NNG,176,0.7322188482462888,Dovish
15,50, 경제/NNG;활동/NNG;완만/NNG;속도/NNG;확장/NNG,65,0.43560816226177523,Dovish
16,32, 클/NNG,48,0.7260136037696253,Dovish
160,420, 경기민감주/NNG,580,0.5531532219197146,Dovish
233,492, 소형주/NNG,725,0.687647031212694,Dovish
100,197, 하드/NNG,297,0.7370696484970817,Dovish
6,15, 추적오차/NNG,21,0.5808108830157004,Dovish
18,35, 현업/NNG,53,0.7467568495916148,Dovish
7,17, 공저/NNG,24,0.5978935560455738,Dovish
198,456, 전기가스업/NNG,654,0.6304854980104642,Dovish
222,480, 음식료품/NNG,702,0.6715625834869035,Dovish
23,58, 솔/NNG,81,0.5758038926448753,Dovish
4,15, 경기민감주/NNG;비중/NNG;확대/NNG,19,0.3872072553438002,Dovish
18,58, 금융시장/NNG;거품/NNG,76,0.45062913337425026,Dovish
43,83, 실적/NNG;하향/NNG,126,0.7522550593275636,Dovish
6,12, 회복/NNG;늦/VV,18,0.7260136037696254,Dovish
26,56, 특권/NNG,82,0.6741554892146522,Dovish
5,11, 이전/NNG;fed/NNG;금리/NNG;인상/NNG,16,0.6600123670632958,Dovish
9,25, 연방정부/NNG;폐쇄/NNG;우려/NNG,34,0.5227297947141304,Dovish
81,166, crs/NNG;금리/NNG;상승/NNG,247,0.7085193000643332,Dovish
5,12, 대출/NNG;연체율/NNG;급등/NNG,17,0.6050113364746877,Dovish
4,13, 기업/NNG;부채/NNG;부실/NNG,17,0.44677760231976943,Dovish
5,11, 은행/NNG;대출/NNG;부실/NNG,16,0.6600123670632958,Dovish
18,38, 출구전략/NNG;지연/NNG,56,0.687802361465961,Dovish
19,39, 재무관리/NNG,58,0.707397870339635,Dovish
7,15, 카드승인금액/NNG,22,0.6776126968516504,Dovish
8,31, 불어오/VV,39,0.3747166987198067,Dovish
10,24, 기나긴/VA,34,0.6050113364746877,Dovish
6,18, 이미/MAG;양적완화/NNG;축소/NNG,24,0.4840090691797503,Dovish
31,74, 금융위기/NNG;경기/NNG;침체/NNG,105,0.6082816680231996,Dovish
11,25, 경기/NNG;추세/NNG;회복/NNG,36,0.6388919713172704,Dovish
45,169, 청문/NNG,214,0.3866344635459543,Dovish
23,44, 극한/NNG,67,0.7590142221227901,Dovish
13,26, 배당기준일/NNG,39,0.7260136037696254,Dovish
25,66, 둔화/NNG;일시적/VAX,91,0.5500103058860799,Dovish
54,126, 배당률/NNG,180,0.6222973746596789,Dovish
12,23, 맞춘다는/VV,35,0.7575794126291744,Dovish
66,173, ecb/NNG;경기/NNG;부양/NNG,239,0.5539525762866506,Dovish
23,47, 금리/NNG;완만/NNG;상승/NNG,70,0.7105665058170801,Dovish
3,14, 가격/NNG;안정/NNG;당분간/MAG;낮/VA,17,0.3111486873298395,Dovish
4,14, 양적완화/NNG;축소/NNG;중단/NNG,18,0.41486491643978596,Dovish
7,21, 옹/NNG,28,0.4840090691797503,Dovish
20,41, 인플레이션/NNG;전망/NNG;하향/NNG,61,0.7083059548971955,Dovish
8,24, 고용시장/NNG;여건/NNG;개선/NNG,32,0.4840090691797502,Dovish
411,803, 안내/NNG,1214,0.7431920078438756,Dovish
12,24, 맞닥뜨릴/VV,36,0.7260136037696254,Dovish
10,22, 달력/NNG,32,0.6600123670632958,Dovish
19,38, 주택/NNG;경기/NNG;호조/NNG,57,0.7260136037696254,Dovish
25,49, 예상/NNG;소폭/MAG;하회/NNG,74,0.7408302079281892,Dovish
7,16, 글로벌/NNG;수요/NNG;증가/NNG,23,0.6352619032984222,Dovish
4,14, 나태/NNG,18,0.41486491643978596,Dovish
75,149, 혹독/NNG,224,0.7308861782915692,Dovish
15,48, 국채/NNG;금리/NNG;최저/NNG,63,0.45375850235601584,Dovish
5,11, 경기/NNG;회복/NNG;방해/NNG,16,0.6600123670632958,Dovish
17,43, 악천후/NNG,60,0.5740572680969132,Dovish
6,12, 세계/NNG;경제/NNG;성장률/NNG;상향/NNG,18,0.7260136037696254,Dovish
15,41, 국채선물/NNG;금리/NNG;인하/NNG,56,0.5312294661728967,Dovish
4,15, 고용시장/NNG;호전/NNG,19,0.3872072553438002,Dovish
62,124, 옅/VA,186,0.7260136037696255,Dovish
11,23, 난맥상/NNG,34,0.6944477949100765,Dovish
3,13, 상환능력/NNG;약화/NNG,16,0.33508320173982714,Dovish
20,49, 통화정책/NNG;경기/NNG;회복/NNG,69,0.5926641663425514,Dovish
8,16, 전망/NNG;훼손/NNG,24,0.7260136037696253,Dovish
51,104, 치른/VV,155,0.7120518036971326,Dovish
11,25, 기업/NNG;수익/NNG;악화/NNG,36,0.6388919713172704,Dovish
10,24, 수출/NNG;제한/NNG,34,0.6050113364746877,Dovish
5,15, 예상/NNG;강화/NNG,20,0.48400906917975023,Dovish
5,12, 신용/NNG;억제/NNG,17,0.6050113364746877,Dovish
8,16, 원자/NNG,24,0.7260136037696253,Dovish
5,12, 투자심리/NNG;부정적/VAX;영향/NNG;줄/VV,17,0.6050113364746877,Dovish
3,18, fed/NNG;경제/NNG;부진/NNG,21,0.24200453458987514,Dovish
33,71, fed/NNG;부담/NNG,104,0.6748858851942996,Dovish
8,21, 신흥국/NNG;자본/NNG;유출/NNG;우려/NNG,29,0.5531532219197145,Dovish
14,27, 신흥국/NNG;자금/NNG;유출/NNG;우려/NNG,41,0.7529029965018337,Dovish
23,71, 혹한/NNG,94,0.47037501089299666,Dovish
33,76, 작물/NNG,109,0.6304854980104642,Dovish
9,27, 소비자/NNG;물가/NNG;상승률/NNG;안정/NNG,36,0.4840090691797503,Dovish
6,13, 제조업/NNG;성장/NNG;둔화/NNG,19,0.6701664034796543,Dovish
22,65, 경기/NNG;악영향/NNG,87,0.49145536255174643,Dovish
19,45, 수출/NNG;활성화/NNG,64,0.6130781542943504,Dovish
8,28, 하락/NNG;억제/NNG,36,0.41486491643978596,Dovish
136,400, 개인정보/NNG,536,0.49368925056334534,Dovish
5,13, 부채/NNG;관리/NNG;강화/NNG,18,0.5584720028997119,Dovish
33,94, 그레이트로테이션/NNG,127,0.5097542324339923,Dovish
21,65, 최대경제국/NNG,86,0.469116482435758,Dovish
6,14, 수요/NNG;증가/NNG;상승/NNG,20,0.622297374659679,Dovish
5,19, 취약성지수/NNG,24,0.38211242303664494,Dovish
7,22, 단정지/VV,29,0.4620086569443071,Dovish
8,16, 대외변수/NNG;취약/NNG,24,0.7260136037696253,Dovish
10,31, 정보유출사태/NNG,41,0.46839587339975836,Dovish
8,41, 금소/NNG,49,0.2833223819588782,Dovish
55,122, 투자금융/NNG,177,0.6546024296283508,Dovish
3,13, 주택/NNG;경기/NNG;불확실성/NNG,16,0.33508320173982714,Dovish
3,17, 주택시장/NNG;지수/NNG;하락/NNG,20,0.25624009544810306,Dovish
3,15, 완만/NNG;경기/NNG;확장/NNG,18,0.2904054415078502,Dovish
3,15, 수출/NNG;증가/NNG;확대/NNG,18,0.2904054415078502,Dovish
41,103, 금/NNG;가격/NNG;강세/NNG,144,0.5779914127097989,Dovish
5,12, 어렵/VA;강세/NNG,17,0.6050113364746877,Dovish
5,12, 부채비율/NNG;감축/NNG,17,0.6050113364746877,Dovish
9,21, 부채비율/NNG;줄/VV,30,0.6222973746596789,Dovish
5,14, 가계/NNG;부채/NNG;우려/NNG;크/VV,19,0.5185811455497324,Dovish
14,33, 회사채/NNG;발행/NNG;어렵/VA,47,0.6160115425924094,Dovish
33,85, 이자/NNG;부담/NNG;덜/VV,118,0.5637282099858267,Dovish
8,20, 실적/NNG;안/MAG;좋/VA,28,0.5808108830157003,Dovish
9,18, 건전성/NNG;회복/NNG,27,0.7260136037696254,Dovish
21,45, 투자/NNG;어렵/VA,66,0.6776126968516504,Dovish
16,35,개념/NNG,51,0.6637838663036575,Dovish
47,100, 주립/NNG,147,0.6824527875434478,Dovish
5,17, 신규/NNG;고용자수/NNG;증가/NNG,22,0.42706682574683846,Dovish
162,348, 우크라이나사태/NNG,510,0.6759437000613754,Dovish
90,183, 라운드/NNG,273,0.7141117414127462,Dovish
18,44, 방국/NNG,62,0.5940111303569663,Dovish
10,23, 세계/NNG;경제/NNG;성장/NNG;둔화/NNG;우려/NNG,33,0.6313161771909785,Dovish
4,16, 여력/NNG;개선/NNG,20,0.36300680188481266,Dovish
388,850, 완전고용/NNG,1238,0.6628077135590933,Dovish
23,56, 양적완화/NNG;종료/NNG;금리/NNG;인상/NNG,79,0.5963683173821923,Dovish
32,63, 완전고용/NNG;물가/NNG;안정/NNG,95,0.7375376292262861,Dovish
16,40, 실업률/NNG;금리/NNG;인상/NNG,56,0.5808108830157003,Dovish
6,14, 중립성/NNG,20,0.622297374659679,Dovish
16,38, 전망/NNG;fed/NNG;금리/NNG;인상/NNG,54,0.6113798768586319,Dovish
10,20, 가격/NNG;하방/NNG;압력/NNG,30,0.7260136037696254,Dovish
33,71, 테이퍼링/NNG;종료/NNG,104,0.6748858851942996,Dovish
4,14, 자산/NNG;매입/NNG;종료/NNG;금리/NNG;인상/NNG,18,0.41486491643978596,Dovish
20,81, fed/NNG;자산/NNG;매입/NNG;종료/NNG,101,0.35852523642944467,Dovish
23,56, 수신/NNG;금리/NNG;인하/NNG,79,0.5963683173821923,Dovish
29,72, 국비/NNG,101,0.5848442919255316,Dovish
19,39, 고은/VA,58,0.707397870339635,Dovish
8,22, 출상/NNG,30,0.5280098936506367,Dovish
15,29, 경제/NNG;성장/NNG;긍정적/VAX,44,0.7510485556237504,Dovish
228,582, 질의/NNG,810,0.5688354008916653,Dovish
115,240, 붓/VV,355,0.6957630369458909,Dovish
85,199, 기업/NNG;실적/NNG;악화/NNG,284,0.6202126263358608,Dovish
8,21, 높/VA;부실/NNG,29,0.5531532219197145,Dovish
19,50, 고용/NNG;상향/NNG,69,0.5517703388649153,Dovish
8,22, 중도주/NNG,30,0.5280098936506367,Dovish
8,29, 물가/NNG;상승/NNG;압력/NNG;없/VA,37,0.4005592296660002,Dovish
15,40, 경기/NNG;금리/NNG;인상/NNG,55,0.544510202827219,Dovish
3,13, 선진국/NNG;금리/NNG;높/VA,16,0.33508320173982714,Dovish
74,158, 국제통화/NNG,232,0.6800633756829403,Dovish
508,1180, 출석/NNG,1688,0.6251100181609657,Dovish
17,36, 끈질기/VA,53,0.6856795146713129,Dovish
34,70, 가계/NNG;부채/NNG;넘/VV,104,0.7052703579476362,Dovish
8,24, 외환보유액/NNG;안정/NNG,32,0.4840090691797502,Dovish
20,62, 극단주의/NNG,82,0.46839587339975836,Dovish
9,22, 감시단/NNG,31,0.5940111303569663,Dovish
22,50, 제조업/NNG;회복/NNG,72,0.6388919713172704,Dovish
1502,2877,신흥국/NNG,4379,0.7580621709155212,Dovish
39,80, 커플링/NNG,119,0.7078632636753848,Dovish
6,15, 금리/NNG;오르/VV;내리/VV;어렵/VA,21,0.5808108830157004,Dovish
6,16, 경제/NNG;활동/NNG;상승/NNG,22,0.5445102028272191,Dovish
12,23, 상환능력/NNG;양호/NNG,35,0.7575794126291744,Dovish
100,196, 일으킨/VV,296,0.7408302079281892,Dovish
7,16, 안정/NNG;않/VX,23,0.6352619032984222,Dovish
9,30, 발행/NNG;여건/NNG;개선/NNG,39,0.43560816226177523,Dovish
6,12, 부진/NNG;소폭/MAG;하락/NNG,18,0.7260136037696254,Dovish
128,359, 세월호참사/NNG,487,0.5177144361142733,Dovish
18,36, 내수/NNG;부진/NNG;우려/NNG,54,0.7260136037696254,Dovish
20,46, 금리/NNG;방향/NNG;인상/NNG,66,0.6313161771909785,Dovish
27,60, 내수/NNG;경기/NNG;부진/NNG,87,0.6534122433926628,Dovish
13,39, 쿠싱/NNG,52,0.4840090691797503,Dovish
10,32, 지준율/NNG;인하/NNG;금리/NNG;인하/NNG,42,0.4537585023560159,Dovish
5,12, 세계/NNG;경제/NNG;견인/NNG,17,0.6050113364746877,Dovish
6,17, 경제/NNG;성장/NNG;개선/NNG,23,0.5124801908962061,Dovish
12,27, 부양책/NNG;기대/NNG;크/VV,39,0.6453454255730003,Dovish
34,78, 주의자/NNG,112,0.6329349366196735,Dovish
56,127, 실무진/NNG,183,0.6402639655291185,Dovish
5,11, 유로존/NNG;물가/NNG;하락/NNG,16,0.6600123670632958,Dovish
38,77, 생겨났/VV,115,0.7165848556687212,Dovish
5,12, 자산/NNG;건전성/NNG;훼손/NNG,17,0.6050113364746877,Dovish
20,60, 경제/NNG;심리/NNG;위축/NNG,80,0.48400906917975023,Dovish
8,16, 하단/NNG;하향/NNG,24,0.7260136037696253,Dovish
110,212, 레피/NNG,322,0.753410343534517,Dovish
19,38, 로테이션/NNG,57,0.7260136037696254,Dovish
6,17, 일정폭/NNG,23,0.5124801908962061,Dovish
7,16, 쓰라린/VA,23,0.6352619032984222,Dovish
64,133, 춘다고/VV,197,0.6987198592670077,Dovish
8,21, 투자/NNG;한도/NNG;확대/NNG,29,0.5531532219197145,Dovish
31,62, 소매/NNG;판매/NNG;늘/VV,93,0.7260136037696255,Dovish
25,48, 인플레이션/NNG;높/VV,73,0.7562641705933597,Dovish
9,20, 대출/NNG;급감/NNG,29,0.6534122433926629,Dovish
12,93, 이라크사태/NNG,105,0.18735834935990334,Dovish
5,12, 임금/NNG;상승/NNG;금리/NNG;인상/NNG,17,0.6050113364746877,Dovish
5,22, 통화/NNG;긴축/NNG;선호/NNG,27,0.3300061835316479,Dovish
78,151, 경기/NNG;침체/NNG;빠지/VV,229,0.750053789324911,Dovish
34,65, 예상/NNG;비둘기/NNG,99,0.7595219239436083,Dovish
22,54, 부나/NNG,76,0.5915666401085836,Dovish
5,13, 성장/NNG;모멘텀/NNG;회복/NNG,18,0.5584720028997119,Dovish
8,19, 근원/NNG;물가/NNG;하락/NNG,27,0.6113798768586319,Dovish
8,20, 소비/NNG;모멘텀/NNG,28,0.5808108830157003,Dovish
27,60, 자본비율/NNG;높/VV,87,0.6534122433926628,Dovish
5,12, 현금/NNG;줄/VV,17,0.6050113364746877,Dovish
17,37, 품부/NNG,54,0.6671476358964126,Dovish
195,373, 원위안/NNG,568,0.7591026956304394,Dovish
4,19, 구제금융/NNG;종료/NNG,23,0.30568993842931597,Dovish
13,35, 수지/NNG;흑자전환/NNG,48,0.5393243913717217,Dovish
5,11, 낮/VA;개선/NNG,16,0.6600123670632958,Dovish
3,18, 경기/NNG;부양책/NNG;기대/NNG;크/VV,21,0.24200453458987514,Dovish
10,29, 금리/NNG;인하/NNG;가능성/NNG;없/VA,39,0.5006990370825003,Dovish
18,47,박수/NNG,65,0.5560955262916281,Dovish
8,22, 슬픔/NNG,30,0.5280098936506367,Dovish
7,14, 좌판/NNG,21,0.7260136037696254,Dovish
11,31, 정평/NNG,42,0.5152354607397341,Dovish
5,16, 돌아간다면/VV,21,0.4537585023560159,Dovish
25,52, 입대/NNG,77,0.6980900036246398,Dovish
8,20, 소화기/NNG,28,0.5808108830157003,Dovish
3,13, 들으며/VV,16,0.33508320173982714,Dovish
22,53, 경제/NNG;성장률/NNG;내리/VV,75,0.6027282748276136,Dovish
23,64, 의자/NNG,87,0.5218222777094182,Dovish
5,14, 고용/NNG;호조/NNG;금리/NNG;인상/NNG,19,0.5185811455497324,Dovish
11,25, 수입/NNG;물가/NNG;안정/NNG,36,0.6388919713172704,Dovish
16,31, 했어도/XSV,47,0.7494333974396133,Dovish
15,67, 경기/NNG;하방/NNG;위험/NNG;크/VV,82,0.3250807181058024,Dovish
6,12, 점차/MAG;높/VA;상승/NNG;압력/NNG,18,0.7260136037696254,Dovish
9,60, 금리/NNG;깜짝/MAG;인하/NNG,69,0.21780408113088762,Dovish
30,60, 완만/NNG;경제/NNG;성장/NNG,90,0.7260136037696253,Dovish
16,50, 내수/NNG;회복/NNG;지연/NNG,66,0.46464870641256023,Dovish
8,21, 비용/NNG;인하/NNG,29,0.5531532219197145,Dovish
10,26, 원유/NNG;공급/NNG;차질/NNG,36,0.5584720028997119,Dovish
17,35,선반영/NNG,52,0.7052703579476362,Dovish
3,18, 키워갔/VV,21,0.24200453458987514,Dovish
5,15, 경기/NNG;회복/NNG;예상/NNG;더디/VA,20,0.48400906917975023,Dovish
6,17, 비둘기/NNG;금리/NNG;인하/NNG,23,0.5124801908962061,Dovish
9,24, 채권/NNG;금리/NNG;하락/NNG;강세/NNG,33,0.5445102028272191,Dovish
5,16, 인하/NNG;확대/NNG,21,0.4537585023560159,Dovish
13,27, 위험/NNG;늘/VV,40,0.6991242110374171,Dovish
5,16, 돌발/NNG;위험/NNG,21,0.4537585023560159,Dovish
15,31, 굳/VV,46,0.7025938100996375,Dovish
38,90, 앨/NNG,128,0.6130781542943504,Dovish
7,19, 빔/NNG,26,0.5349573922513029,Dovish
6,13, 람/NNG,19,0.6701664034796543,Dovish
62,187, 여객기/NNG,249,0.4814207853873452,Dovish
8,26, 낮/VA;인하/NNG,34,0.44677760231976943,Dovish
99,262, 금융중개지원대출/NNG,361,0.5486667692610147,Dovish
130,349, 수은/NNG,479,0.5408697334673427,Dovish
17,33, 설비투자펀드/NNG,50,0.7480140160050687,Dovish
5,11, 자산/NNG;부정적/VAX,16,0.6600123670632958,Dovish
10,21, 발맞춘/VV,31,0.6914415273996433,Dovish
55,235, 재정보강/NNG,290,0.3398361549559949,Dovish
31,271, 도액/NNG,302,0.1660990532609475,Dovish
191,377, 영세자영업자/NNG,568,0.7356424314058273,Dovish
6,21, 경제/NNG;성장/NNG;미약/NNG,27,0.41486491643978596,Dovish
207,445, 연금저축/NNG,652,0.6754373751924155,Dovish
17,35, 금융시장/NNG;변동성/NNG;높/VA,52,0.7052703579476362,Dovish
3,15, 발행/NNG;금리/NNG;최저/NNG,18,0.2904054415078502,Dovish
8,31, 경제활동참가율/NNG;상승/NNG,39,0.3747166987198067,Dovish
6,23, 경기/NNG;둔화/NNG;우려/NNG;안전자산/NNG;선호/NNG,29,0.3787897063145872,Dovish
9,19, 기대/NNG;투자심리/NNG;개선/NNG,28,0.687802361465961,Dovish
6,18, 금리/NNG;인하/NNG;가능성/NNG;완전히/MAG;배제/NNG,24,0.4840090691797503,Dovish
6,15, 금리/NNG;이미/MAG;금리/NNG;인하/NNG,21,0.5808108830157004,Dovish
28,72, 임금/NNG;상승률/NNG;부진/NNG,100,0.5646772473763753,Dovish
2,15, 금리/NNG;방향/NNG;인하/NNG,17,0.1936036276719001,Dovish
12,54, 매우/MAG;비둘기/NNG,66,0.32267271278650017,Dovish
7,20, 수요/NNG;실망/NNG,27,0.5082095226387378,Dovish
14,27, 지상군/NNG,41,0.7529029965018337,Dovish
112,228, 후강퉁/NNG,340,0.7132765230017372,Dovish
156,317, 사들일/VV,473,0.7145622850981802,Dovish
21,56, 테이퍼링/NNG;양적완화/NNG,77,0.5445102028272191,Dovish
16,41, 비둘기/NNG;않/VX,57,0.5666447639177564,Dovish
2,20, 부진/NNG;경기/NNG;침체/NNG,22,0.14520272075392507,Dovish
21,43, 금리/NNG;하방/NNG;압력/NNG,64,0.7091295664726573,Dovish
22,47, 금융시장/NNG;충격/NNG;줄/VV,69,0.6796723099119898,Dovish
4,12, 계부/NNG,16,0.4840090691797502,Dovish
28,54, 총사업비/NNG,82,0.7529029965018337,Dovish
36,146, 완화/NNG;금리/NNG;인하/NNG,182,0.35803410596858243,Dovish
5,14, 개선/NNG;물가/NNG;상승/NNG,19,0.5185811455497324,Dovish
6,20, 경제/NNG;여건/NNG;나쁘/VA,26,0.43560816226177523,Dovish
8,16, 전망/NNG;안정/NNG;부정적/VAX,24,0.7260136037696253,Dovish
56,119, 한주/NNG,175,0.6833069211949415,Dovish
23,47, 가계/NNG;부채/NNG;심각/NNG,70,0.7105665058170801,Dovish
55,112, 가계/NNG;대출/NNG;급증/NNG,167,0.7130490751308821,Dovish
8,17, 완화/NNG;기대/NNG;높/VA,25,0.6833069211949414,Dovish
61,163, 재정정책/NNG;확대/NNG,224,0.5433966850300264,Dovish
6,16, 저성장/NNG;탈피/NNG,22,0.5445102028272191,Dovish
217,580,조기/NNG,797,0.5432584552345128,Dovish
17,46, 공연장/NNG,63,0.5366187506123319,Dovish
10,26, 비즈니스센터/NNG,36,0.5584720028997119,Dovish
8,25, fed/NNG;테이퍼링/NNG;종료/NNG,33,0.46464870641256023,Dovish
9,20, 투자심리/NNG;흔들/VV,29,0.6534122433926629,Dovish
5,17, 바라본다면/VV,22,0.42706682574683846,Dovish
101,194, 사내/NNG,295,0.7559523090797131,Dovish
2,16, 인하/NNG;기대/NNG;강화/NNG,18,0.18150340094240633,Dovish
12,24, 수출/NNG;경쟁력/NNG;회복/NNG,36,0.7260136037696254,Dovish
1231,2452,실업률/NNG,3683,0.7289745075370382,Dovish
8,35, 소비자/NNG;신뢰지수/NNG;부진/NNG,43,0.33189193315182874,Dovish
19,38, 소비/NNG;지출/NNG;호조/NNG,57,0.7260136037696254,Dovish
9,21, 유로존/NNG;경기/NNG;우려/NNG,30,0.6222973746596789,Dovish
14,47, 금리/NNG;인하/NNG;기대/NNG;꺾/VV,61,0.4325187426712662,Dovish
20,43, 은행/NNG;주택담보대출/NNG;증가/NNG,63,0.6753614918787213,Dovish
7,21, 기업/NNG;심리/NNG;회복/NNG,28,0.4840090691797503,Dovish
80,256, fed/NNG;금리/NNG;인상/NNG;늦/VV,336,0.4537585023560159,Dovish
5,11, 소득/NNG;증가율/NNG;둔화/NNG,16,0.6600123670632958,Dovish
33,69, 민간/NNG;소비/NNG;부진/NNG,102,0.6944477949100764,Dovish
61,129, 담배가격/NNG;인상/NNG,190,0.6866175167433667,Dovish
5,18, 부진/NNG;경기/NNG;부양/NNG,23,0.4033408909831252,Dovish
31,81, 안일/NNG,112,0.5557141164656392,Dovish
4,15, 예상/NNG;달리/MAG;양적완화/NNG,19,0.3872072553438002,Dovish
10,27, 프론티어마켓/NNG,37,0.5377878546441669,Dovish
43,94, 유로존/NNG;디플레이션/NNG;우려/NNG,137,0.6642252119594445,Dovish
37,80, 초석/NNG,117,0.6715625834869035,Dovish
13,43, 움직여왔/VV,56,0.43898496972116885,Dovish
15,30, 구조적/VAX;개선/NNG,45,0.7260136037696253,Dovish
6,14, 엔저/NNG;부담/NNG,20,0.622297374659679,Dovish
15,29, 수제/NNG,44,0.7510485556237504,Dovish
94,193, 압승/NNG,287,0.70720496118492,Dovish
2,14, 유로존/NNG;성장률/NNG;하향/NNG,16,0.20743245821989298,Dovish
5,12, 국채/NNG;가격/NNG;지지/NNG,17,0.6050113364746877,Dovish
12,48, 임금/NNG;늘/VV,60,0.3630068018848127,Dovish
8,16, 근로소득증대세제/NNG,24,0.7260136037696253,Dovish
16,33, 배당소득증대세제/NNG,49,0.7040131915341822,Dovish
41,86, 배당정책/NNG,127,0.6922455291756893,Dovish
469,956, 배당주/NNG,1425,0.7123438915647581,Dovish
28,56, 주민세/NNG,84,0.7260136037696254,Dovish
38,74, 상수도/NNG,112,0.7456355930606964,Dovish
15,36, 외곽순환도로/NNG,51,0.6050113364746877,Dovish
35,86, 봉투/NNG,121,0.5909413053938811,Dovish
8,16, 태백/NNG,24,0.7260136037696253,Dovish
17,39, 애인/NNG,56,0.6329349366196735,Dovish
23,57, 파스/NNG,80,0.5859057153228555,Dovish
6,18, 경기/NNG;둔화/NNG;원자재/NNG;가격/NNG;하락/NNG,24,0.4840090691797503,Dovish
29,73, 소비자/NNG;물가/NNG;상승률/NNG;낮/VA,102,0.5768327262827161,Dovish
7,19, 디플레이션/NNG;우려/NNG;높/VA,26,0.5349573922513029,Dovish
17,36, 글로벌/NNG;경제/NNG;우려/NNG,53,0.6856795146713129,Dovish
45,94, 가계/NNG;소득/NNG;증대/NNG,139,0.695119407864535,Dovish
22,48, 외교관/NNG,70,0.6655124701221565,Dovish
5,16, 스파이/NNG,21,0.4537585023560159,Dovish
18,51, 금리/NNG;인하/NNG;가능성/NNG;낮/VV,69,0.5124801908962061,Dovish
22,52, 수출/NNG;악화/NNG,74,0.614319203189683,Dovish
33,124, 하폭/NNG,157,0.38642659555480063,Dovish
9,20, 금리/NNG;하락/NNG;영향/NNG;강세/NNG,29,0.6534122433926629,Dovish
5,16, 인하/NNG;기대/NNG;희석/NNG,21,0.4537585023560159,Dovish
48,93, 수출/NNG;긍정적/VAX,141,0.7494333974396133,Dovish
42,93, 가계부/NNG,135,0.6557542227596616,Dovish
24,58, 잦아지/VV,82,0.6008388444990004,Dovish
60,118, 보건복지/NNG,178,0.7383189190877547,Dovish
117,225, 체육/NNG,342,0.7550541479204104,Dovish
6,13, 물가/NNG;상승/NNG;모멘텀/NNG,19,0.6701664034796543,Dovish
4,18, 글로벌/NNG;교역/NNG;부진/NNG,22,0.32267271278650017,Dovish
39,102, 공급/NNG;과잉/NNG;해소/NNG,141,0.55518687347089,Dovish
47,90, 부채/NNG;상환/NNG;부담/NNG,137,0.7582808750482753,Dovish
6,12, 물가/NNG;하방/NNG;위험/NNG,18,0.7260136037696254,Dovish
6,19, 투자/NNG;저조/NNG,25,0.458534907643974,Dovish
11,38, 부진/NNG;경제/NNG;성장/NNG,49,0.42032366534030946,Dovish
10,22, 생/NNG,32,0.6600123670632958,Dovish
6,13, 하락/NNG;디플레이션/NNG;우려/NNG,19,0.6701664034796543,Dovish
13,36, 통화정책/NNG;금융안정/NNG,49,0.5243431582780628,Dovish
28,58, 돋보인다/VV,86,0.7009786519155004,Dovish
7,22, 군내/NNG,29,0.4620086569443071,Dovish
9,20,영구/NNG,29,0.6534122433926629,Dovish
42,94, 결성/NNG,136,0.6487781140068993,Dovish
11,31, 해운동맹/NNG,42,0.5152354607397341,Dovish
6,14, 높/VA;유가/NNG;하락/NNG,20,0.622297374659679,Dovish
19,57, 개조/NNG,76,0.4840090691797503,Dovish
11,28, 유로존/NNG;디플레이션/NNG;위험/NNG,39,0.5704392601047057,Dovish
5,12, 금리/NNG;fed/NNG;인상/NNG,17,0.6050113364746877,Dovish
10,20, 수출/NNG;경쟁력/NNG;타격/NNG,30,0.7260136037696254,Dovish
11,30, 물가/NNG;유가/NNG;하락/NNG,41,0.5324099760977252,Dovish
13,29, 싹/MAG,42,0.6509087482072504,Dovish
6,18, 호악/NNG,24,0.4840090691797503,Dovish
6,13, 유로존/NNG;성장률/NNG;전망/NNG;하향/NNG,19,0.6701664034796543,Dovish
251,939, 인내심/NNG,1190,0.3881350682559659,Dovish
7,20, 유로존/NNG;경기/NNG;하락/NNG,27,0.5082095226387378,Dovish
5,11, 물가/NNG;압력/NNG;약화/NNG,16,0.6600123670632958,Dovish
4,15, 주택시장/NNG;타격/NNG,19,0.3872072553438002,Dovish
7,14, 강달러/NNG;압력/NNG,21,0.7260136037696254,Dovish
14,33, 할당량/NNG,47,0.6160115425924094,Dovish
73,160, 주소/NNG,233,0.6624874134397832,Dovish
152,328, 미/NNG;fed/NNG;금리/NNG;인상/NNG,480,0.6728906571523358,Dovish
5,16, 글로벌/NNG;경제/NNG;긍정적/VAX,21,0.4537585023560159,Dovish
8,18, 유동성/NNG;위기/NNG;우려/NNG,26,0.6453454255730003,Dovish
23,46, 성장/NNG;속도/NNG;둔화/NNG,69,0.7260136037696253,Dovish
5,12, 차환/NNG;발행/NNG;어렵/VA,17,0.6050113364746877,Dovish
6,15, 긍정적/VAX;파급효과/NNG,21,0.5808108830157004,Dovish
6,15, 영업이익률/NNG;상승/NNG,21,0.5808108830157004,Dovish
6,24, 자본지출/NNG;축소/NNG,30,0.3630068018848127,Dovish
4,12, 자본지출/NNG;감소/NNG,16,0.4840090691797502,Dovish
7,16, 대출/NNG;힘들/VA,23,0.6352619032984222,Dovish
92,178, 생산/NNG;줄/VV,270,0.7504859724360172,Dovish
30,104, 경제/NNG;불황/NNG,134,0.41885400217478386,Dovish
14,31, 공임/NNG,45,0.6557542227596617,Dovish
6,19, 금리/NNG;인하/NNG;기대/NNG;축소/NNG,25,0.458534907643974,Dovish
13,33, 이자/NNG;낮/VA,46,0.572010718121523,Dovish
23,44, 순유출세/NNG,67,0.7590142221227901,Dovish
24,87, 코넥스/NNG,111,0.40055922966600027,Dovish
25,67, 절대수익추구형/NNG,92,0.5418011968430041,Dovish
6,13, 일식/NNG,19,0.6701664034796543,Dovish
30,66, 우선권/NNG,96,0.6600123670632958,Dovish
21,54, 채권/NNG;금리/NNG;높/VA,75,0.5646772473763753,Dovish
48,109, 농어민/NNG,157,0.6394248253383857,Dovish
6,12, 서비스무역/NNG,18,0.7260136037696254,Dovish
323,777, 관광객/NNG,1100,0.60360976581104,Dovish
11,25, 범용/NNG,36,0.6388919713172704,Dovish
33,65, 개관/NNG,98,0.7371830438276197,Dovish
15,33, 공금/NNG,48,0.6600123670632958,Dovish
45,97, 기밀/NNG,142,0.673620869476972,Dovish
45,92, 직권/NNG,137,0.7102306993398508,Dovish
17,35, 송치/NNG,52,0.7052703579476362,Dovish
14,37, 구금/NNG,51,0.5494157001499868,Dovish
14,44, 인단/NNG,58,0.4620086569443071,Dovish
10,21, 계획경제/NNG,31,0.6914415273996433,Dovish
12,33, 순수입/NNG,45,0.5280098936506367,Dovish
35,80, 실크로드/NNG,115,0.6352619032984222,Dovish
13,31, 진력/NNG,44,0.6089146354196858,Dovish
16,42, 공공시설/NNG,58,0.5531532219197145,Dovish
103,635, 그렉시트/NNG,738,0.23552567303392574,Dovish
5,16, 옮겨가/VV,21,0.4537585023560159,Dovish
13,28, 금지조항/NNG,41,0.6741554892146522,Dovish
29,56, 적법/NNG,85,0.751942661047112,Dovish
44,109, 금리/NNG;인상/NNG;서둘/VV;않/VX,153,0.5861394232268535,Dovish
67,182, 금리/NNG;내리/VV;않/VX,249,0.5345374884897242,Dovish
4,15, 우려/NNG;비둘기/NNG,19,0.3872072553438002,Dovish
62,158, 하락/NNG;최저/NNG,220,0.5697828282748959,Dovish
4,16, 하자보수/NNG,20,0.36300680188481266,Dovish
13,50, 경인/NNG,63,0.37752707396020524,Dovish
22,71, 운하/NNG,93,0.4499239234628664,Dovish
6,17, 절반/NNG;부담/NNG,23,0.5124801908962061,Dovish
54,127, 대일/NNG,181,0.61739739533165,Dovish
117,241, 다각/NNG,358,0.7049260717099267,Dovish
7,16, 세계/NNG;경제/NNG;불확실성/NNG;높/VA,23,0.6352619032984222,Dovish
29,60, 예선/NNG,89,0.7018131503106378,Dovish
126,348, 금리/NNG;인하/NNG;압박/NNG,474,0.5257339889366253,Dovish
6,13, 안전자산/NNG;위험자산/NNG;선호/NNG,19,0.6701664034796543,Dovish
10,22, 낮/VA;임금/NNG;상승/NNG,32,0.6600123670632958,Dovish
88,181, 루/NNG,269,0.7059579793560998,Dovish
60,116, 곤두박/VV,176,0.7510485556237504,Dovish
44,113, 실은/MAG,157,0.5653911250595313,Dovish
37,83, 가도/NNG,120,0.6472892370958107,Dovish
9,19, 디젤유/NNG,28,0.687802361465961,Dovish
17,39, 도농/NNG,56,0.6329349366196735,Dovish
14,32, 무선인터넷/NNG,46,0.6352619032984222,Dovish
16,32, 빗장/NNG,48,0.7260136037696253,Dovish
5,17, 자를/VV,22,0.42706682574683846,Dovish
5,17, 뿜/VV,22,0.42706682574683846,Dovish
15,31, 올라타/VV,46,0.7025938100996375,Dovish
21,41, 달릴/VV,62,0.7437212526420554,Dovish
121,261, 농지/NNG,382,0.6731620387442503,Dovish
33,92, 공작/NNG,125,0.5208358461825573,Dovish
17,49, 시장조사업체/NNG,66,0.5037645413911687,Dovish
5,13, 억장/NNG,18,0.5584720028997119,Dovish
56,123, 결제금액/NNG,179,0.6610855579040491,Dovish
5,14, 푸/MAG,19,0.5185811455497324,Dovish
198,393, 문자/NNG,591,0.7315556923480194,Dovish
32,71, 시상/NNG,103,0.6544347977641692,Dovish
273,523, 노하우/NNG,796,0.7579415442795706,Dovish
22,71, 의원실/NNG,93,0.4499239234628664,Dovish
14,27, 위어바오/NNG,41,0.7529029965018337,Dovish
18,43, 자액/NNG,61,0.6078253426908492,Dovish
32,103, 넥타이/NNG,135,0.45111524894423327,Dovish
21,45, 자산/NNG;가격/NNG;떨어/VV,66,0.6776126968516504,Dovish
17,40, 실망/NNG;크/VV,57,0.6171115632041816,Dovish
33,76, 하방/NNG;위험/NNG;크/VV,109,0.6304854980104642,Dovish
94,247, 세계/NNG;경기/NNG;침체/NNG,341,0.5525933502376096,Dovish
140,321,매달/MAG,461,0.633282894253879,Dovish
201,404, 신용거래/NNG,605,0.7224194770182906,Dovish
62,133, 투자심리/NNG;냉각/NNG,195,0.6768848636649138,Dovish
8,44, 세계/NNG;경제/NNG;성장률/NNG;하향/NNG,52,0.26400494682531833,Dovish
9,22, 위험자산/NNG;선호/NNG;약세/NNG,31,0.5940111303569663,Dovish
4,16, 돈/NNG;시중/NNG;풀/VV,20,0.36300680188481266,Dovish
6,14, 연근/NNG,20,0.622297374659679,Dovish
37,85, 당원/NNG,122,0.632058902105321,Dovish
7,18, 글로벌/NNG;성장률/NNG;전망/NNG;하향/NNG,25,0.5646772473763753,Dovish
5,16, 국채/NNG;급등/NNG,21,0.4537585023560159,Dovish
6,17, 펼친다면/VV,23,0.5124801908962061,Dovish
136,536, 래스/NNG,672,0.36842481385324277,Dovish
44,89, 디플레이션/NNG;우려/NNG;크/VV,133,0.7178561475474947,Dovish
162,385, 인터넷은행/NNG,547,0.6109828769385939,Dovish
16,43, 제트/NNG,59,0.540289193502977,Dovish
29,66, 대형업체/NNG,95,0.6380119548278526,Dovish
6,19, 매출/NNG;타격/NNG,25,0.458534907643974,Dovish
9,18,반등시/NNG,27,0.7260136037696254,Dovish
78,186, 인턴/NNG,264,0.6089146354196858,Dovish
18,36, 자국/NNG;통화/NNG;방어/NNG,54,0.7260136037696254,Dovish
2,16, 통화정책/NNG;부정적/VAX,18,0.18150340094240633,Dovish
91,280, 연말정산/NNG,371,0.4719088424502565,Dovish
6,21, 금리/NNG;인상/NNG;가능성/NNG;강화/NNG,27,0.41486491643978596,Dovish
7,18, 대외시장/NNG,25,0.5646772473763753,Dovish
59,136, 인컴/NNG,195,0.6299235679765867,Dovish
5,14, 유동성/NNG;환경/NNG;개선/NNG,19,0.5185811455497324,Dovish
8,20, 미/NNG;경제/NNG;견조/NNG,28,0.5808108830157003,Dovish
9,21, 융사/NNG,30,0.6222973746596789,Dovish
1511,3062,금/NNG,4573,0.7165294286713938,Dovish
34,74, 블록딜/NNG,108,0.6671476358964126,Dovish
20,39, 쿼/NNG,59,0.7446293371996158,Dovish
6,17, 해친다는/VV,23,0.5124801908962061,Dovish
5,13, 합할/VV,18,0.5584720028997119,Dovish
5,14, 자금/NNG;증시/NNG;이탈/NNG,19,0.5185811455497324,Dovish
75,166, 치러진/VV,241,0.6560363889484567,Dovish
5,13, 부진/NNG;투자심리/NNG;위축/NNG,18,0.5584720028997119,Dovish
4,21, 그렉시트/NNG;우려/NNG;완화/NNG,25,0.27657661095985725,Dovish
8,18, 유가/NNG;증시/NNG;상승/NNG,26,0.6453454255730003,Dovish
101,208, 경제/NNG;악영향/NNG,309,0.7050709036608862,Dovish
38,149, 랑화/NNG,187,0.37031566366772845,Dovish
9,22, 금리/NNG;인하/NNG;확장/NNG,31,0.5940111303569663,Dovish
4,17, 라마/NNG,21,0.3416534605974707,Dovish
24,60, 폐기물/NNG,84,0.5808108830157004,Dovish
16,35, 운반/NNG,51,0.6637838663036575,Dovish
111,216, 운전/NNG,327,0.7461806483187816,Dovish
14,34, 경부/NNG,48,0.5978935560455738,Dovish
18,88, 부영/NNG,106,0.29700556517848314,Dovish
6,12, 수출/NNG;제품/NNG;가격/NNG;하락/NNG,18,0.7260136037696254,Dovish
2,14, 실물/NNG;경기/NNG;제약/NNG,16,0.20743245821989298,Dovish
16,35, 차이퉁/NNG,51,0.6637838663036575,Dovish
315,799, 조처/NNG,1114,0.5724512770649113,Dovish
31,70, 금리/NNG;인상/NNG;우려/NNG;하락/NNG,101,0.6430406204816682,Dovish
7,16, 부진/NNG;영향/NNG;상승/NNG,23,0.6352619032984222,Dovish
96,224, 국채/NNG;수익률/NNG;높/VA,320,0.622297374659679,Dovish
9,19, 테이퍼링/NNG;충격/NNG,28,0.687802361465961,Dovish
3,21, 생산/NNG;많/VA,24,0.20743245821989298,Dovish
5,16, 중간지주회사/NNG,21,0.4537585023560159,Dovish
6,42, 국채/NNG;마이너스/NNG,48,0.20743245821989298,Dovish
6,15, 모았으나/VV,21,0.5808108830157004,Dovish
6,34, 가계/NNG;부채/NNG;질/NNG;개선/NNG,40,0.25624009544810306,Dovish
6,13, 제품/NNG;하락/NNG,19,0.6701664034796543,Dovish
11,22, 이긴/VV,33,0.7260136037696254,Dovish
8,18, 기준연도/NNG,26,0.6453454255730003,Dovish
15,33, 금리/NNG;인하/NNG;사이클/NNG;종료/NNG,48,0.6600123670632958,Dovish
5,13, 금융위기/NNG;낮/VA,18,0.5584720028997119,Dovish
15,74, 물가/NNG;상승률/NNG;전망/NNG;하향/NNG,89,0.2943298393660643,Dovish
29,76, 글로벌/NNG;채권/NNG;강세/NNG,105,0.5540630134031351,Dovish
9,20, 달러인덱스/NNG;약세/NNG,29,0.6534122433926629,Dovish
12,32, 물가/NNG;마이너스/NNG,44,0.5445102028272191,Dovish
4,14, 성장동력/NNG;떨어/VV,18,0.41486491643978596,Dovish
122,274, 질타/NNG,396,0.6465230632109074,Dovish
15,42, 경제/NNG;성장률/NNG;전망/NNG;낮/VA,57,0.5185811455497324,Dovish
111,242, 지출/NNG;늘/VV,353,0.666012479491144,Dovish
19,46, 소비/NNG;투자/NNG;부진/NNG,65,0.5997503683314297,Dovish
5,23, 소비/NNG;투자/NNG;내수/NNG;개선/NNG,28,0.3156580885954893,Dovish
26,53, 금융시장/NNG;금리/NNG;인하/NNG,79,0.7123152338871797,Dovish
7,24, 인상/NNG;우려/NNG;완화/NNG,31,0.42350793553228144,Dovish
15,32, 통화정책/NNG;확장/NNG,47,0.6806377535340238,Dovish
7,16, 슬라이딩/NNG,23,0.6352619032984222,Dovish
10,26, 가계/NNG;부채/NNG;금리/NNG;인하/NNG,36,0.5584720028997119,Dovish
5,16, 가계/NNG;부채/NNG;개선/NNG,21,0.4537585023560159,Dovish
25,50, 대출/NNG;구조/NNG;개선/NNG,75,0.7260136037696254,Dovish
27,60, 되돌아오/VV,87,0.6534122433926628,Dovish
6,15, 생산/NNG;투자/NNG;부진/NNG,21,0.5808108830157004,Dovish
28,60, 심리/NNG;훼손/NNG,88,0.6776126968516504,Dovish
55,114,급하/VA,169,0.700539442233849,Dovish
1,15, 변동성/NNG;끝/NNG,16,0.09680181383595005,Dovish
3,13, 소비/NNG;투자/NNG;긍정적/VAX,16,0.33508320173982714,Dovish
38,92, 주택/NNG;거래/NNG;늘/VV,130,0.5997503683314297,Dovish
17,38, 휘말렸/VV,55,0.6495911191622965,Dovish
7,16, 코피/NNG,23,0.6352619032984222,Dovish
7,16, 스크랩/NNG,23,0.6352619032984222,Dovish
131,297, 결단/NNG,428,0.6404564450762352,Dovish
6,27, 더이상/MAG;금리/NNG;인하/NNG,33,0.32267271278650017,Dovish
11,27, 마이너스/NNG;상승/NNG,38,0.5915666401085836,Dovish
17,41, 신성/NNG,58,0.6020600616626163,Dovish
6,20, fed/NNG;금리/NNG;인상/NNG;기대/NNG;강화/NNG,26,0.43560816226177523,Dovish
6,13, 전망/NNG;성장/NNG;경로/NNG;하방/NNG;위험/NNG,19,0.6701664034796543,Dovish
24,48, 금융시장/NNG;fed/NNG;금리/NNG;인상/NNG,72,0.7260136037696254,Dovish
25,52, 가격/NNG;소폭/MAG;상승/NNG,77,0.6980900036246398,Dovish
32,69,시선/NNG,101,0.6734039223370438,Dovish
239,502, 공원/NNG,741,0.6913037900435876,Dovish
43,126, 관람/NNG,169,0.49553309463641093,Dovish
24,63, 피해업종/NNG,87,0.5531532219197146,Dovish
34,73, 세정/NNG,107,0.6762866446073224,Dovish
29,59, 가계/NNG;부채/NNG;확대/NNG,88,0.7137082884514961,Dovish
63,127, 장금/NNG,190,0.7202969612202583,Dovish
56,115, 접점/NNG,171,0.7070741184538961,Dovish
24,50, 가계/NNG;부채/NNG;관리/NNG;강화/NNG,74,0.6969730596188405,Dovish
308,609,발/NNG,917,0.7343585877210004,Dovish
7,53, 긴급정상회의/NNG,60,0.19177717835424068,Dovish
10,28, 단간/NNG,38,0.5185811455497324,Dovish
24,75, 장기물/NNG;부담/NNG,99,0.4646487064125603,Dovish
26,55, 벌여왔/VV,81,0.6864128617458277,Dovish
65,147, 은행지점/NNG,212,0.6420528468710972,Dovish
12,28, 웨/NNG,40,0.622297374659679,Dovish
1,26, 은행/NNG;영업/NNG;중단/NNG,27,0.05584720028997118,Dovish
13,27, 아스/NNG,40,0.6991242110374171,Dovish
3,23, 유럽안정화기구/NNG,26,0.1893948531572936,Dovish
5,12, 국제/NNG;금융시장/NNG;불안/NNG;크/VV,17,0.6050113364746877,Dovish
43,93,안심/NNG,136,0.6713674185396535,Dovish
25,56, fed/NNG;금리/NNG;인상/NNG;속도/NNG;늦/VV,81,0.6482264319371656,Dovish
136,264, 금리/NNG;인상/NNG;미루/VV,400,0.7480140160050687,Dovish
6,13, 일자리/NNG;증가/NNG;둔화/NNG,19,0.6701664034796543,Dovish
7,31, 고용/NNG;견조/NNG,38,0.32787711137983083,Dovish
6,12, 합쳤/VV,18,0.7260136037696254,Dovish
57,122, 족/NNG,179,0.6784061543421089,Dovish
7,17, 한민족/NNG,24,0.5978935560455738,Dovish
39,88, 관광업/NNG,127,0.6435120578867135,Dovish
17,50, 교부금/NNG,67,0.49368925056334534,Dovish
5,21, 폐허/NNG,26,0.34572076369982163,Dovish
4,15, 부정과/NNG,19,0.3872072553438002,Dovish
8,35, 마테오/NNG,43,0.33189193315182874,Dovish
29,61, 렌치/NNG,90,0.6903080166989881,Dovish
27,65, 진흥회/NNG,92,0.6031497631316889,Dovish
10,21, 제금/NNG,31,0.6914415273996433,Dovish
8,18, 대외/NNG;위험/NNG;확대/NNG,26,0.6453454255730003,Dovish
11,24, arpu/NNG,35,0.6655124701221565,Dovish
11,24, 미래부/NNG,35,0.6655124701221565,Dovish
22,46,약/NNG,68,0.6944477949100765,Dovish
40,95, 증축/NNG,135,0.6113798768586319,Dovish
22,50, 투융자/NNG,72,0.6388919713172704,Dovish
2,36, 추경/NNG;불확실성/NNG,38,0.08066817819662504,Dovish
12,36, 끝장/NNG,48,0.4840090691797503,Dovish
41,79, 신흥국/NNG;자금/NNG;이탈/NNG,120,0.7535837406216365,Dovish
31,63, 반겼/VV,94,0.7144895783129647,Dovish
5,17, 유럽재정안정화기구/NNG,22,0.42706682574683846,Dovish
2,14, 부채/NNG;상환/NNG;실패/NNG,16,0.20743245821989298,Dovish
18,57, 사법부/NNG,75,0.4585349076439739,Dovish
7,18, 마진거래/NNG,25,0.5646772473763753,Dovish
4,16, 대주거래/NNG,20,0.36300680188481266,Dovish
5,19, 금리/NNG;인상/NNG;우려/NNG;완화/NNG;상승/NNG,24,0.38211242303664494,Dovish
4,12, 재정정책/NNG;성장/NNG,16,0.4840090691797502,Dovish
20,42, 부채/NNG;경감/NNG,62,0.6914415273996433,Dovish
20,44, 종료/NNG;우려/NNG,64,0.6600123670632958,Dovish
8,23, 원유/NNG;하락/NNG,31,0.5050529417527828,Dovish
20,49, 조리/NNG,69,0.5926641663425514,Dovish
8,29, 식자/NNG,37,0.4005592296660002,Dovish
89,189, 통업/NNG,278,0.6837588437618694,Dovish
11,25, 두부/NNG,36,0.6388919713172704,Dovish
59,129, 배추/NNG,188,0.6641054670140759,Dovish
13,29, 마진/NNG;높/VA,42,0.6509087482072504,Dovish
5,11, 체재/NNG,16,0.6600123670632958,Dovish
23,65, 금리/NNG;인하/NNG;지준율/NNG;인하/NNG,88,0.5137942426677349,Dovish
24,59, 부동산/NNG;부양/NNG,83,0.5906551352702037,Dovish
13,27, 채권/NNG;부실/NNG,40,0.6991242110374171,Dovish
19,38, 우려/NNG;완화/NNG;상승/NNG,57,0.7260136037696254,Dovish
8,16, 잠재/NNG;성장률/NNG;높/VA,24,0.7260136037696253,Dovish
6,14, 저유가/NNG;긍정적/VAX,20,0.622297374659679,Dovish
4,15, 기업/NNG;구조조정/NNG;가속/NNG,19,0.3872072553438002,Dovish
6,12, 유동성/NNG;긍정적/VAX,18,0.7260136037696254,Dovish
10,22, 정책/NNG;차질/NNG,32,0.6600123670632958,Dovish
209,410, 생활안정/NNG,619,0.7401797228675693,Dovish
119,245, 어린이집/NNG,364,0.7052703579476362,Dovish
11,34, 매입비/NNG,45,0.46977350832152226,Dovish
9,30, 경제/NNG;활동/NNG;성장/NNG,39,0.43560816226177523,Dovish
5,13, 성장/NNG;지탱/NNG,18,0.5584720028997119,Dovish
14,30, 성장/NNG;멈추/VV,44,0.6776126968516504,Dovish
3,17, 안진/NNG,20,0.25624009544810306,Dovish
10,23, 성장/NNG;더디/VA,33,0.6313161771909785,Dovish
53,116, 랜드화/NNG,169,0.6634262241343128,Dovish
8,26, 인플레이션/NNG;전망/NNG;낮/VV,34,0.44677760231976943,Dovish
22,46, 탈락/MAG,68,0.6944477949100765,Dovish
12,25, 원자재/NNG;약세/NNG,37,0.6969730596188405,Dovish
17,60, 국채/NNG;매도/NNG;강화/NNG,77,0.41140770880278776,Dovish
63,178, 일보/NNG,241,0.5139197419942292,Dovish
5,16, 기술적/VAX;경기/NNG;침체/NNG,21,0.4537585023560159,Dovish
10,29, 경제/NNG;매우/MAG;어렵/VA,39,0.5006990370825003,Dovish
5,13, 실적/NNG;악화/NNG;하락/NNG,18,0.5584720028997119,Dovish
14,31, 이익/NNG;급감/NNG,45,0.6557542227596617,Dovish
5,13, 미중전략경제대화/NNG,18,0.5584720028997119,Dovish
38,86, 수출/NNG;경쟁력/NNG;강화/NNG,124,0.6415934172847853,Dovish
35,71, 되돌아왔/VV,106,0.7157880600545603,Dovish
24,52, 시중/NNG;돈/NNG;풀/VV,76,0.6701664034796543,Dovish
32,63, 금리/NNG;fed/NNG;금리/NNG;인상/NNG,95,0.7375376292262861,Dovish
9,20, 외국인/NNG;자금/NNG;이탈/NNG;가속/NNG,29,0.6534122433926629,Dovish
22,58, 부동산투자회사/NNG,80,0.5507689407907503,Dovish
17,44, 인플레이션/NNG;떨어/VV,61,0.5610105120038015,Dovish
23,68, 거시/NNG;금융안정/NNG,91,0.49112684960886416,Dovish
170,340,원위안/NNG,510,0.7260136037696254,Dovish
8,19, 농경지/NNG,27,0.6113798768586319,Dovish
23,46, 한자리수/NNG,69,0.7260136037696253,Dovish
937,2167, 재정환율/NNG,3104,0.6278493278561503,Dovish
6,12, 로버/NNG,18,0.7260136037696254,Dovish
19,40, 고품질/NNG,59,0.6897129235811441,Dovish
12,26, 대출/NNG;선호/NNG,38,0.6701664034796543,Dovish
5,11, 신흥국/NNG;금리/NNG;상승/NNG,16,0.6600123670632958,Dovish
65,164, 마이너스통장대출/NNG,229,0.5754985883539713,Dovish
17,35, 대출/NNG;높/VA,52,0.7052703579476362,Dovish
31,72,풀/VV,103,0.6251783810238442,Dovish
25,52, 금리/NNG;인상/NNG;기대/NNG;약하/VA,77,0.6980900036246398,Dovish
32,65, 인수도/NNG,97,0.7148441637116312,Dovish
15,43, 통화위기/NNG,58,0.506521118909041,Dovish
91,194, 수익금/NNG,285,0.6811055458044939,Dovish
43,93, 저리자금/NNG,136,0.6713674185396535,Dovish
8,25, 대출실행일/NNG,33,0.46464870641256023,Dovish
45,95, 세계/NNG;금융시장/NNG;불안/NNG,140,0.6878023614659609,Dovish
8,19, 회사채/NNG;시장/NNG;안정/NNG,27,0.6113798768586319,Dovish
7,15, 대외/NNG;여건/NNG;우호적/VAX,22,0.6776126968516504,Dovish
4,18, 해운/NNG;건설/NNG;취약/NNG,22,0.32267271278650017,Dovish
5,20, 신용위험/NNG;경계/NNG,25,0.3630068018848127,Dovish
7,14, 금리/NNG;인하/NNG;힘들/VA,21,0.7260136037696254,Dovish
10,30, 플래트닝/NNG;되돌/VV,40,0.48400906917975023,Dovish
63,134,중간/NNG,197,0.6826695080221851,Dovish
6,17, 완승/NNG,23,0.5124801908962061,Dovish
26,100, 디플레이션/NNG;공포/NNG,126,0.37752707396020524,Dovish
146,336, 블록/NNG,482,0.6309403937521745,Dovish
25,48, 고부가/NNG,73,0.7562641705933597,Dovish
50,107, 갑론을박/NNG,157,0.6785173867005845,Dovish
59,155, 딤섬본드/NNG,214,0.5527071306117148,Dovish
26,50, 유턴/NNG,76,0.7550541479204105,Dovish
13,31, 재생에너지/NNG,44,0.6089146354196858,Dovish
22,58, 소사이어티/NNG,80,0.5507689407907503,Dovish
11,26, 자금/NNG;유출/NNG;압력/NNG,37,0.614319203189683,Dovish
42,107, 거취/NNG,149,0.5699546048284909,Dovish
26,50, 전담팀/NNG,76,0.7550541479204105,Dovish
33,88, 선배/NNG,121,0.5445102028272191,Dovish
24,54, 배울/VV,78,0.6453454255730003,Dovish
9,40, 이롭/VA,49,0.32670612169633145,Dovish
6,33, 국채/NNG;가격/NNG;부정적/VAX,39,0.26400494682531833,Dovish
54,104, 경제/NNG;나쁘/VA,158,0.7539372039146109,Dovish
20,74, 애플/NNG,94,0.39243978582141914,Dovish
12,35, 신용등급/NNG;투기등급/NNG;강등/NNG,47,0.49783789972774317,Dovish
20,44, 능사/NNG,64,0.6600123670632958,Dovish
13,50, 금리/NNG;인하/NNG;경기/NNG;회복/NNG,63,0.37752707396020524,Dovish
17,44, 외통/NNG,61,0.5610105120038015,Dovish
7,15, 이자/NNG;부담/NNG;높/VA,22,0.6776126968516504,Dovish
8,17,오버슈팅/NNG,25,0.6833069211949414,Dovish
16,148, 국제채권단/NNG,164,0.15697591432856764,Dovish
37,78, 환경보호/NNG,115,0.6887821369096446,Dovish
22,56, 늦춰진/VV,78,0.5704392601047057,Dovish
6,17, 부양책/NNG;기대/NNG;높/VA,23,0.5124801908962061,Dovish
24,47, 건과/NNG,71,0.7414607017221707,Dovish
8,16, 금리/NNG;환율/NNG;안정/NNG,24,0.7260136037696253,Dovish
19,39, 배기가스/NNG,58,0.707397870339635,Dovish
8,18, 재정/NNG;건전성/NNG;악화/NNG;우려/NNG,26,0.6453454255730003,Dovish
75,164, 물가/NNG;상승률/NNG;오르/VV,239,0.6640368327161208,Dovish
5,16, 유액/NNG,21,0.4537585023560159,Dovish
11,47, 조작사태/NNG,58,0.3398361549559949,Dovish
13,31, 하세/NNG,44,0.6089146354196858,Dovish
68,146, 프로모션/NNG,214,0.6762866446073224,Dovish
4,12, 출사/NNG,16,0.4840090691797502,Dovish
51,112, 은산분리/NNG,163,0.6611909605759089,Dovish
97,201, 전문지/NNG,298,0.7007295479169519,Dovish
1710,3624, etf/NNG,5334,0.6851452883256398,Dovish
10,36, 낙농/NNG,46,0.4033408909831252,Dovish
11,24, 벌지/NNG,35,0.6655124701221565,Dovish
13,37, 빨아들였/VV,50,0.5101717215678448,Dovish
4,14, 해부/NNG,18,0.41486491643978596,Dovish
26,57, 비효율성/NNG,83,0.6623281999301845,Dovish
4,12, 기업/NNG;부실/NNG;위험/NNG,16,0.4840090691797502,Dovish
8,21, 부실/NNG;위험/NNG;높/VA,29,0.5531532219197145,Dovish
14,42, 성장/NNG;약하/VA,56,0.4840090691797503,Dovish
5,11, 약하/VA;회복/NNG,16,0.6600123670632958,Dovish
16,50, 외수/NNG,66,0.46464870641256023,Dovish
5,12, 부진/NNG;금리/NNG;인상/NNG;우려/NNG;완화/NNG,17,0.6050113364746877,Dovish
6,14, 금리/NNG;인상/NNG;우려/NNG;낮/VV,20,0.622297374659679,Dovish
13,31, 작/VA;금리/NNG;인상/NNG,44,0.6089146354196858,Dovish
8,16, 투자수익률/NNG;마이너스/NNG,24,0.7260136037696253,Dovish
5,13, 통화/NNG;많/VA,18,0.5584720028997119,Dovish
17,35, 임금/NNG;인상/NNG;압력/NNG,52,0.7052703579476362,Dovish
10,26, 물가/NNG;상승률/NNG;약하/VA,36,0.5584720028997119,Dovish
24,76, 금리/NNG;인상/NNG;선호/NNG,100,0.458534907643974,Dovish
13,40, 재정/NNG;확충/NNG,53,0.4719088424502565,Dovish
20,46, 잠재/NNG;성장률/NNG;떨어/VV,66,0.6313161771909785,Dovish
6,12, 글로벌/NNG;교역/NNG;감소/NNG,18,0.7260136037696254,Dovish
21,42, 일시적/VAX;효과/NNG,63,0.7260136037696254,Dovish
67,146, 시니어/NNG,213,0.6663412527748617,Dovish
271,586, 하단/NNG;지지/NNG,857,0.6715006369336808,Dovish
67,131, 선취/NNG,198,0.7426398695048076,Dovish
31,74, 보험업법/NNG,105,0.6082816680231996,Dovish
52,101, 사라진다/VV,153,0.7475783642776341,Dovish
4,14, 외국인/NNG;국채선물/NNG;매수/NNG;늘/VV,18,0.41486491643978596,Dovish
5,12, 미/NNG;원유/NNG;재고/NNG;증가/NNG,17,0.6050113364746877,Dovish
13,27, 원자재/NNG;가격/NNG;회복/NNG,40,0.6991242110374171,Dovish
7,18, 부양책/NNG;기대/NNG;상승/NNG,25,0.5646772473763753,Dovish
19,48, 위험자산/NNG;선호/NNG;살/VV,67,0.5747607696509535,Dovish
8,22, 채권/NNG;수요/NNG;많/VA,30,0.5280098936506367,Dovish
326,788, fed/NNG;비둘기/NNG,1114,0.6007117635251216,Dovish
11,30, 좀비/NNG,41,0.5324099760977252,Dovish
5,14, 이행보증/NNG,19,0.5185811455497324,Dovish
66,228, 이슬람국가/NNG,294,0.4203236653403094,Dovish
28,86, 무장세력/NNG,114,0.4727530443151049,Dovish
10,21, 정치/NNG;불확실성/NNG;하락/NNG,31,0.6914415273996433,Dovish
28,78, 개발은행/NNG,106,0.5212405360397311,Dovish
28,76, 아시아인프라투자은행/NNG,104,0.5349573922513029,Dovish
8,16, 지준율/NNG;하향/NNG,24,0.7260136037696253,Dovish
12,24, 문어/NNG,36,0.7260136037696254,Dovish
143,288, 국토교통부/NNG,431,0.7209718426323363,Dovish
9,23, 내부감사/NNG,32,0.5681845594718807,Dovish
73,196, 달러인덱스/NNG;상승/NNG,269,0.5408060517875781,Dovish
61,129, 성패/NNG,190,0.6866175167433667,Dovish
35,75, 초당/NNG,110,0.6776126968516504,Dovish
7,19, 치루/VV,26,0.5349573922513029,Dovish
281,561, 토론회/NNG,842,0.7273077456658279,Dovish
16,43, 지지층/NNG,59,0.540289193502977,Dovish
28,76, 기업가/NNG,104,0.5349573922513029,Dovish
90,226, 전직/NNG,316,0.5782409233563388,Dovish
13,37, 막말/NNG,50,0.5101717215678448,Dovish
25,51, 전문의/NNG,76,0.7117780429113975,Dovish
7,33, 오드/NNG,40,0.3080057712962047,Dovish
47,104, 떠넘기/VV,151,0.6562046034071614,Dovish
6,14, 수용소/NNG,20,0.622297374659679,Dovish
25,63, 자유당/NNG,88,0.576201272833036,Dovish
7,16, 수정예산/NNG,23,0.6352619032984222,Dovish
7,18, 세비/NNG,25,0.5646772473763753,Dovish
18,42, 간병/NNG,60,0.6222973746596789,Dovish
64,133, 요양/NNG,197,0.6987198592670077,Dovish
6,12, 의식주/NNG,18,0.7260136037696254,Dovish
8,32, 총서기/NNG,40,0.36300680188481266,Dovish
13,31, 정치국/NNG,44,0.6089146354196858,Dovish
5,11, 고성능/NNG,16,0.6600123670632958,Dovish
48,92, 평일/NNG,140,0.7575794126291744,Dovish
10,24, fed/NNG;금리/NNG;오르/VV;못하/VX,34,0.6050113364746877,Dovish
19,53, 부동산/NNG;경기/NNG;부양/NNG,72,0.520538055532939,Dovish
8,18, 유가/NNG;가격/NNG;상승/NNG,26,0.6453454255730003,Dovish
4,28, 금리/NNG;인하/NNG;종료/NNG,32,0.20743245821989298,Dovish
5,17, 소득/NNG;갭/NNG;확대/NNG,22,0.42706682574683846,Dovish
5,13, 채권/NNG;금리/NNG;쉽/VA,18,0.5584720028997119,Dovish
20,49, 외부충격/NNG;취약/NNG,69,0.5926641663425514,Dovish
12,34, 구조적/VAX;성장/NNG,46,0.5124801908962061,Dovish
20,41, 생산성/NNG;하락/NNG,61,0.7083059548971955,Dovish
46,124, 통화/NNG;부양/NNG,170,0.5386552544097221,Dovish
8,18, 완화/NNG;압력/NNG,26,0.6453454255730003,Dovish
12,24, 위안거리/NNG,36,0.7260136037696254,Dovish
145,361, 코너/NNG,506,0.5832242246348791,Dovish
48,108, 탄핵안/NNG,156,0.6453454255730003,Dovish
18,39, 불법자금/NNG,57,0.6701664034796543,Dovish
64,149, 살해/NNG,213,0.6236895388088057,Dovish
8,19, 근거지/NNG,27,0.6113798768586319,Dovish
9,18, 자폭/NNG,27,0.7260136037696254,Dovish
8,16, 경제/NNG;정치/NNG;불확실성/NNG,24,0.7260136037696253,Dovish
6,16, 총선/NNG;정치/NNG;불확실성/NNG,22,0.5445102028272191,Dovish
135,273, 국채/NNG;금리/NNG;내리/VV,408,0.7180354322996295,Dovish
5,11, 산사/NNG,16,0.6600123670632958,Dovish
34,67, 개업/NNG,101,0.7368496277064855,Dovish
7,14, 대출비중/NNG;축소/NNG,21,0.7260136037696254,Dovish
22,43, 비용/NNG;감축/NNG,65,0.7428976410665934,Dovish
16,35, 우리사주조합/NNG,51,0.6637838663036575,Dovish
3,32, 고용/NNG;지수/NNG;하락/NNG,35,0.13612755070680477,Dovish
14,27, 황이/NNG,41,0.7529029965018337,Dovish
9,26, 급부/NNG,35,0.5026248026097407,Dovish
107,208, 호주달러/NNG;강세/NNG,315,0.7469563038783646,Dovish
51,98, 빼앗/VV,149,0.755646812086753,Dovish
18,45, 경제/NNG;전망/NNG;금리/NNG;인상/NNG,63,0.5808108830157004,Dovish
6,14, 하방/NNG;위험/NNG;감소/NNG,20,0.622297374659679,Dovish
7,15, 해왔으며/VV,22,0.6776126968516504,Dovish
35,69, 성장/NNG;가속/NNG,104,0.7365355400561417,Dovish
19,54, 느리/VA;성장/NNG,73,0.5108984619119586,Dovish
12,23, 세워진/VV,35,0.7575794126291744,Dovish
7,17, 가격/NNG;하락/NNG;제한적/VAX,24,0.5978935560455738,Dovish
94,199, 빌렸/VV,293,0.6858821985361284,Dovish
59,122, 끈/VV,181,0.7022098790558672,Dovish
8,16, 전환주식/NNG,24,0.7260136037696253,Dovish
11,44, 호조/NNG;fed/NNG;금리/NNG;인상/NNG,55,0.3630068018848127,Dovish
5,12, 유통금융/NNG,17,0.6050113364746877,Dovish
9,18, 이익/NNG;안정성/NNG;높/VA,27,0.7260136037696254,Dovish
221,614, 파리/NNG,835,0.522635200107776,Dovish
8,33, 금융시장/NNG;심각/NNG,41,0.3520065957670911,Dovish
16,34, 수기/NNG,50,0.6833069211949414,Dovish
89,171, 급급/NNG,260,0.7557334588946978,Dovish
6,13, 설립계획/NNG,19,0.6701664034796543,Dovish
13,41, 헤/VV,54,0.4603988706831771,Dovish
14,44, 원격/NNG,58,0.4620086569443071,Dovish
8,19, 금융시장/NNG;불확실성/NNG;확대/NNG,27,0.6113798768586319,Dovish
22,50, 분할상환비중/NNG,72,0.6388919713172704,Dovish
30,78, 수산업/NNG,108,0.5584720028997118,Dovish
1,25, 떠밀린/VV,26,0.05808108830157003,Dovish
5,15, 강일/NNG,20,0.48400906917975023,Dovish
18,38, 관제/NNG,56,0.687802361465961,Dovish
15,33, 연유/NNG,48,0.6600123670632958,Dovish
1545,6002, 브렉시트/NNG,7547,0.3737724151363116,Dovish
2,15, 춘투/NNG,17,0.1936036276719001,Dovish
39,78, 초월/NNG,117,0.7260136037696254,Dovish
10,22, 방직/NNG,32,0.6600123670632958,Dovish
59,149, 위안화채권/NNG,208,0.5749637935893678,Dovish
9,19, 자본/NNG;유출/NNG;압력/NNG;크/VV,28,0.687802361465961,Dovish
5,18, 금리/NNG;역전/NNG;해소/NNG,23,0.4033408909831252,Dovish
53,123, 재정/NNG;지출/NNG;늘/VV,176,0.6256702601591894,Dovish
7,14, 이익/NNG;내/VV;어렵/VA,21,0.7260136037696254,Dovish
5,14, 금융위기/NNG;성공/NNG,19,0.5185811455497324,Dovish
14,32, 수출기업/NNG;부담/NNG,46,0.6352619032984222,Dovish
11,57, 브렉시트/NNG;위험/NNG,68,0.2802157768935396,Dovish
7,17, 공공요금/NNG;상승/NNG,24,0.5978935560455738,Dovish
6,12, 구조적/VAX;부진/NNG,18,0.7260136037696254,Dovish
38,76, 주거비/NNG;부담/NNG,114,0.7260136037696254,Dovish
11,26, 지출/NNG;급증/NNG,37,0.614319203189683,Dovish
6,17, 구조/NNG;위험/NNG,23,0.5124801908962061,Dovish
14,30, 경기/NNG;친화/NNG,44,0.6776126968516504,Dovish
9,19, 위험/NNG;과도/NNG,28,0.687802361465961,Dovish
8,19, 임금/NNG;개선/NNG,27,0.6113798768586319,Dovish
10,25, 성장/NNG;좋/VA,35,0.5808108830157004,Dovish
5,16, 많/VA;안정/NNG,21,0.4537585023560159,Dovish
18,43, 소득/NNG;많/VA,61,0.6078253426908492,Dovish
36,69, 원샷법/NNG,105,0.7575794126291744,Dovish
7,19, 인플레이션/NNG;하락/NNG;압력/NNG,26,0.5349573922513029,Dovish
6,18, 경제/NNG;펀더멘털/NNG;약화/NNG,24,0.4840090691797503,Dovish
5,14, 성장/NNG;잠재력/NNG;하락/NNG,19,0.5185811455497324,Dovish
50,103, 산업/NNG;경쟁력/NNG;강화/NNG,153,0.7048675764753646,Dovish
8,28, 물가/NNG;불확실성/NNG,36,0.41486491643978596,Dovish
426,814, 저점/NNG;고점/NNG,1240,0.7599061307269297,Dovish
23,74, 테러사태/NNG,97,0.45130575369463194,Dovish
40,81, 가격/NNG;최저/NNG,121,0.7170504728588893,Dovish
3,15, 원화환산액/NNG,18,0.2904054415078502,Dovish
85,163, 달러인덱스/NNG;오르/VV,248,0.7571921020910203,Dovish
20,54, 수의/NNG,74,0.5377878546441669,Dovish
20,40, 사들임/VV,60,0.7260136037696254,Dovish
33,76, 상장법인/NNG,109,0.6304854980104642,Dovish
5,11, 개선/NNG;fed/NNG;금리/NNG;인상/NNG,16,0.6600123670632958,Dovish
10,31, 유로존/NNG;국채/NNG;금리/NNG;하락/NNG,41,0.46839587339975836,Dovish
7,30, 장기물/NNG;금리/NNG;내리/VV,37,0.3388063484258252,Dovish
19,51, 경기/NNG;하락/NNG;압력/NNG,70,0.540951312612662,Dovish
203,400, 채권/NNG;금리/NNG;오르/VV,603,0.7369038078261698,Dovish
5,12, 가격/NNG;하락/NNG;최대/NNG,17,0.6050113364746877,Dovish
21,53, 금/NNG;가격/NNG;금리/NNG;인상/NNG,74,0.575331535062722,Dovish
341,840, 롱스탑/NNG,1181,0.5894539021081958,Dovish
140,297, 화제/NNG,437,0.6844572695471216,Dovish
107,208, 탈동조화/NNG,315,0.7469563038783646,Dovish
4,12, 인플레이션/NNG;디플레이션/NNG;우려/NNG,16,0.4840090691797502,Dovish
27,79, 유로존/NNG;양적완화/NNG,106,0.49626246333619967,Dovish
7,16, 채권시장/NNG;일시적/VAX,23,0.6352619032984222,Dovish
10,27, 고용시장/NNG;강하/VA,37,0.5377878546441669,Dovish
8,29, 심리/NNG;부진/NNG,37,0.4005592296660002,Dovish
157,328,산유국/NNG,485,0.6950252182428731,Dovish
4,17, 경기/NNG;침체/NNG;늪/NNG,21,0.3416534605974707,Dovish
18,49, 침체/NNG;늪/NNG;빠지/VV,67,0.5333977497082962,Dovish
37,78, 각료회의/NNG,115,0.6887821369096446,Dovish
113,235, 출렁였/VV,348,0.698208827455044,Dovish
28,70, 예상/NNG;웃돌/VV;호조/NNG,98,0.5808108830157003,Dovish
6,15, 결제기관/NNG,21,0.5808108830157004,Dovish
14,28, 대통/NNG,42,0.7260136037696254,Dovish
14,46, 연성/NNG,60,0.441921324033685,Dovish
48,106, fed/NNG;경제/NNG;성장/NNG,154,0.6575217543573967,Dovish
12,49, 임금/NNG;상승률/NNG;둔화/NNG,61,0.3555984998055308,Dovish
4,14, 국호/NNG,18,0.41486491643978596,Dovish
10,52, 이언/NNG,62,0.27923600144985594,Dovish
20,46, fed/NNG;통화정책/NNG;불확실성/NNG,66,0.6313161771909785,Dovish
5,13, 변동성/NNG;급증/NNG,18,0.5584720028997119,Dovish
32,87, 자본/NNG;유출/NNG;위험/NNG,119,0.5340789728880002,Dovish
246,474, 공급/NNG;과잉/NNG;우려/NNG,720,0.7535837406216365,Dovish
47,145, 금융투자상품/NNG,192,0.4706570948575502,Dovish
35,70, 가용자본/NNG,105,0.7260136037696254,Dovish
4,12, 출생률/NNG,16,0.4840090691797502,Dovish
5,11, 주거비/NNG;부담/NNG;증가/NNG,16,0.6600123670632958,Dovish
2,20, 산업/NNG;대출/NNG;증가/NNG,22,0.14520272075392507,Dovish
12,23, 섣불/VA;금리/NNG;인상/NNG,35,0.7575794126291744,Dovish
8,31, fed/NNG;완만/NNG;금리/NNG;인상/NNG,39,0.3747166987198067,Dovish
15,55, 언제/MAG;금리/NNG;인상/NNG,70,0.39600742023797747,Dovish
15,48, 체인저/NNG,63,0.45375850235601584,Dovish
94,213, 빈/NNG,307,0.6408007394774158,Dovish
20,39, 한다거나/XSV,59,0.7446293371996158,Dovish
26,53, 금리/NNG;인상/NNG;전망/NNG;강화/NNG,79,0.7123152338871797,Dovish
7,14, 하이일드/NNG;시장/NNG;불안/NNG,21,0.7260136037696254,Dovish
19,49, 경제/NNG;회복/NNG;자신/NNG,68,0.5630309580254238,Dovish
12,28, 하방/NNG;압력/NNG;크/VV,40,0.622297374659679,Dovish
16,34, 반부패/NNG,50,0.6833069211949414,Dovish
12,29, 여행업/NNG,41,0.6008388444990004,Dovish
6,36, fed/NNG;금리/NNG;인상/NNG;금리/NNG;인상/NNG,42,0.24200453458987514,Dovish
8,21, 경제/NNG;위기/NNG;빠지/VV,29,0.5531532219197145,Dovish
155,458, 선제안내/NNG,613,0.4914065877043316,Dovish
25,50, 유로존/NNG;회복/NNG,75,0.7260136037696254,Dovish
121,330, 역레포/NNG,451,0.5324099760977252,Dovish
8,22, 줬으나/VV,30,0.5280098936506367,Dovish
6,12, 인상/NNG;유보/NNG,18,0.7260136037696254,Dovish
5,14, 금리/NNG;인상/NNG;경제/NNG;자신/NNG,19,0.5185811455497324,Dovish
3,14, 전망/NNG;소폭/MAG;낮/VA,17,0.3111486873298395,Dovish
3,24, 경상/NNG;성장/NNG,27,0.18150340094240636,Dovish
119,237, ff/NNG;금리/NNG;인상/NNG,356,0.7290769523087377,Dovish
4,13, 목적/VV,17,0.44677760231976943,Dovish
16,43, 채권시장/NNG;fed/NNG;금리/NNG;인상/NNG,59,0.540289193502977,Dovish
13,28, 전망/NNG;소폭/MAG;상향/NNG,41,0.6741554892146522,Dovish
20,49, 느리/VA;금리/NNG;인상/NNG,69,0.5926641663425514,Dovish
4,12, 급락/NNG;최대/NNG,16,0.4840090691797502,Dovish
13,27, 부채/NNG;구조/NNG;개선/NNG,40,0.6991242110374171,Dovish
12,28, 가계/NNG;소득/NNG;개선/NNG,40,0.622297374659679,Dovish
9,18, 거시/NNG;충격/NNG,27,0.7260136037696254,Dovish
1,23, 요진/NNG,24,0.06313161771909785,Dovish
6,14, 노동시장/NNG;유연/NNG;높/VV,20,0.622297374659679,Dovish
116,227,수출입/NNG,343,0.7420050928394409,Dovish
6,13, 둔화/NNG;국제/NNG;유가/NNG;하락/NNG,19,0.6701664034796543,Dovish
11,24, 고단/NNG,35,0.6655124701221565,Dovish
23,45, 국채/NNG;금리/NNG;인상/NNG,68,0.7421472394089503,Dovish
17,38, 유가/NNG;반등/NNG,55,0.6495911191622965,Dovish
49,195, 정무위원회/NNG,244,0.36486837522781174,Dovish
12,30, 원유/NNG;공급/NNG;과잉/NNG;우려/NNG,42,0.5808108830157004,Dovish
3,13, 외국인/NNG;국채선물/NNG;매수/NNG;강화/NNG,16,0.33508320173982714,Dovish
5,11, 초장기물/NNG;발행/NNG;늘/VV,16,0.6600123670632958,Dovish
17,52, 이익률/NNG;하락/NNG,69,0.4747012024647551,Dovish
42,83, 주택분양/NNG,125,0.7347607556222715,Dovish
9,21, 자금난/NNG;완화/NNG,30,0.6222973746596789,Dovish
5,16, 성장/NNG;전망/NNG;하방/NNG;위험/NNG,21,0.4537585023560159,Dovish
6,13, 어렵/VA;fed/NNG;금리/NNG;인상/NNG,19,0.6701664034796543,Dovish
41,91, 광공업/NNG;생산/NNG;감소/NNG,132,0.6542100605396625,Dovish
8,17, 금리/NNG;실망/NNG,25,0.6833069211949414,Dovish
10,30, 상장회사/NNG,40,0.48400906917975023,Dovish
45,103, 물가/NNG;하락/NNG;압력/NNG,148,0.634380818827828,Dovish
6,12, 위험/NNG;일시적/VAX,18,0.7260136037696254,Dovish
4,16, 기업/NNG;실적/NNG;둔화/NNG;우려/NNG,20,0.36300680188481266,Dovish
21,45, 저하/NNG;우려/NNG,66,0.6776126968516504,Dovish
560,1123, 브렌트유/NNG,1683,0.7240741195209087,Dovish
9,18, 신흥국/NNG;경제/NNG;타격/NNG,27,0.7260136037696254,Dovish
10,20, 약하/VA;경제/NNG;성장/NNG,30,0.7260136037696254,Dovish
14,42, 유로존/NNG;낮/VA,56,0.4840090691797503,Dovish
12,23, 신흥국/NNG;경기/NNG;우려/NNG,35,0.7575794126291744,Dovish
5,18, 드려/VV,23,0.4033408909831252,Dovish
7,21, 예상/NNG;달리/MAG;매파/NNG,28,0.4840090691797503,Dovish
24,64, 시간제근로자/NNG,88,0.5445102028272191,Dovish
91,193, 린/NNG,284,0.6846345900832737,Dovish
7,25, 유가/NNG;전망/NNG;하향/NNG,32,0.40656761811099024,Dovish
33,87,영구채/NNG,120,0.5507689407907502,Dovish
16,50, 지수/NNG;부정적/VAX,66,0.46464870641256023,Dovish
11,34, 긴급생활자금/NNG,45,0.46977350832152226,Dovish
18,43, 금리/NNG;대출/NNG;활성화/NNG,61,0.6078253426908492,Dovish
5,11, 인하/NNG;배제/NNG,16,0.6600123670632958,Dovish
7,18, 우려/NNG;빠지/VV,25,0.5646772473763753,Dovish
9,20, 대량살상무기/NNG,29,0.6534122433926629,Dovish
349,814,디플레이션/NNG,1163,0.622552205689433,Dovish
15,41, 재정/NNG;확대/NNG;금리/NNG;인하/NNG,56,0.5312294661728967,Dovish
25,49, 노동/NNG;비용/NNG;증가/NNG,74,0.7408302079281892,Dovish
4,14, 성장/NNG;전망/NNG;어둡/VA,18,0.41486491643978596,Dovish
30,62, 불안/NNG;가시/VV;않/VX,92,0.7025938100996375,Dovish
308,640, 약관/NNG,948,0.6987880936282644,Dovish
14,31, 부실/NNG;위험/NNG;크/VV,45,0.6557542227596617,Dovish
6,22, 따듯/NNG,28,0.3960074202379775,Dovish
21,44, 라운지/NNG,65,0.6930129854164606,Dovish
14,92, 단종/NNG,106,0.2209606620168425,Dovish
21,43, 떠도/VV,64,0.7091295664726573,Dovish
33,71, 단기투자자/NNG,104,0.6748858851942996,Dovish
22,50, 매장량/NNG,72,0.6388919713172704,Dovish
6,12, 한국판블랙프라이데이/NNG,18,0.7260136037696254,Dovish
40,101, 국채/NNG;가격/NNG;오르/VV,141,0.5750602802135647,Dovish
4,13, 이전/NNG;어렵/VA,17,0.44677760231976943,Dovish
6,20, 유가/NNG;하락/NNG;우려/NNG,26,0.43560816226177523,Dovish
13,27, 투자/NNG;위험/NNG;높/VA,40,0.6991242110374171,Dovish
8,20, 유출/NNG;우려/NNG;줄/VV,28,0.5808108830157003,Dovish
12,27, 대출/NNG;시장/NNG;활성화/NNG,39,0.6453454255730003,Dovish
5,12, 불확실성/NNG;유가/NNG;하락/NNG,17,0.6050113364746877,Dovish
42,187, 브렉시트/NNG;불확실성/NNG,229,0.32612375784304026,Dovish
25,76, 경기/NNG;하방/NNG;압력/NNG,101,0.4776405287958062,Dovish
4,13, 디플레이션/NNG;경계/NNG,17,0.44677760231976943,Dovish
4,19, 취약/NNG;개선/NNG,23,0.30568993842931597,Dovish
3,17, 이전/NNG;매파/NNG,20,0.25624009544810306,Dovish
4,14, 국채/NNG;금리/NNG;역대/NNG;최저/NNG,18,0.41486491643978596,Dovish
26,61, 유가/NNG;최저/NNG,87,0.6188968425577135,Dovish
16,36, 회비/NNG,52,0.6453454255730003,Dovish
22,46, 금리/NNG;인상/NNG;하락/NNG,68,0.6944477949100765,Dovish
2,18, 유로존/NNG;긍정적/VAX,20,0.16133635639325009,Dovish
12,31, 수출/NNG;성장/NNG;둔화/NNG,43,0.5620750480797101,Dovish
20,48, 모자/NNG,68,0.6050113364746877,Dovish
18,40, 가격/NNG;경쟁력/NNG;높/VV,58,0.6534122433926629,Dovish
8,26, 산업/NNG;넘/VV,34,0.44677760231976943,Dovish
50,140, 원했/VV,190,0.5185811455497324,Dovish
14,33, 물가/NNG;전망/NNG;낮/VV,47,0.6160115425924094,Dovish
9,24, 경제/NNG;금융시장/NNG;불안/NNG,33,0.5445102028272191,Dovish
3,13, 글로벌/NNG;경기/NNG;둔화/NNG;우려/NNG;확산/NNG,16,0.33508320173982714,Dovish
3,18, 유로존/NNG;금리/NNG;하락/NNG,21,0.24200453458987514,Dovish
5,15, 감세/NNG;재정/NNG;확대/NNG,20,0.48400906917975023,Dovish
8,26, 스텐/NNG,34,0.44677760231976943,Dovish
9,43, 유한책임/NNG,52,0.3039126713454246,Dovish
1388,2977, els/NNG,4365,0.6769948821177293,Dovish
33,100, 녹인/NNG,133,0.47916897848795276,Dovish
11,27, 통화정책/NNG;양적완화/NNG,38,0.5915666401085836,Dovish
42,84,충분/NNG,126,0.7260136037696254,Dovish
6,17, 공개경쟁입찰/NNG,23,0.5124801908962061,Dovish
15,29, 공개입찰/NNG,44,0.7510485556237504,Dovish
49,104, 경제난/NNG,153,0.6841282035521471,Dovish
9,20, 왕실/NNG,29,0.6534122433926629,Dovish
19,58, 원유/NNG;감산/NNG,77,0.4756640852283753,Dovish
8,19, 통화/NNG;강하/VA,27,0.6113798768586319,Dovish
4,14, 주택/NNG;구매/NNG;제한/NNG,18,0.41486491643978596,Dovish
15,35, 의문점/NNG,50,0.6222973746596789,Dovish
12,25, 은밀/NNG,37,0.6969730596188405,Dovish
83,184, 필요지준/NNG,267,0.6549905338356403,Dovish
29,85, 금리/NNG;마이너스/NNG;낮/VV,114,0.4953975178663326,Dovish
16,33, 신용/NNG;확장/NNG,49,0.7040131915341822,Dovish
9,39, 금리/NNG;인하/NNG;가능성/NNG;작/VA,48,0.33508320173982714,Dovish
10,21, 환경/NNG;긴축/NNG,31,0.6914415273996433,Dovish
50,138,코코본드/NNG,188,0.5260968143258156,Dovish
15,33, 은행/NNG;도산/NNG,48,0.6600123670632958,Dovish
23,49, 장거리미사일발사/NNG,72,0.681563791293934,Dovish
7,24, 집행액/NNG,31,0.42350793553228144,Dovish
145,361, 전통시장/NNG,506,0.5832242246348791,Dovish
12,23, 민간/NNG;투자/NNG;확대/NNG,35,0.7575794126291744,Dovish
17,51, 낙관/NNG;않/VX,68,0.4840090691797503,Dovish
15,29, 다가와/VV,44,0.7510485556237504,Dovish
8,20, 국제/NNG;유가/NNG;감산/NNG,28,0.5808108830157003,Dovish
10,40, 감사위원회/NNG,50,0.3630068018848127,Dovish
6,17, 지분비율/NNG,23,0.5124801908962061,Dovish
21,48, 미사일방어/NNG,69,0.6352619032984221,Dovish
10,23, 유린/NNG,33,0.6313161771909785,Dovish
8,19, 보낸다면/VV,27,0.6113798768586319,Dovish
5,11, 은행/NNG;수익성/NNG;악화/NNG;우려/NNG,16,0.6600123670632958,Dovish
78,162, 주선/NNG,240,0.6991242110374171,Dovish
5,11, 대외/NNG;여건/NNG;불확실성/NNG;높/VA,16,0.6600123670632958,Dovish
6,20, 편향성/NNG,26,0.43560816226177523,Dovish
153,350, 고배/NNG,503,0.6347433221528724,Dovish
20,50, 경제/NNG;악영향/NNG;줄/VV,70,0.5808108830157004,Dovish
5,18, 브라스/NNG,23,0.4033408909831252,Dovish
11,32, 사회개발/NNG,43,0.4991343525916174,Dovish
21,45, 금융감독체계/NNG,66,0.6776126968516504,Dovish
11,35, 우선변제/NNG,46,0.4563514080837645,Dovish
15,35, 감독규제/NNG,50,0.6222973746596789,Dovish
4,14, 은행/NNG;경기/NNG;침체/NNG,18,0.41486491643978596,Dovish
4,13, 수익성/NNG;좋/VA;않/VX,17,0.44677760231976943,Dovish
5,18, 수익/NNG;약화/NNG,23,0.4033408909831252,Dovish
25,55, 환영사/NNG,80,0.6600123670632958,Dovish
4,17, 유가/NNG;상승/NNG;힘입/VV;상승/NNG,21,0.3416534605974707,Dovish
19,38, 충동/NNG,57,0.7260136037696254,Dovish
17,52, 안전자산/NNG;매수/NNG;약화/NNG,69,0.4747012024647551,Dovish
31,68, 종과/NNG,99,0.6619535799075996,Dovish
39,89, 법사/NNG,128,0.6362815853261885,Dovish
26,56, 법제처/NNG,82,0.6741554892146522,Dovish
25,48, 샌드위치/NNG,73,0.7562641705933597,Dovish
4,18, 가처분/NNG;소득/NNG;증대/NNG,22,0.32267271278650017,Dovish
6,13, 전망/NNG;불확실성/NNG;크/VV,19,0.6701664034796543,Dovish
10,21, 금리/NNG;넘/VV;오르/VV,31,0.6914415273996433,Dovish
3,13, 정책/NNG;제한/NNG,16,0.33508320173982714,Dovish
33,73, 북해산/NNG,106,0.656395860942401,Dovish
25,86, 소비자/NNG;물가/NNG;부진/NNG,111,0.4221009324242008,Dovish
6,22, 기대/NNG;유가/NNG;상승/NNG,28,0.3960074202379775,Dovish
6,13, 경착륙/NNG;우려/NNG;크/VV,19,0.6701664034796543,Dovish
66,141, 기대/NNG;급등/NNG,207,0.6796723099119897,Dovish
17,34, 예상/NNG;충족/NNG,51,0.7260136037696254,Dovish
4,15,소강상태/NNG,19,0.3872072553438002,Dovish
12,29, 돔/NNG,41,0.6008388444990004,Dovish
113,218, 부동산/NNG;가격/NNG;급등/NNG,331,0.7526563048253915,Dovish
22,43, 비주류/NNG,65,0.7428976410665934,Dovish
60,127, 부동산투자신탁/NNG,187,0.6859971059240555,Dovish
7,15, 전망/NNG;제한적/VAX,22,0.6776126968516504,Dovish
36,70, 법제/NNG,106,0.7467568495916148,Dovish
14,34, 설비/NNG;가동률/NNG;하락/NNG,48,0.5978935560455738,Dovish
6,16, 유가/NNG;상승/NNG;강세/NNG,22,0.5445102028272191,Dovish
6,12, 고용/NNG;축소/NNG,18,0.7260136037696254,Dovish
252,539,물가채/NNG,791,0.6788698632651043,Dovish
23,44, 곱해/VV,67,0.7590142221227901,Dovish
2,17, 디플레이션/NNG;우려/NNG;과도/NNG,19,0.17082673029873535,Dovish
9,22, 내수/NNG;위축/NNG;우려/NNG,31,0.5940111303569663,Dovish
5,12, 원자재/NNG;가격/NNG;낮/VA,17,0.6050113364746877,Dovish
6,13, 그리/MAG;낙관/NNG;않/VX,19,0.6701664034796543,Dovish
21,51, 원자재/NNG;가격/NNG;강세/NNG,72,0.5978935560455738,Dovish
6,12, 경제/NNG;환경/NNG;개선/NNG,18,0.7260136037696254,Dovish
44,104,양적/VAX,148,0.614319203189683,Dovish
18,35, 순대/NNG,53,0.7467568495916148,Dovish
4,19, 스파이크/NNG,23,0.30568993842931597,Dovish
5,12, 균형가격/NNG,17,0.6050113364746877,Dovish
11,46, 대출/NNG;촉진/NNG,57,0.34722389745503823,Dovish
6,31, 금융업자/NNG,37,0.28103752403985505,Dovish
159,309, 특위/NNG,468,0.7471596310638863,Dovish
4,13, 앞선다는/VV,17,0.44677760231976943,Dovish
11,23, 자본/NNG;유출/NNG;통제/NNG,34,0.6944477949100765,Dovish
27,59, 비상장주식/NNG,86,0.6644870271789792,Dovish
88,193, 신분/NNG,281,0.6620642189816273,Dovish
31,69, 순수익/NNG,100,0.6523600497640113,Dovish
115,278,사례/NNG,393,0.6006587369317045,Dovish
4,22, 부작용/NNG;경계/NNG,26,0.26400494682531833,Dovish
7,24, 아보/NNG,31,0.42350793553228144,Dovish
8,17, 소비자/NNG;지출/NNG;늘/VV,25,0.6833069211949414,Dovish
6,22, 예상/NNG;강하/VA;않/VX,28,0.3960074202379775,Dovish
25,64, 브루킹스연구소/NNG,89,0.5671981279450199,Dovish
89,177, 블로그/NNG,266,0.7301153755423351,Dovish
9,26, 테러리즘/NNG,35,0.5026248026097407,Dovish
189,381,마이너스/NNG,570,0.7202969612202582,Dovish
93,219, 입국/NNG,312,0.6166142936125585,Dovish
113,247, 예술/NNG,360,0.664287750817552,Dovish
23,53, 기술원/NNG,76,0.630125014592505,Dovish
10,20, 총저축률/NNG,30,0.7260136037696254,Dovish
12,33, 뛰어나/VV,45,0.5280098936506367,Dovish
259,599, 튼/VV,858,0.6278381414902604,Dovish
19,41, 대출포트폴리오/NNG,60,0.6728906571523358,Dovish
9,22, 국제/NNG;신용등급/NNG;강등/NNG,31,0.5940111303569663,Dovish
16,38, 주택담보대출/NNG;최저/NNG,54,0.6113798768586319,Dovish
17,39, 활성화/NNG;효과/NNG,56,0.6329349366196735,Dovish
12,33, 정책/NNG;부정적/VAX,45,0.5280098936506367,Dovish
4,14, 가격/NNG;견조/NNG,18,0.41486491643978596,Dovish
8,16, 길/VA;위험/NNG,24,0.7260136037696253,Dovish
180,487,비둘기/NNG,667,0.5366835674683063,Dovish
35,75, fed/NNG;물가/NNG;상승/NNG,110,0.6776126968516504,Dovish
5,12, 인플레이션/NNG;크/VV,17,0.6050113364746877,Dovish
26,51, 수익성/NNG;강화/NNG,77,0.7402491646278533,Dovish
49,131, 수요/NNG;확보/NNG,180,0.5431246806826205,Dovish
3,14, 마진/NNG;강세/NNG,17,0.3111486873298395,Dovish
100,222, 전문위원/NNG,322,0.6540663097023652,Dovish
25,66, 물가/NNG;내리/VV,91,0.5500103058860799,Dovish
24,52, 춘계/NNG,76,0.6701664034796543,Dovish
4,18, 입찰서/NNG,22,0.32267271278650017,Dovish
8,24, 소비/NNG;우려/NNG,32,0.4840090691797502,Dovish
17,44,성향/NNG,61,0.5610105120038015,Dovish
32,84, 뉴욕이코노믹클럽/NNG,116,0.5531532219197145,Dovish
5,14, 통화정책/NNG;물가/NNG;상승/NNG,19,0.5185811455497324,Dovish
13,45, 경제/NNG;전망/NNG;위험/NNG,58,0.41947452662245027,Dovish
8,21, 가격/NNG;비둘기/NNG,29,0.5531532219197145,Dovish
171,337,강하/VA,508,0.7367853189590858,Dovish
31,62, 자력/NNG,93,0.7260136037696255,Dovish
14,30, fed/NNG;금리/NNG;인상/NNG;우려/NNG;완화/NNG,44,0.6776126968516504,Dovish
5,13, 물가/NNG;상승/NNG;약화/NNG,18,0.5584720028997119,Dovish
22,51, 사려/VV,73,0.6263646777620296,Dovish
3,31, 세계/NNG;경제/NNG;금융시장/NNG;불확실성/NNG,34,0.14051876201992752,Dovish
8,23, 기대/NNG;비둘기/NNG,31,0.5050529417527828,Dovish
48,126, 누리/NNG,174,0.5531532219197146,Dovish
5,13, 화원/NNG,18,0.5584720028997119,Dovish
8,23, 제조업/NNG;확장/NNG,31,0.5050529417527828,Dovish
6,12, 제약요건/NNG,18,0.7260136037696254,Dovish
24,79, 바르/NNG,103,0.44112218963217753,Dovish
51,104,과감/NNG,155,0.7120518036971326,Dovish
5,12, 노동유연성/NNG,17,0.6050113364746877,Dovish
69,144, 재배/NNG,213,0.695763036945891,Dovish
34,87, 페그/NNG,121,0.5674589086935004,Dovish
7,17, 매개체/NNG,24,0.5978935560455738,Dovish
189,368, 불완전판매/NNG,557,0.7457422343068435,Dovish
22,43, 치킨/NNG,65,0.7428976410665934,Dovish
6,12, 호구/NNG,18,0.7260136037696254,Dovish
14,30, 주춤거렸/VV,44,0.6776126968516504,Dovish
53,113, 경수/NNG,166,0.6810393097307991,Dovish
8,16, 정치/NNG;불확실성/NNG;안전자산/NNG;선호/NNG,24,0.7260136037696253,Dovish
5,16, 제조업/NNG;경기/NNG;악화/NNG,21,0.4537585023560159,Dovish
5,13, 소비/NNG;여력/NNG;확충/NNG,18,0.5584720028997119,Dovish
6,13, 가계/NNG;대출/NNG;성장/NNG,19,0.6701664034796543,Dovish
6,19, 수요자/NNG;관심/NNG;높/VA,25,0.458534907643974,Dovish
7,15, 내재/NNG;위험/NNG,22,0.6776126968516504,Dovish
7,15, 정치/NNG;반대/NNG,22,0.6776126968516504,Dovish
11,23, 심각/NNG;둔화/NNG,34,0.6944477949100765,Dovish
75,149, 상환계획/NNG,224,0.7308861782915692,Dovish
13,25, 실업률/NNG;소폭/MAG;상승/NNG,38,0.7550541479204105,Dovish
5,11, 국채/NNG;수요/NNG;높/VA,16,0.6600123670632958,Dovish
41,88, 전폭/NNG,129,0.6765126762398782,Dovish
11,31, 금리/NNG;인하/NNG;배제/NNG,42,0.5152354607397341,Dovish
11,39, 지배주주/NNG,50,0.4095461354597887,Dovish
11,41, 국고채/NNG;금리/NNG;밑돌/VV,52,0.38956827519345755,Dovish
33,103, 아우성/NNG,136,0.4652126004737405,Dovish
43,84, 금리/NNG;서서히/MAG;오르/VV,127,0.7432996419546165,Dovish
5,18, 부진/NNG;탈출/NNG,23,0.4033408909831252,Dovish
7,14, 요새/MAG,21,0.7260136037696254,Dovish
25,55, 사용처/NNG,80,0.6600123670632958,Dovish
8,22, 노령연금/NNG,30,0.5280098936506367,Dovish
40,104, 사내유보금/NNG,144,0.5584720028997119,Dovish
5,15, 가계/NNG;부채/NNG;위험/NNG;줄/VV,20,0.48400906917975023,Dovish
5,15, 강하/VA;fed/NNG;금리/NNG;인상/NNG,20,0.48400906917975023,Dovish
7,15, 유가/NNG;전망/NNG;상향/NNG,22,0.6776126968516504,Dovish
15,31, 해질/XSV,46,0.7025938100996375,Dovish
8,19, 구조개혁/NNG;성공/NNG,27,0.6113798768586319,Dovish
10,32,대통령탄핵안/NNG,42,0.4537585023560159,Dovish
271,625,총선/NNG,896,0.6295989971890191,Dovish
16,34, 유지율/NNG,50,0.6833069211949414,Dovish
3,13, 기대/NNG;그치/VV,16,0.33508320173982714,Dovish
189,417,재정정책/NNG,606,0.6581130508990849,Dovish
302,711,구조조정/NNG,1013,0.6167541725412852,Dovish
230,448, 레포/NNG,678,0.7454603967277403,Dovish
1,16, 불신임안/NNG,17,0.09075170047120316,Dovish
10,61, 야정/NNG,71,0.2380372471375821,Dovish
4,13, 신용경색/NNG;금융시장/NNG;불안/NNG,17,0.44677760231976943,Dovish
14,32, 속도전/NNG,46,0.6352619032984222,Dovish
15,32,야심/NNG,47,0.6806377535340238,Dovish
7,16, 채권/NNG;공급/NNG;늘/VV,23,0.6352619032984222,Dovish
5,12, 구조조정/NNG;늦/VA,17,0.6050113364746877,Dovish
21,46, 부실/NNG;막/VV,67,0.6628819860505275,Dovish
118,252, 측근/NNG,370,0.6799175019429825,Dovish
19,52, 서비스업/NNG;활성화/NNG,71,0.5305484027547263,Dovish
4,18, 통화/NNG;회복/NNG,22,0.32267271278650017,Dovish
97,223, 사후관리/NNG,320,0.631599278615728,Dovish
10,25, 둘러싸인/VV,35,0.5808108830157004,Dovish
7,21, 나르/VV,28,0.4840090691797503,Dovish
7,30, 들어와야/VV,37,0.3388063484258252,Dovish
12,23, 집행간부/NNG,35,0.7575794126291744,Dovish
71,141, 아낄/VV,212,0.7311626364204739,Dovish
23,46, 산업/NNG;활성화/NNG,69,0.7260136037696253,Dovish
49,120, fed/NNG;금리/NNG;인상/NNG;경계/NNG,169,0.5929111097451941,Dovish
11,35, 글로벌/NNG;채권/NNG;약세/NNG,46,0.4563514080837645,Dovish
115,333,만장일치/NNG,448,0.50145083743848,Dovish
24,67, 만약/NNG;fed/NNG;금리/NNG;인상/NNG,91,0.5201291489692839,Dovish
4,13, 달러원/NNG;상승/NNG;하락/NNG,17,0.44677760231976943,Dovish
5,11, 기업/NNG;부채/NNG;우려/NNG,16,0.6600123670632958,Dovish
7,15, 대출태도/NNG;지수/NNG;마이너스/NNG,22,0.6776126968516504,Dovish
5,16, 매입/NNG;금리/NNG;인하/NNG,21,0.4537585023560159,Dovish
6,17, 탈로/NNG,23,0.5124801908962061,Dovish
8,19, 금리/NNG;인하/NNG;기대/NNG;하락/NNG,27,0.6113798768586319,Dovish
5,13, 은행/NNG;부실/NNG;위험/NNG,18,0.5584720028997119,Dovish
5,16, 가격/NNG;상승/NNG;물가/NNG;상승/NNG,21,0.4537585023560159,Dovish
6,15, 소폭/MAG;성장/NNG,21,0.5808108830157004,Dovish
8,32,정책공/NNG,40,0.36300680188481266,Dovish
25,58, 경제/NNG;성장률/NNG;낮/VV,83,0.6258737963531253,Dovish
5,15, 전망/NNG;취약/NNG,20,0.48400906917975023,Dovish
10,26, 원화채권/NNG;금리/NNG;상승/NNG,36,0.5584720028997119,Dovish
103,203, ff/NNG;금리선물/NNG;금리/NNG;인상/NNG,306,0.7367428688499648,Dovish
26,64, 채광/NNG,90,0.5898860530628207,Dovish
9,19, 용접/NNG,28,0.687802361465961,Dovish
72,149, 성장산업/NNG,221,0.7016507311599065,Dovish
5,12, 안화/NNG,17,0.6050113364746877,Dovish
10,21, 유로화자산/NNG,31,0.6914415273996433,Dovish
24,49, 취업률/NNG,73,0.7111969996110616,Dovish
10,27, 각자도생/NNG,37,0.5377878546441669,Dovish
6,35, 반이민정책/NNG,41,0.24891894986387159,Dovish
21,41, 가람/NNG,62,0.7437212526420554,Dovish
23,53, fed/NNG;경기/NNG;침체/NNG,76,0.630125014592505,Dovish
12,24, 산업/NNG;경쟁력/NNG;약화/NNG,36,0.7260136037696254,Dovish
10,27, 소득/NNG;제한/NNG,37,0.5377878546441669,Dovish
6,15, 신규/NNG;주택가격/NNG;하락/NNG,21,0.5808108830157004,Dovish
5,25, 부채/NNG;심각/NNG,30,0.2904054415078502,Dovish
13,36, 예상/NNG;견조/NNG,49,0.5243431582780628,Dovish
5,12, 현금출자/NNG,17,0.6050113364746877,Dovish
40,105, 골든타임/NNG,145,0.5531532219197146,Dovish
5,12, 폐광/NNG,17,0.6050113364746877,Dovish
3,17, 금리/NNG;인하/NNG;한계/NNG,20,0.25624009544810306,Dovish
14,30, 유종/NNG,44,0.6776126968516504,Dovish
17,43, 법리/NNG,60,0.5740572680969132,Dovish
10,24, 용이성/NNG,34,0.6050113364746877,Dovish
8,17, 경기/NNG;침체/NNG;방어/NNG,25,0.6833069211949414,Dovish
4,20, 스태프/NNG,24,0.29040544150785014,Dovish
18,37, 노동시장/NNG;호조/NNG,55,0.7063916144785545,Dovish
8,22, fed/NNG;금리/NNG;인상/NNG;경계/NNG;크/VV,30,0.5280098936506367,Dovish
31,63, 텃밭/NNG,94,0.7144895783129647,Dovish
30,75, 수확량/NNG,105,0.5808108830157003,Dovish
32,62, 은닉/NNG,94,0.7494333974396133,Dovish
16,32, 낮/VA;반대/NNG,48,0.7260136037696253,Dovish
9,24, 청산절차/NNG,33,0.5445102028272191,Dovish
261,608,미국발/NNG,869,0.6233208900785271,Dovish
54,140, 시신/NNG,194,0.560067637193711,Dovish
19,38, 호화/NNG,57,0.7260136037696254,Dovish
5,27, 사만/NNG,32,0.26889392732208345,Dovish
5,20, 차주/NNG;신용위험/NNG,25,0.3630068018848127,Dovish
18,53, 부실/NNG;크/VV,71,0.4931413157680475,Dovish
342,2191,브렉시트/NNG,2533,0.22665143997189585,Dovish
9,18, 자금/NNG;금리/NNG;인상/NNG,27,0.7260136037696254,Dovish
9,19,연장선/NNG,28,0.687802361465961,Dovish
11,26, 신용경로/NNG,37,0.614319203189683,Dovish
7,28, 수익성/NNG;타격/NNG,35,0.3630068018848127,Dovish
6,15, 도산/NNG;방지/NNG,21,0.5808108830157004,Dovish
18,56, 따져야/VV,74,0.46672303099475926,Dovish
5,14, 해외/NNG;투자/NNG;비중/NNG;늘/VV,19,0.5185811455497324,Dovish
5,11, 그럼에도/VA;금리/NNG;인하/NNG,16,0.6600123670632958,Dovish
15,32, 제조업/NNG;줄/VV,47,0.6806377535340238,Dovish
7,20, 금리/NNG;인상/NNG;시장/NNG;우려/NNG,27,0.5082095226387378,Dovish
9,22, 위험/NNG;크/VV;우려/NNG,31,0.5940111303569663,Dovish
2,18, 비농업/NNG;신규/NNG;고용자수/NNG;증가/NNG,20,0.16133635639325009,Dovish
5,15, 부정적/VAX;영향/NNG;확대/NNG,20,0.48400906917975023,Dovish
7,20, 매파/NNG;긴축/NNG,27,0.5082095226387378,Dovish
7,14, 임금/NNG;높/VV,21,0.7260136037696254,Dovish
5,17, 농수산업/NNG,22,0.42706682574683846,Dovish
5,15, 금리/NNG;선제/NNG;인하/NNG,20,0.48400906917975023,Dovish
9,24, 소비/NNG;내수/NNG;개선/NNG,33,0.5445102028272191,Dovish
10,30, 예상/NNG;깨/VV;금리/NNG;인하/NNG,40,0.48400906917975023,Dovish
29,69, 경기/NNG;살/VV;않/VX,98,0.6102723046179459,Dovish
8,21, 신흥국/NNG;통화/NNG;안정/NNG,29,0.5531532219197145,Dovish
4,14, 수입/NNG;물가/NNG;높/VA,18,0.41486491643978596,Dovish
14,27, 쇼트/NNG,41,0.7529029965018337,Dovish
10,25, 부동층/NNG,35,0.5808108830157004,Dovish
8,16, 이주자/NNG,24,0.7260136037696253,Dovish
11,24, 자체사업/NNG,35,0.6655124701221565,Dovish
318,610,점/NNG,928,0.7569584458975109,Dovish
5,19, 경기/NNG;영향/NNG;줄/VV,24,0.38211242303664494,Dovish
15,32, 국론/NNG,47,0.6806377535340238,Dovish
5,13, 영연방/NNG,18,0.5584720028997119,Dovish
13,29, 상업화/NNG,42,0.6509087482072504,Dovish
4,17, 북해유전/NNG,21,0.3416534605974707,Dovish
3,14, 없앤다고/VV,17,0.3111486873298395,Dovish
632,1231,선물/NNG,1863,0.7454761942849768,Dovish
19,91, 피살/NNG,110,0.3031705158598436,Dovish
4,22, 충분/NNG;경제/NNG;성장/NNG,26,0.26400494682531833,Dovish
18,48, 움츠러든/VV,66,0.5445102028272191,Dovish
4,24, 브렉시트/NNG;안전자산/NNG;선호/NNG,28,0.2420045345898751,Dovish
406,838,우려/NNG,1244,0.7034881220297563,Dovish
23,48, 국고채/NNG;금리/NNG;높/VA,71,0.6957630369458909,Dovish
31,81, 금융중심지/NNG,112,0.5557141164656392,Dovish
4,25, 금융시장/NNG;점차/MAG;안정/NNG,29,0.23232435320628012,Dovish
121,337, 추경안/NNG,458,0.5213510151698794,Dovish
18,45, 경제현안점검회의/NNG,63,0.5808108830157004,Dovish
7,15, 경제/NNG;악영향/NNG;우려/NNG,22,0.6776126968516504,Dovish
5,13, 수출/NNG;예상/NNG;부진/NNG,18,0.5584720028997119,Dovish
20,48, 금리/NNG;전망/NNG;하향/NNG,68,0.6050113364746877,Dovish
8,16, 변동성/NNG;확대/NNG;위험/NNG,24,0.7260136037696253,Dovish
13,60, 브렉시트/NNG;금리/NNG;인상/NNG,73,0.31460589496683766,Dovish
59,125, 내려진/VV,184,0.6853568419585263,Dovish
444,982,각국/NNG,1426,0.6565173932254861,Dovish
110,215, 부추겨/VV,325,0.7428976410665935,Dovish
34,97, 계획서/NNG,131,0.50895799027149,Dovish
6,22, 종료/NNG;늦/VV,28,0.3960074202379775,Dovish
8,17, fed/NNG;경기/NNG;개선/NNG,25,0.6833069211949414,Dovish
2,27, 부동산펀드/NNG;환매/NNG;중단/NNG,29,0.10755757092883338,Dovish
42,109, 금리/NNG;마이너스/NNG;내리/VV,151,0.5594967221710875,Dovish
15,29, 글로벌/NNG;금리/NNG;오르/VV,44,0.7510485556237504,Dovish
12,23, 매출처/NNG,35,0.7575794126291744,Dovish
30,78, 프라이머리/NNG,108,0.5584720028997118,Dovish
69,137, 대출/NNG;어렵/VA,206,0.7313129731402067,Dovish
88,223,소수의견/NNG,311,0.5729972836926192,Dovish
7,20, 수출/NNG;회복/NNG;지연/NNG,27,0.5082095226387378,Dovish
20,52, 기근/NNG,72,0.5584720028997119,Dovish
205,440, 푸/VV,645,0.6765126762398782,Dovish
29,57, 부딪힐/VV,86,0.7387506845375135,Dovish
24,47, 바닥나/VV,71,0.7414607017221707,Dovish
15,36, 대학살/NNG,51,0.6050113364746877,Dovish
11,33, 불리우/VV,44,0.48400906917975023,Dovish
17,52, 금리/NNG;ff/NNG;금리/NNG;인상/NNG,69,0.4747012024647551,Dovish
7,17, 재정지출계획/NNG,24,0.5978935560455738,Dovish
4,12, 나올수록/VV,16,0.4840090691797502,Dovish
28,61, 경제/NNG;견고/NNG,89,0.6665042919852299,Dovish
18,43,호전/NNG,61,0.6078253426908492,Dovish
5,11, 고용시장/NNG;강화/NNG,16,0.6600123670632958,Dovish
6,16, 전망/NNG;반대/NNG,22,0.5445102028272191,Dovish
41,100, 변동성지수/NNG;상승/NNG,141,0.5953311550910929,Dovish
4,13, 소비/NNG;충격/NNG,17,0.44677760231976943,Dovish
8,23, 낮/VA;금리/NNG;낮/VA,31,0.5050529417527828,Dovish
8,29, 금리/NNG;이미/MAG;낮/VA,37,0.4005592296660002,Dovish
92,183, 다다랐/VV,275,0.7299808912219184,Dovish
10,21, 본원/NNG;통화/NNG;확대/NNG,31,0.6914415273996433,Dovish
11,24, 경기/NNG;펀더멘털/NNG;개선/NNG,35,0.6655124701221565,Dovish
18,35, 퉁/NNG,53,0.7467568495916148,Dovish
7,14, 부동산/NNG;경기/NNG;호황/NNG,21,0.7260136037696254,Dovish
29,71, 소셜/NNG,100,0.5930815354737784,Dovish
5,12, 제네릭/NNG,17,0.6050113364746877,Dovish
23,53, 테두리/NNG,76,0.630125014592505,Dovish
12,34, 빈번히/MAG,46,0.5124801908962061,Dovish
66,127, 현기/NNG,193,0.754596816516461,Dovish
40,84, 살포/NNG,124,0.6914415273996433,Dovish
10,24, 합법화/NNG,34,0.6050113364746877,Dovish
35,76, 집행유예/NNG,111,0.6686967403141287,Dovish
13,39, 근린/NNG,52,0.4840090691797503,Dovish
21,43, fed/NNG;금리/NNG;인상/NNG;어렵/VA,64,0.7091295664726573,Dovish
5,11, 생산성/NNG;증가율/NNG;둔화/NNG,16,0.6600123670632958,Dovish
22,77, 단기/NNG;경기/NNG;부양/NNG,99,0.4148649164397859,Dovish
3,25, 은행/NNG;수익/NNG;악화/NNG,28,0.17424326490471012,Dovish
14,29, 이전/NNG;금리/NNG;오르/VV,43,0.7009786519155004,Dovish
5,13, 악화/NNG;부작용/NNG,18,0.5584720028997119,Dovish
18,36, 유가/NNG;지지/NNG,54,0.7260136037696254,Dovish
1286,2785,스왑/NNG,4071,0.6704872491545696,Dovish
31,74, 낙인/NNG,105,0.6082816680231996,Dovish
13,34, 물가/NNG;하락/NNG;우려/NNG,47,0.55518687347089,Dovish
4,14, 원화/NNG;강세/NNG;부정적/VAX,18,0.41486491643978596,Dovish
79,153, 싱크탱크/NNG,232,0.7497395385333386,Dovish
19,39, 수출/NNG;어렵/VA,58,0.707397870339635,Dovish
13,26, 원유/NNG;공급/NNG;감소/NNG,39,0.7260136037696254,Dovish
57,127, 나쁘/VA;지지/NNG;않/VX,184,0.6516972506278528,Dovish
15,33, 은행/NNG;대출/NNG;금리/NNG;인하/NNG,48,0.6600123670632958,Dovish
77,192, 은행/NNG;금리/NNG;인하/NNG,269,0.582323411356887,Dovish
5,13, 기업/NNG;금리/NNG;인하/NNG,18,0.5584720028997119,Dovish
8,22, 한심/NNG,30,0.5280098936506367,Dovish
6,13, 수심/NNG,19,0.6701664034796543,Dovish
138,290, 신용등급/NNG;오르/VV,428,0.6909646711738504,Dovish
40,82, 고용시장/NNG;성장/NNG,122,0.7083059548971955,Dovish
5,15, 합치/NNG,20,0.48400906917975023,Dovish
27,56, 금과은/NNG,83,0.7000845464921388,Dovish
39,86, 가격/NNG;부정적/VAX,125,0.6584774545817532,Dovish
8,32, 벌기/NNG,40,0.36300680188481266,Dovish
3,13, 생길까/VV,16,0.33508320173982714,Dovish
14,29, 자금/NNG;유입/NNG;가속/NNG,43,0.7009786519155004,Dovish
14,35, 고용시장/NNG;견고/NNG,49,0.5808108830157003,Dovish
11,23, 역인/NNG,34,0.6944477949100765,Dovish
5,12, 구조조정/NNG;확대/NNG,17,0.6050113364746877,Dovish
6,20, 정족수/NNG,26,0.43560816226177523,Dovish
4,12, 불안정성/NNG;해소/NNG,16,0.4840090691797502,Dovish
31,65, 고용/NNG;증가/NNG;상향/NNG,96,0.6925052835956428,Dovish
3,15, 인하/NNG;기대/NNG;줄/VV,18,0.2904054415078502,Dovish
818,1609,비농업/NNG,2427,0.7381965542368596,Dovish
23,45, 전기요금/NNG;인하/NNG,68,0.7421472394089503,Dovish
11,22, 원시/NNG,33,0.7260136037696254,Dovish
8,24, 정대/NNG,32,0.4840090691797502,Dovish
3,15, 신용등급/NNG;위험/NNG,18,0.2904054415078502,Dovish
5,15, 구조조정/NNG;실패/NNG,20,0.48400906917975023,Dovish
5,12, fed/NNG;금리/NNG;인상/NNG;충격/NNG,17,0.6050113364746877,Dovish
3,16, 시운전/NNG,19,0.27225510141360953,Dovish
5566,10932,ecb/NNG,16498,0.7392959602235154,Dovish
20,66, 덜/MAG;비둘기/NNG,86,0.44000824470886385,Dovish
129,259, 금품/NNG,388,0.7232104624423296,Dovish
10,21, 이원/NNG,31,0.6914415273996433,Dovish
9,21, 권총/NNG,30,0.6222973746596789,Dovish
7,17, 합자/NNG,24,0.5978935560455738,Dovish
8,28, 사회보장기금/NNG,36,0.41486491643978596,Dovish
15,39, 성장기업/NNG,54,0.5584720028997118,Dovish
3,13, 기업/NNG;부채/NNG;급증/NNG,16,0.33508320173982714,Dovish
167,327, 장기쪽/NNG,494,0.741555179385489,Dovish
5,21, 자산/NNG;매입/NNG;양적완화/NNG,26,0.34572076369982163,Dovish
7,23, 예상/NNG;덜/MAG;매파/NNG,30,0.441921324033685,Dovish
16,42, fed/NNG;느리/VA;금리/NNG;인상/NNG,58,0.5531532219197145,Dovish
99,205, 발작/NNG,304,0.7012228953482236,Dovish
6,17, 경제/NNG;전망/NNG;단기/NNG;위험/NNG,23,0.5124801908962061,Dovish
8,22, 변동성/NNG;크/VV;않/VX,30,0.5280098936506367,Dovish
4,13, 숙려/NNG,17,0.44677760231976943,Dovish
40,92, 펀드런/NNG,132,0.6313161771909785,Dovish
15,33, 기업/NNG;금리/NNG;인상/NNG,48,0.6600123670632958,Dovish
7,21, 디스인플레이션/NNG;압력/NNG,28,0.4840090691797503,Dovish
5,21, 민낯/NNG,26,0.34572076369982163,Dovish
57,109, 사그라지/VV,166,0.759316980089333,Dovish
9,18, 내버려둘/VV,27,0.7260136037696254,Dovish
6,15, 깊어진다/VV,21,0.5808108830157004,Dovish
248,642,테이퍼링/NNG,890,0.5609077063391499,Dovish
12,30, 가계/NNG;대출/NNG;부담/NNG,42,0.5808108830157004,Dovish
12,23, 변동성/NNG;불확실성/NNG,35,0.7575794126291744,Dovish
3,23, 테이퍼링/NNG;축소/NNG,26,0.1893948531572936,Dovish
13,28, 가격/NNG;떨어/VV;않/VX,41,0.6741554892146522,Dovish
13,48, 원사/NNG,61,0.39325736870854705,Dovish
6,12, 국제/NNG;유가/NNG;상승/NNG;위험자산/NNG;선호/NNG,18,0.7260136037696254,Dovish
41,136, 생산/NNG;중단/NNG,177,0.4377434963905094,Dovish
13,36,연기/NNG,49,0.5243431582780628,Dovish
80,163,유지/NNG,243,0.7126513902033133,Dovish
23,59, 무역/NNG;흑자/NNG;확대/NNG,82,0.5660445046339452,Dovish
6,23, 신용/NNG;성장/NNG,29,0.3787897063145872,Dovish
25,58, 아리랑본드/NNG,83,0.6258737963531253,Dovish
7,15, 거래둔화/NNG,22,0.6776126968516504,Dovish
49,106, 비영리단체/NNG,155,0.6712201242398425,Dovish
32,70, 적립액/NNG,102,0.6637838663036575,Dovish
9,20, 금융시장/NNG;불안/NNG;높/VA,29,0.6534122433926629,Dovish
21,59, 예상/NNG;소폭/MAG;밑돌/VV,80,0.5168232433614283,Dovish
25,52, 급락/NNG;면하/VV;못하/VX,77,0.6980900036246398,Dovish
6,14, 중간층/NNG,20,0.622297374659679,Dovish
88,172, 빈곤층/NNG,260,0.7428976410665934,Dovish
35,121, 현역/NNG,156,0.4200078699493701,Dovish
6,13, 짝수/NNG,19,0.6701664034796543,Dovish
9,19, 예결/NNG,28,0.687802361465961,Dovish
12,38, 입법부/NNG,50,0.458534907643974,Dovish
12,37, 요청서/NNG,49,0.47092774298570295,Dovish
49,110, 자정/NNG,159,0.6468121197220299,Dovish
25,64, 인지세/NNG,89,0.5671981279450199,Dovish
97,199, 원한다고/VV,296,0.7077720559362177,Dovish
6,14, 감세/NNG;인프라/NNG;투자/NNG;확대/NNG,20,0.622297374659679,Dovish
13,25, 재정정책/NNG;경기/NNG;부양/NNG,38,0.7550541479204105,Dovish
6,17, 신용등급/NNG;강등/NNG;악재/NNG,23,0.5124801908962061,Dovish
7,20, 조달비율/NNG,27,0.5082095226387378,Dovish
9,18, 펀더멘털/NNG;나쁘/VA;않/VX,27,0.7260136037696254,Dovish
6,12, 기대/NNG;환율/NNG;상승/NNG,18,0.7260136037696254,Dovish
7,14, 저금리/NNG;낮/VA,21,0.7260136037696254,Dovish
11,36, 고립주의/NNG,47,0.44367498008143774,Dovish
9,26, 간여/NNG,35,0.5026248026097407,Dovish
11,31, 생선/NNG,42,0.5152354607397341,Dovish
7,20, 역제/NNG,27,0.5082095226387378,Dovish
9,18, 격타/NNG,27,0.7260136037696254,Dovish
4,16, 금리/NNG;완만/NNG;인상/NNG,20,0.36300680188481266,Dovish
13,32, 불확실성/NNG;상승/NNG,45,0.5898860530628207,Dovish
6,16, 무역/NNG;둔화/NNG,22,0.5445102028272191,Dovish
6,15, 무역/NNG;제한/NNG,21,0.5808108830157004,Dovish
5,16, 무역/NNG;위축/NNG,21,0.4537585023560159,Dovish
5,12, 글로벌/NNG;금리/NNG;상승/NNG;압력/NNG,17,0.6050113364746877,Dovish
9,28, 들여올/VV,37,0.46672303099475926,Dovish
27,53, 몰려든/VV,80,0.7397119736520712,Dovish
47,92, 페드워치/NNG,139,0.7417965081993998,Dovish
6,24, 전미/NNG;활동/NNG;지수/NNG;상승/NNG,30,0.3630068018848127,Dovish
9,24, 생산성/NNG;성장/NNG,33,0.5445102028272191,Dovish
19,56, 숙소/NNG,75,0.4926520882722459,Dovish
35,119, 마곡/NNG,154,0.4270668257468385,Dovish
22,71, 지식재산권/NNG,93,0.4499239234628664,Dovish
30,74, 집적/VAX,104,0.5886596787321287,Dovish
19,47, 고신/NNG,66,0.5869897221967184,Dovish
5,16, 통일성/NNG,21,0.4537585023560159,Dovish
13,38, 개별주식옵션/NNG,51,0.49674614994763844,Dovish
12,23, 안정성/NNG;훼손/NNG,35,0.7575794126291744,Dovish
6,14, 우익/NNG,20,0.622297374659679,Dovish
656,1257,국민/NNG,1913,0.7577803087873893,Dovish
8,16, 소프트브렉시트/NNG,24,0.7260136037696253,Dovish
55,115, 트럼프노믹스/NNG,170,0.6944477949100765,Dovish
15,42, 토양/NNG,57,0.5185811455497324,Dovish
5,12, 호조/NNG;유가/NNG;상승/NNG,17,0.6050113364746877,Dovish
5,13, 군계일학/NNG,18,0.5584720028997119,Dovish
30,65, 많/VA;위험/NNG,95,0.6701664034796543,Dovish
10,22, 고점/NNG;회복/NNG,32,0.6600123670632958,Dovish
17,80, 고압경제/NNG,97,0.3085557816020908,Dovish
6,37, 대통령탄핵소추안/NNG,43,0.23546387149285147,Dovish
7,22, 폐점/NNG,29,0.4620086569443071,Dovish
27,53, 대내외/NNG;여건/NNG;불확실성/NNG,80,0.7397119736520712,Dovish
56,113, 금융안정/NNG;위험/NNG,169,0.7195887046212216,Dovish
5,11,드러나/VV,16,0.6600123670632958,Dovish
14,29, 발톱/NNG,43,0.7009786519155004,Dovish
6,15, 낮/VA;인플레이션/NNG;높/VA,21,0.5808108830157004,Dovish
11,36, 언제/MAG;금리/NNG;오르/VV,47,0.44367498008143774,Dovish
23,44,액션/NNG,67,0.7590142221227901,Dovish
159,354,금융사/NNG,513,0.6521817118608499,Dovish
17,46, 채용계획/NNG,63,0.5366187506123319,Dovish
6,15, 소비자/NNG;심리/NNG;위축/NNG,21,0.5808108830157004,Dovish
1,18, 작국/NNG,19,0.08066817819662504,Dovish
5,16, 무역/NNG;촉진/NNG,21,0.4537585023560159,Dovish
11,30, 트랜스/NNG,41,0.5324099760977252,Dovish
4,21, 합병안/NNG,25,0.27657661095985725,Dovish
30,72, 뒤처지/VV,102,0.6050113364746877,Dovish
56,126, 우려/NNG;작/VA;않/VX,182,0.6453454255730003,Dovish
5,13, 제조업/NNG;경기/NNG;살/VV,18,0.5584720028997119,Dovish
6,15, 자유주의/NNG,21,0.5808108830157004,Dovish
5,16, 재래식/NNG,21,0.4537585023560159,Dovish
16,37, 범죄자/NNG,53,0.6279036573142706,Dovish
23,56, 전략비축유/NNG,79,0.5963683173821923,Dovish
5,14, 금리/NNG;오르/VV;않/VX;금리/NNG;인상/NNG,19,0.5185811455497324,Dovish
19,38, 금리/NNG;인상/NNG;기대/NNG;낮/VV,57,0.7260136037696254,Dovish
11,25, 기업/NNG;수익/NNG;개선/NNG,36,0.6388919713172704,Dovish
7,15, 비슷/NNG;성장/NNG,22,0.6776126968516504,Dovish
24,52, 면했/VV,76,0.6701664034796543,Dovish
5,11, 씨/VV,16,0.6600123670632958,Dovish
9,20, 테이퍼링/NNG;경계/NNG,29,0.6534122433926629,Dovish
24,47, 납부액/NNG,71,0.7414607017221707,Dovish
21,42, 행도/NNG,63,0.7260136037696254,Dovish
21,43, 변론/NNG,64,0.7091295664726573,Dovish
5,11, 주택담보대출/NNG;상승/NNG,16,0.6600123670632958,Dovish
31,180, 쿠데타/NNG,211,0.25007135240953765,Dovish
13,26, 경제/NNG;성장률/NNG;전망/NNG;내리/VV,39,0.7260136037696254,Dovish
4,19, 컨센서스/NNG;금리/NNG;인상/NNG,23,0.30568993842931597,Dovish
5,13, 수입산/NNG,18,0.5584720028997119,Dovish
8,19, 떨어트린/VV,27,0.6113798768586319,Dovish
6,49, 감세/NNG;재정/NNG;지출/NNG;확대/NNG,55,0.1777992499027654,Dovish
2,21, 금리/NNG;인하/NNG;경제/NNG;성장/NNG,23,0.13828830547992862,Dovish
9,18, 금리/NNG;인상/NNG;금융시장/NNG;불안/NNG,27,0.7260136037696254,Dovish
4,14, 가격/NNG;정체/NNG,18,0.41486491643978596,Dovish
7,20, 감산/NNG;효과/NNG,27,0.5082095226387378,Dovish
5,11, 경제/NNG;우려/NNG;완화/NNG,16,0.6600123670632958,Dovish
17,34, 근로장려세제/NNG,51,0.7260136037696254,Dovish
5,13, 경제주체/NNG;심리/NNG;악화/NNG,18,0.5584720028997119,Dovish
621,1188,취임/NNG,1809,0.7590142221227902,Dovish
10,23, 경영계/NNG,33,0.6313161771909785,Dovish
11,33,대담/NNG,44,0.48400906917975023,Dovish
118,251, 대담/NNG,369,0.682626336612078,Dovish
3,14, 반이민/NNG,17,0.3111486873298395,Dovish
51,116, 물결/NNG,167,0.6383912722801879,Dovish
31,64, 반쪽/NNG,95,0.7033256786518246,Dovish
30,59, 망가지/VV,89,0.7383189190877547,Dovish
9,36, 격퇴/NNG,45,0.3630068018848127,Dovish
4,12, 일자리/NNG;회복/NNG,16,0.4840090691797502,Dovish
5,13, 경기/NNG;전망/NNG;좋/VA;않/VX,18,0.5584720028997119,Dovish
25,69, 민평/NNG;금리/NNG;낮/VA,94,0.5260968143258156,Dovish
67,131,금융규제/NNG,198,0.7426398695048076,Dovish
46,128, 스카/NNG,174,0.5218222777094182,Dovish
8,17, 대상금액/NNG,25,0.6833069211949414,Dovish
5,11, 없앤다는/VV,16,0.6600123670632958,Dovish
4,25, 재투자/NNG;줄/VV,29,0.23232435320628012,Dovish
126,286, 연설문/NNG,412,0.6397042942305791,Dovish
10,23, 물가/NNG;상승/NNG;압력/NNG;낮/VV,33,0.6313161771909785,Dovish
11,22, 물가/NNG;압력/NNG;약하/VA,33,0.7260136037696254,Dovish
8,16, 자신/NNG;높/VA,24,0.7260136037696253,Dovish
13,38, 염가/NNG,51,0.49674614994763844,Dovish
14,40, 의대/NNG,54,0.5082095226387378,Dovish
62,119, 마음대로/MAG,181,0.7565183770372568,Dovish
4,12, 국가주의/NNG,16,0.4840090691797502,Dovish
49,103, 대출/NNG;받/VV;어렵/VA,152,0.6907702249458573,Dovish
5,12, 대출/NNG;늘/VV;없/VA,17,0.6050113364746877,Dovish
3,13, 유동성/NNG;취약/NNG,16,0.33508320173982714,Dovish
5,19, 무소속/NNG,24,0.38211242303664494,Dovish
19,47, 폴리스/NNG,66,0.5869897221967184,Dovish
5,16, 시추공/NNG,21,0.4537585023560159,Dovish
7,16, 에세이/NNG,23,0.6352619032984222,Dovish
35,67, 정치/NNG;불확실성/NNG;크/VV,102,0.7585216755802057,Dovish
45,94, 마르/VV,139,0.695119407864535,Dovish
3,30, 반이민행정명령/NNG,33,0.1452027207539251,Dovish
141,303, 석유협회/NNG,444,0.6756958292509385,Dovish
11,25, 착취/NNG,36,0.6388919713172704,Dovish
6,12, 계신/VV,18,0.7260136037696254,Dovish
1,23, 공장/NNG;재수주/NNG;증가/NNG,24,0.06313161771909785,Dovish
5,14, 공장/NNG;재수주/NNG;감소/NNG,19,0.5185811455497324,Dovish
2,17, 금융시장/NNG;확대/NNG,19,0.17082673029873535,Dovish
63,138, 윈윈/NNG,201,0.6628819860505275,Dovish
6,32, 정책/NNG;불확실성/NNG;크/VV,38,0.27225510141360953,Dovish
23,51, 산업/NNG;생산/NNG;늘/VV,74,0.6548357994784856,Dovish
8,19, 공제제도/NNG,27,0.6113798768586319,Dovish
149,286, wto/NNG,435,0.7564757130187005,Dovish
8,22, 일회성손실/NNG,30,0.5280098936506367,Dovish
18,40, 기업/NNG;어렵/VA,58,0.6534122433926629,Dovish
8,18, 비은행/NNG;가계/NNG;대출/NNG;증가/NNG,26,0.6453454255730003,Dovish
5,14, 부진/NNG;내수/NNG;회복/NNG,19,0.5185811455497324,Dovish
78,150, 취약차주/NNG,228,0.7550541479204105,Dovish
3,13, 교역촉진법/NNG,16,0.33508320173982714,Dovish
8,23, 수입/NNG;부진/NNG,31,0.5050529417527828,Dovish
18,38, 치러진다/VV,56,0.687802361465961,Dovish
7,40, 금융감독시스템/NNG,47,0.2541047613193689,Dovish
21,73, 감찰/NNG,94,0.41770645696334613,Dovish
6,13, 정강/NNG,19,0.6701664034796543,Dovish
6,22, 부칙/NNG,28,0.3960074202379775,Dovish
6,37, 정부기금/NNG,43,0.23546387149285147,Dovish
11,32, 소비자보호법/NNG,43,0.4991343525916174,Dovish
6,12, 시류/NNG,18,0.7260136037696254,Dovish
32,90, 꺼릴/VV,122,0.5162763404584002,Dovish
18,41, 대출/NNG;회피/NNG,59,0.637475359407476,Dovish
24,69, 봄바람/NNG,93,0.5050529417527829,Dovish
51,100, 두드리/VV,151,0.740533875845018,Dovish
5,18, 회인/NNG,23,0.4033408909831252,Dovish
4,15, 인플레이션/NNG;전망/NNG;개선/NNG,19,0.3872072553438002,Dovish
6,18, 민관협력사업/NNG,24,0.4840090691797503,Dovish
33,80, 연은지수/NNG,113,0.5989612231099408,Dovish
5,23, 고용/NNG;물가/NNG;상승/NNG,28,0.3156580885954893,Dovish
39,76, 원유/NNG;생산/NNG;증가/NNG,115,0.7451192249214577,Dovish
5,20, 수출/NNG;물가/NNG;하락/NNG,25,0.3630068018848127,Dovish
10,22, 강력/NNG;금융/NNG;완화/NNG,32,0.6600123670632958,Dovish
54,330, 트럼프케어/NNG,384,0.2376044521427865,Dovish
5,16, 호조/NNG;아니/VCN,21,0.4537585023560159,Dovish
33,65, 이어져야/VV,98,0.7371830438276197,Dovish
7,15, 새롭/VA;경기/NNG;부양/NNG,22,0.6776126968516504,Dovish
26,50, 부동산/NNG;가격/NNG;잡/VV,76,0.7550541479204105,Dovish
9,20, 판매가격/NNG;상승/NNG,29,0.6534122433926629,Dovish
26,50, 트윗/NNG,76,0.7550541479204105,Dovish
11,27, 필승/NNG,38,0.5915666401085836,Dovish
3,16,고압경제/NNG,19,0.27225510141360953,Dovish
74,174, 복안/NNG,248,0.6175288124017504,Dovish
4,18, 물적담보/NNG,22,0.32267271278650017,Dovish
35,70, 소득대체율/NNG,105,0.7260136037696254,Dovish
5,11, 의과/NNG,16,0.6600123670632958,Dovish
32,68, 연금제도/NNG,100,0.6833069211949414,Dovish
5,22, 불확실성/NNG;위험/NNG;회피/NNG,27,0.3300061835316479,Dovish
26,62, 유가/NNG;상승/NNG;견인/NNG,88,0.6089146354196858,Dovish
5,20, 지방간/NNG,25,0.3630068018848127,Dovish
10,36, 부정적/VAX;영향/NNG;줄/VV;우려/NNG,46,0.4033408909831252,Dovish
5,14, 실업률/NNG;임금/NNG;상승/NNG,19,0.5185811455497324,Dovish
10,25, fed/NNG;금리/NNG;인상/NNG;자산/NNG;축소/NNG,35,0.5808108830157004,Dovish
11,25, 방위사업/NNG,36,0.6388919713172704,Dovish
4,16, 순이자비용/NNG,20,0.36300680188481266,Dovish
37,85, 실적/NNG;부담/NNG,122,0.632058902105321,Dovish
6,13, 앵/NNG,19,0.6701664034796543,Dovish
8,17, 금리/NNG;연저점/NNG,25,0.6833069211949414,Dovish
27,68, 버텼/VV,95,0.5765402147582319,Dovish
51,123,임명/NNG,174,0.6020600616626162,Dovish
95,190, 데이비드/NNG,285,0.7260136037696254,Dovish
23,48, 낙마/NNG,71,0.6957630369458909,Dovish
45,90, 달했으나/VV,135,0.7260136037696254,Dovish
10,24, 숏포지션청산/NNG,34,0.6050113364746877,Dovish
8,22, 솝/NNG,30,0.5280098936506367,Dovish
76,154, 갉아먹/VV,230,0.7165848556687212,Dovish
14,29, 경제/NNG;활동/NNG;개선/NNG,43,0.7009786519155004,Dovish
18,61, 매출/NNG;급감/NNG,79,0.4284670448476478,Dovish
7,16, 유가/NNG;추락/NNG,23,0.6352619032984222,Dovish
34,70, 경제/NNG;성장률/NNG;부진/NNG,104,0.7052703579476362,Dovish
6,12, 기대/NNG;투자심리/NNG;회복/NNG,18,0.7260136037696254,Dovish
45,87, 지역구/NNG,132,0.7510485556237504,Dovish
149,286, 음식점/NNG,435,0.7564757130187005,Dovish
45,93, 끊기/VV,138,0.7025938100996374,Dovish
17,37, 둔화/NNG;fed/NNG;금리/NNG;인상/NNG,54,0.6671476358964126,Dovish
10,20, 집요/NNG,30,0.7260136037696254,Dovish
11,34, 우려/NNG;가라앉/VV,45,0.46977350832152226,Dovish
6,12, 실효환율/NNG;하락/NNG,18,0.7260136037696254,Dovish
11,27, 세수진도율/NNG,38,0.5915666401085836,Dovish
4,29, 성장/NNG;부진/NNG;일시적/VAX,33,0.2002796148330001,Dovish
82,187, 기대/NNG;밑돌/VV,269,0.6367178129316501,Dovish
13,34, 싸워야/VV,47,0.55518687347089,Dovish
5,12, 연고점/NNG;높/VV,17,0.6050113364746877,Dovish
53,108, 주유/NNG,161,0.7125689074035212,Dovish
31,67, 신뢰수준/NNG,98,0.6718334840853251,Dovish
14,35, 현국/NNG,49,0.5808108830157003,Dovish
12,28, 주식옵션/NNG,40,0.622297374659679,Dovish
12,36, 분양시장/NNG;호조/NNG,48,0.4840090691797503,Dovish
9,24, 체전/NNG,33,0.5445102028272191,Dovish
33,65, 러셀/NNG,98,0.7371830438276197,Dovish
8,27, 금리/NNG;전망/NNG;상향/NNG,35,0.4302302837153335,Dovish
8,21, 재정/NNG;건전성/NNG;높/VV,29,0.5531532219197145,Dovish
8,25, 비틀/VV,33,0.46464870641256023,Dovish
6,13, 사업성기금/NNG,19,0.6701664034796543,Dovish
20,60, 돌봄/VV,80,0.48400906917975023,Dovish
58,120, 교실/NNG,178,0.7018131503106378,Dovish
38,124, 증권거래세/NNG,162,0.44497607972977044,Dovish
5,25, 국회선진화법/NNG,30,0.2904054415078502,Dovish
13,52, 정의당/NNG,65,0.3630068018848127,Dovish
3,13, 노동/NNG;생산성/NNG;상승/NNG,16,0.33508320173982714,Dovish
6,15, 정책/NNG;축소/NNG,21,0.5808108830157004,Dovish
7,14, 공급/NNG;억제/NNG,21,0.7260136037696254,Dovish
19,45, 소득/NNG;상승/NNG,64,0.6130781542943504,Dovish
18,63, 내통/NNG,81,0.41486491643978596,Dovish
5,14, 물가/NNG;부정적/VAX,19,0.5185811455497324,Dovish
3,13, 워터게이트/NNG,16,0.33508320173982714,Dovish
3,16, 탄핵사태/NNG,19,0.27225510141360953,Dovish
55,128,리츠/NNG,183,0.6239179407395218,Dovish
8,31, 자본환원율/NNG,39,0.3747166987198067,Dovish
31,68, 국고여유자금/NNG,99,0.6619535799075996,Dovish
4,24, 앙/MAG,28,0.2420045345898751,Dovish
110,271,후순위채/NNG,381,0.5893837373775557,Dovish
7,27, 투자/NNG;불확실성/NNG,34,0.37645149825091684,Dovish
20,40, 의사일정/NNG,60,0.7260136037696254,Dovish
14,28, 미취/NNG,42,0.7260136037696254,Dovish
12,30, 자채/NNG,42,0.5808108830157004,Dovish
7,19, 대량생산/NNG,26,0.5349573922513029,Dovish
70,136, 노사관계/NNG,206,0.7473669450569673,Dovish
9,18, 동독/NNG,27,0.7260136037696254,Dovish
108,270, 자살/NNG,378,0.5808108830157003,Dovish
240,555, 지상/NNG,795,0.6279036573142706,Dovish
4,26, 대마/NNG,30,0.22338880115988471,Dovish
8,16, 경제/NNG;내수/NNG;회복/NNG,24,0.7260136037696253,Dovish
8,18, fed/NNG;금융안정/NNG,26,0.6453454255730003,Dovish
6,18, 인하/NNG;줄/VV,24,0.4840090691797503,Dovish
11,25, 수익성/NNG;부담/NNG,36,0.6388919713172704,Dovish
4,14, 국고자금/NNG,18,0.41486491643978596,Dovish
26,52, 상고/NNG,78,0.7260136037696254,Dovish
4,13, 놓/NNG,17,0.44677760231976943,Dovish
8,21, 금리/NNG;국제/NNG;유가/NNG;상승/NNG,29,0.5531532219197145,Dovish
8,19, 공공/NNG;지출/NNG;확대/NNG,27,0.6113798768586319,Dovish
545,1080,임금/NNG,1625,0.7327359519526775,Dovish
20,63, 사스/NNG,83,0.4609610182664288,Dovish
15,31, 버리/NNG,46,0.7025938100996375,Dovish
15,32, 임금/NNG;상승률/NNG;높/VA,47,0.6806377535340238,Dovish
14,27, 완화/NNG;긴축/NNG,41,0.7529029965018337,Dovish
12,32, 예상/NNG;늦/VV,44,0.5445102028272191,Dovish
7,23, 노동/NNG;늘/VV,30,0.441921324033685,Dovish
6,15, 교역/NNG;줄/VV,21,0.5808108830157004,Dovish
22,59, 실투자금/NNG,81,0.5414338739976867,Dovish
92,178, 용적률/NNG,270,0.7504859724360172,Dovish
7,18, 건설/NNG;투자/NNG;확대/NNG,25,0.5646772473763753,Dovish
37,73, 부동산/NNG;억제/NNG,110,0.7359589956020861,Dovish
7,20, 스왑레이트/NNG;하락/NNG,27,0.5082095226387378,Dovish
6,14, 유가/NNG;원유/NNG;재고/NNG;급증/NNG,20,0.622297374659679,Dovish
7,17, fed/NNG;경기/NNG;낙관/NNG,24,0.5978935560455738,Dovish
104,226, 임금/NNG;오르/VV,330,0.6681895114339915,Dovish
24,58, 여분/NNG,82,0.6008388444990004,Dovish
7,20, 친족/NNG,27,0.5082095226387378,Dovish
126,272, 투기과열지구/NNG,398,0.6726302505512706,Dovish
33,107, 리브/NNG,140,0.44782147522238575,Dovish
46,109, 응급/NNG,155,0.6127821242826196,Dovish
11,37, 공정률/NNG,48,0.431683764403561,Dovish
4,28, 담보인정비율/NNG;총부채/NNG;상환/NNG;비율/NNG;완화/NNG,32,0.20743245821989298,Dovish
6,12, 사뿐/MAG,18,0.7260136037696254,Dovish
2,19, 걸린다면/VV,21,0.15284496921465798,Dovish
4,14, 금리/NNG;인상/NNG;전망/NNG;늦/VV,18,0.41486491643978596,Dovish
8,19, 물가/NNG;상승/NNG;약하/VA,27,0.6113798768586319,Dovish
18,37, 투자/NNG;급감/NNG,55,0.7063916144785545,Dovish
233,513,시행/NNG,746,0.6594977375373205,Dovish
4,12, 위험/NNG;요인/NNG;많/VA,16,0.4840090691797502,Dovish
9,22, 위탁관리/NNG,31,0.5940111303569663,Dovish
5,18, 경기/NNG;부양/NNG;기대/NNG;상승/NNG,23,0.4033408909831252,Dovish
5,18, 위안화지수/NNG,23,0.4033408909831252,Dovish
10,40, fed/NNG;예상/NNG;매파/NNG,50,0.3630068018848127,Dovish
151,372, 답했/VV,523,0.5893981406946958,Dovish
5,11, 오리지널/NNG,16,0.6600123670632958,Dovish
69,162, 은퇴자/NNG,231,0.6184560328407921,Dovish
33,73, 킹/MAG,106,0.656395860942401,Dovish
5,12, 감독자/NNG,17,0.6050113364746877,Dovish
13,28, 재무/NNG;건전성/NNG;확보/NNG,41,0.6741554892146522,Dovish
10,33,로컬/NNG,43,0.44000824470886385,Dovish
5,17, 물가/NNG;최저/NNG,22,0.42706682574683846,Dovish
23,49, 발행/NNG;금리/NNG;낮/VV,72,0.681563791293934,Dovish
62,130, 신저가/NNG,192,0.6925052835956428,Dovish
13,32, 관가/NNG,45,0.5898860530628207,Dovish
19,37,진짜/MAG,56,0.7456355930606964,Dovish
8,21, 고용/NNG;환경/NNG;개선/NNG,29,0.5531532219197145,Dovish
19,53, 도달성/NNG,72,0.520538055532939,Dovish
17,41, 가계/NNG;부채/NNG;증가/NNG;억제/NNG,58,0.6020600616626163,Dovish
6,18, 가계/NNG;부채/NNG;상환/NNG;부담/NNG;크/VV,24,0.4840090691797503,Dovish
3,14, 가계/NNG;부채/NNG;상환능력/NNG;양호/NNG,17,0.3111486873298395,Dovish
17,43, 금융안정/NNG;저해/NNG,60,0.5740572680969132,Dovish
7,51, 성산/NNG,58,0.19929785201519126,Dovish
26,51, 대출/NNG;수요/NNG;늘/VV,77,0.7402491646278533,Dovish
18,58, 연차보고서/NNG,76,0.45062913337425026,Dovish
25,58, 수탁은행/NNG,83,0.6258737963531253,Dovish
5,12, 신용평가/NNG;시스템/NNG;개선/NNG,17,0.6050113364746877,Dovish
16,31, 시스템/NNG;강화/NNG,47,0.7494333974396133,Dovish
12,24, 건강보험개혁법/NNG,36,0.7260136037696254,Dovish
7,23, 들어준/VV,30,0.441921324033685,Dovish
3,14, 디플레이션/NNG;우려/NNG;줄/VV,17,0.3111486873298395,Dovish
106,208, 이모/NNG,314,0.7399754038421182,Dovish
10,24, 낮/VA;부담/NNG,34,0.6050113364746877,Dovish
10,24, 보세/NNG,34,0.6050113364746877,Dovish
21,65, 가업/NNG,86,0.469116482435758,Dovish
31,73, 소액주주/NNG,104,0.6166142936125586,Dovish
13,29, 특이점/NNG,42,0.6509087482072504,Dovish
9,28, 경기/NNG;둔화/NNG;일시적/VAX,37,0.46672303099475926,Dovish
17,35, 성장/NNG;꺾/VV,52,0.7052703579476362,Dovish
16,40, 경제/NNG;성장/NNG;물가/NNG;상승/NNG,56,0.5808108830157003,Dovish
6,13, 호황/NNG;아니/VCN,19,0.6701664034796543,Dovish
20,59, 조정대상지역/NNG,79,0.4922126127251698,Dovish
195,400, 질병/NNG,595,0.7078632636753848,Dovish
22,48, 불가피성/NNG,70,0.6655124701221565,Dovish
93,197, 스팟/NNG,290,0.6854747731022859,Dovish
23,51, 눈초리/NNG,74,0.6548357994784856,Dovish
10,22, 소득/NNG;여건/NNG;개선/NNG,32,0.6600123670632958,Dovish
42,124,최저임금/NNG,166,0.4918156670697463,Dovish
5,14, 저학력/NNG,19,0.5185811455497324,Dovish
40,103, 신체/NNG,143,0.5638940611802916,Dovish
25,87, 근속/NNG,112,0.41724919756875023,Dovish
47,91, 치렀/VV,138,0.749948118179613,Dovish
26,57, 가격/NNG;경쟁력/NNG;떨어/VV,83,0.6623281999301845,Dovish
9,27, 대출/NNG;부실/NNG;위험/NNG,36,0.4840090691797503,Dovish
15,34, 소득/NNG;높/VV,49,0.6406002386202576,Dovish
7,19, 최저/NNG;높/VA,26,0.5349573922513029,Dovish
10,21, 기대/NNG;fed/NNG;금리/NNG;인상/NNG,31,0.6914415273996433,Dovish
15,32, 우딩/NNG,47,0.6806377535340238,Dovish
52,133, 굴복/NNG,185,0.5677098856544439,Dovish
6,16, 고압/NNG,22,0.5445102028272191,Dovish
16,35, 화염/NNG,51,0.6637838663036575,Dovish
73,171, 분노/NNG,244,0.619871264037224,Dovish
9,25, 포위사격/NNG,34,0.5227297947141304,Dovish
9,31, 록과/NNG,40,0.42155628605978257,Dovish
2,18, 감채/NNG,20,0.16133635639325009,Dovish
14,31, 핵탄두/NNG,45,0.6557542227596617,Dovish
25,70, 사거리/NNG,95,0.5185811455497324,Dovish
21,47, 자위권/NNG,68,0.6487781140068993,Dovish
13,29, 비확산/NNG,42,0.6509087482072504,Dovish
7,19, 법치주의/NNG,26,0.5349573922513029,Dovish
6,14, 묵/NNG,20,0.622297374659679,Dovish
5,15, 뿌리깊/VA,20,0.48400906917975023,Dovish
101,216, 연락/NNG,317,0.6789571664882608,Dovish
17,33, 적십자/NNG,50,0.7480140160050687,Dovish
55,137, 이산가족/NNG,192,0.5829306307639328,Dovish
6,15, 생산자/NNG;물가/NNG;부진/NNG,21,0.5808108830157004,Dovish
6,18, 생산성/NNG;부진/NNG,24,0.4840090691797503,Dovish
9,29, 주담/NNG,38,0.45062913337425026,Dovish
7,15, 대운/NNG,22,0.6776126968516504,Dovish
9,34, 매스/NNG,43,0.3843601431721546,Dovish
25,60, 기관경고/NNG,85,0.6050113364746879,Dovish
5,11, fed/NNG;임금/NNG;상승/NNG,16,0.6600123670632958,Dovish
4,13, 금리/NNG;오르/VV;충격/NNG,17,0.44677760231976943,Dovish
4,13, 우주선/NNG,17,0.44677760231976943,Dovish
61,117, ecb/NNG;비둘기/NNG,178,0.7570398261529427,Dovish
54,104, 기술기업/NNG,158,0.7539372039146109,Dovish
35,111, 치매/NNG,146,0.45784641679165566,Dovish
8,41, 장학생/NNG,49,0.2833223819588782,Dovish
17,36, 지출계획/NNG,53,0.6856795146713129,Dovish
11,27, 혐오/NNG,38,0.5915666401085836,Dovish
4,19, 가계/NNG;부채/NNG;시스템/NNG;위험/NNG,23,0.30568993842931597,Dovish
25,53, 가계/NNG;대출/NNG;억제/NNG,78,0.6849184941222882,Dovish
5,12, 생계/NNG;부담/NNG,17,0.6050113364746877,Dovish
7,14, 인상/NNG;넘/VV,21,0.7260136037696254,Dovish
10,24, 투자/NNG;우려/NNG,34,0.6050113364746877,Dovish
102,229,환매/NNG,331,0.6467544767205397,Dovish
8,20, 비컨/NNG,28,0.5808108830157003,Dovish
4,12, 물가/NNG;전망/NNG;내리/VV,16,0.4840090691797502,Dovish
6,15, 섹터지수/NNG,21,0.5808108830157004,Dovish
19,38, 국경세/NNG,57,0.7260136037696254,Dovish
15,31, 실리콘/NNG,46,0.7025938100996375,Dovish
7,42, 우버/NNG,49,0.24200453458987514,Dovish
5,12, 후선/NNG,17,0.6050113364746877,Dovish
95,193, 기관장/NNG,288,0.7147284182188023,Dovish
4,14, 부동산/NNG;가격/NNG;높/VA,18,0.41486491643978596,Dovish
8,25, 채권/NNG;강하/VA,33,0.46464870641256023,Dovish
4,20, 최대/NNG;낮/VV,24,0.29040544150785014,Dovish
7,27, 하단/NNG;경계/NNG,34,0.37645149825091684,Dovish
25,52, 투하/NNG,77,0.6980900036246398,Dovish
13,32, 핵폭탄/NNG,45,0.5898860530628207,Dovish
4,13, 잠수함발사탄도미사일/NNG,17,0.44677760231976943,Dovish
51,100, 끔찍/NNG,151,0.740533875845018,Dovish
9,18, fed/NNG;금리/NNG;인상/NNG;부담/NNG,27,0.7260136037696254,Dovish
8,16, 피해/NNG;입/VV;않/VX,24,0.7260136037696253,Dovish
93,191, 진료/NNG,284,0.7070080120479074,Dovish
5,12, 요양원/NNG,17,0.6050113364746877,Dovish
45,164, 타입/NNG,209,0.39842209962967245,Dovish
13,27, 옮아가/VV,40,0.6991242110374171,Dovish
18,39, 임금/NNG;상승률/NNG;낮/VA,57,0.6701664034796543,Dovish
22,43, 생산/NNG;제한/NNG,65,0.7428976410665934,Dovish
5,15, 신하/NNG,20,0.48400906917975023,Dovish
8,17, 물가/NNG;fed/NNG;금리/NNG;인상/NNG,25,0.6833069211949414,Dovish
41,91, 모아야/VV,132,0.6542100605396625,Dovish
37,89, 들여오/VV,126,0.6036517604376661,Dovish
7,15, 저물가/NNG;위험/NNG,22,0.6776126968516504,Dovish
7,14, 신용/NNG;긍정적/VAX,21,0.7260136037696254,Dovish
10,22, 이익/NNG;부진/NNG,32,0.6600123670632958,Dovish
4,16, 전망/NNG;소폭/MAG;낮/VV,20,0.36300680188481266,Dovish
14,27, 국채/NNG;최대/NNG,41,0.7529029965018337,Dovish
7,28, 강하/VA;금리/NNG;인하/NNG,35,0.3630068018848127,Dovish
4,13, 회복/NNG;예상/NNG;더디/VA,17,0.44677760231976943,Dovish
24,56,중의원/NNG,80,0.622297374659679,Dovish
62,145, 탈당/NNG,207,0.6208668059823004,Dovish
103,285,원화채권/NNG,388,0.5247677276369924,Dovish
14,30,소극적/VAX,44,0.6776126968516504,Dovish
18,37, 발행/NNG;금리/NNG;오르/VV,55,0.7063916144785545,Dovish
5,13, 가격/NNG;국제/NNG;유가/NNG;상승/NNG,18,0.5584720028997119,Dovish
5,14, 금리/NNG;인상/NNG;확률/NNG;상승/NNG,19,0.5185811455497324,Dovish
20,45, 고요/NNG,65,0.6453454255730003,Dovish
16,54, 수변/NNG,70,0.4302302837153335,Dovish
5,17, 중대/NNG;위험/NNG,22,0.42706682574683846,Dovish
217,424, 오찬/NNG,641,0.7431365661226826,Dovish
8,24, 금융부채/NNG;증가/NNG,32,0.4840090691797502,Dovish
19,52, 일용/NNG,71,0.5305484027547263,Dovish
5,15, 물가/NNG;하락/NNG;위험/NNG,20,0.48400906917975023,Dovish
7,14, 원화채권/NNG;강세/NNG,21,0.7260136037696254,Dovish
141,357, 법상/NNG,498,0.5734897374314688,Dovish
43,97, 가산점/NNG,140,0.6436821641668844,Dovish
44,93,계기/NNG,137,0.6869806143196454,Dovish
13,25, 읽혔/VV,38,0.7550541479204105,Dovish
6,12, 되돌아볼/VV,18,0.7260136037696254,Dovish
58,141, 아꼈/VV,199,0.5972877874984152,Dovish
8,17, 더미/NNG,25,0.6833069211949414,Dovish
27,62, 부정적/VAX;충격/NNG,89,0.6323344290896737,Dovish
5,11, 내이/VV,16,0.6600123670632958,Dovish
10,27, 여단/NNG,37,0.5377878546441669,Dovish
11,23, 탈선/NNG,34,0.6944477949100765,Dovish
207,429, 강의/NNG,636,0.7006285127287293,Dovish
271,519, 변액/NNG,790,0.7581876170387994,Dovish
7,15, 재물/NNG,22,0.6776126968516504,Dovish
5,17, 대재/NNG,22,0.42706682574683846,Dovish
47,129, 중간배당/NNG,176,0.5290331686383316,Dovish
6,17, 원차/NNG,23,0.5124801908962061,Dovish
6,17, 채권/NNG;듀레이션/NNG;길/VA,23,0.5124801908962061,Dovish
7,18, 저물가/NNG;탈피/NNG,25,0.5646772473763753,Dovish
3,14, 해지/NNG;위험/NNG,17,0.3111486873298395,Dovish
5,12, 실망/NNG;fed/NNG;금리/NNG;인상/NNG,17,0.6050113364746877,Dovish
8,17, 디폴트/NNG;위험/NNG;높/VA,25,0.6833069211949414,Dovish
12,24, 자산/NNG;매입/NNG;줄/VV,36,0.7260136037696254,Dovish
6,18, 금융시장/NNG;긴축/NNG,24,0.4840090691797503,Dovish
4,15, 경제/NNG;인플레이션/NNG;상승/NNG;압력/NNG,19,0.3872072553438002,Dovish
5,18, 매수청구/NNG,23,0.4033408909831252,Dovish
5,15, 많/VA;양적완화/NNG,20,0.48400906917975023,Dovish
26,54, 불안/NNG;줄/VV,80,0.6991242110374171,Dovish
12,23, 매너/NNG,35,0.7575794126291744,Dovish
6,13, 다른가/VA,19,0.6701664034796543,Dovish
9,20, 채권스왑/NNG;확대/NNG,29,0.6534122433926629,Dovish
22,46, 주문/NNG;감소/NNG,68,0.6944477949100765,Dovish
89,192, 동의안/NNG,281,0.6730751118280901,Dovish
5,29, 경제/NNG;부정적/VAX;충격/NNG,34,0.25034951854125015,Dovish
8,16, 늦/VA;우려/NNG,24,0.7260136037696253,Dovish
8,33, 롱포지션/NNG;축소/NNG,41,0.3520065957670911,Dovish
8,20, 신용등급/NNG;전망/NNG;안정/NNG;긍정적/VAX;상향/NNG,28,0.5808108830157003,Dovish
8,19, 우하/NNG,27,0.6113798768586319,Dovish
15,30, 한도설정/NNG,45,0.7260136037696253,Dovish
7,20, 산업용지/NNG,27,0.5082095226387378,Dovish
10,32, 주택담보대출/NNG;구조/NNG;개선/NNG,42,0.4537585023560159,Dovish
9,18, 성주/NNG,27,0.7260136037696254,Dovish
9,26, 정합성/NNG,35,0.5026248026097407,Dovish
8,18, 상했/VV,26,0.6453454255730003,Dovish
22,44, 관리계획/NNG,66,0.7260136037696254,Dovish
7,15, 가격/NNG;지탱/NNG,22,0.6776126968516504,Dovish
15,30, 견줄/VV,45,0.7260136037696253,Dovish
117,252, 보장성보험/NNG,369,0.6741554892146521,Dovish
49,116, 연금액/NNG,165,0.6133563204260629,Dovish
55,116, 최선호주/NNG,171,0.6884611759884379,Dovish
9,27, 유장/NNG,36,0.4840090691797503,Dovish
20,70, 사적연금/NNG,90,0.41486491643978596,Dovish
5,11, 국제노동기구/NNG,16,0.6600123670632958,Dovish
6,14, 단카이세대/NNG,20,0.622297374659679,Dovish
8,16, 신계약/NNG;성장/NNG,24,0.7260136037696253,Dovish
12,25, 기대/NNG;작/VA,37,0.6969730596188405,Dovish
6,13, 노란색/NNG,19,0.6701664034796543,Dovish
41,91, 실내/NNG,132,0.6542100605396625,Dovish
6,19, 국제/NNG;유가/NNG;저점/NNG,25,0.458534907643974,Dovish
4,14, 부채/NNG;금리/NNG;인상/NNG,18,0.41486491643978596,Dovish
10,29, 더디/VA;금리/NNG;인상/NNG,39,0.5006990370825003,Dovish
7,16, 회복/NNG;부정적/VAX,23,0.6352619032984222,Dovish
4,21, 금리/NNG;비둘기/NNG,25,0.27657661095985725,Dovish
4,13, 션단/NNG,17,0.44677760231976943,Dovish
185,356, 리언/NNG,541,0.7545647005470826,Dovish
16,48, 등유/NNG,64,0.4840090691797502,Dovish
132,283, 법정최고금리/NNG,415,0.6772706409723713,Dovish
164,333, 징계/NNG,497,0.7151124986079193,Dovish
3,17, 단기/NNG;국채/NNG;금리/NNG;상승/NNG,20,0.25624009544810306,Dovish
17,36, 금리/NNG;낮/VV;않/VX,53,0.6856795146713129,Dovish
5,12, 장기물/NNG;공급/NNG;늘/VV,17,0.6050113364746877,Dovish
4,16, 실적/NNG;높/VV,20,0.36300680188481266,Dovish
630,1283,나스닥/NNG,1913,0.7129985508571536,Dovish
34,72,나쁘/VA,106,0.6856795146713129,Dovish
1021,1978,다우존스/NNG,2999,0.7495044382697548,Dovish
7,20, 전망/NNG;실망/NNG,27,0.5082095226387378,Dovish
100,206,기/NNG,306,0.7048675764753646,Dovish
76,146,건전성/NNG,222,0.7558497792670074,Dovish
9,19,부실여신/NNG,28,0.687802361465961,Dovish
14,30, 지표/NNG;부진/NNG;금리/NNG;인상/NNG,44,0.6776126968516504,Dovish
14,51, 소비/NNG;지표/NNG;부진/NNG,65,0.3985957040303825,Dovish
45,90, 고용/NNG;지표/NNG;양호/NNG,135,0.7260136037696254,Dovish
154,325,공격적/VAX,479,0.6880375075724451,Dovish
500,1175, msci/NNG,1675,0.6178839181018089,Dovish
100,211, 경기방어주/NNG,311,0.6881645533361378,Dovish
85,180, 경기/NNG;지표/NNG;부진/NNG,265,0.6856795146713128,Dovish
9,18, 채권펀드/NNG;플러스/NNG,27,0.7260136037696254,Dovish
71,172,상위/NNG,243,0.5993833240423652,Dovish
48,108,차지/NNG,156,0.6453454255730003,Dovish
90,226,장기투자기관/NNG,316,0.5782409233563388,Dovish
154,308, 성과급/NNG,462,0.7260136037696254,Dovish
14,37, 달러원/NNG;높/VA,51,0.5494157001499868,Dovish
511,1079, 경제/NNG;지표/NNG;부진/NNG,1590,0.6876607071849463,Dovish
186,388,고유/NNG,574,0.6960748984595377,Dovish
12,47, 의료진/NNG,59,0.37073035086108536,Dovish
7,14, 월간지/NNG,21,0.7260136037696254,Dovish
24,47, 좌수/NNG,71,0.7414607017221707,Dovish
7,15,주식선물/NNG,22,0.6776126968516504,Dovish
293,668, g7/NNG,961,0.6368921733667672,Dovish
8,21, 양념/NNG,29,0.5531532219197145,Dovish
187,459,정/MAG,646,0.5915666401085836,Dovish
6,12, 순이자마진/NNG;높/VA,18,0.7260136037696254,Dovish
141,281, 순이자마진/NNG;하락/NNG,422,0.7285972820748553,Dovish
12,62,머니매니저/NNG,74,0.28103752403985505,Dovish
61,176,채/NNG,237,0.5032594298857631,Dovish
430,924, aa-등급/NNG,1354,0.6757269472314694,Dovish
1342,2848, 투표/NNG,4190,0.684206640631206,Dovish
73,156,발전/NNG,229,0.6794742701946495,Dovish
42,92, 국제/NNG;유가/NNG;강세/NNG,134,0.6628819860505275,Dovish
28,55, 이슬람/NNG,83,0.7392138511108913,Dovish
10,21, gdp/NNG;충격/NNG,31,0.6914415273996433,Dovish
110,234,콘/NNG,344,0.6825768924329811,Dovish
9,18, 경제/NNG;불균형/NNG;해소/NNG,27,0.7260136037696254,Dovish
38,75, 탐/NNG,113,0.7356937851532204,Dovish
6,12, fed/NNG;경제/NNG;낙관/NNG,18,0.7260136037696254,Dovish
6,27, fed/NNG;매파/NNG;비둘기/NNG,33,0.32267271278650017,Dovish
8,19, 인플레이션/NNG;압력/NNG;강화/NNG,27,0.6113798768586319,Dovish
2176,5034,딜러/NNG,7210,0.6276541922140266,Dovish
7,14,유행/NNG,21,0.7260136037696254,Dovish
13,25, 발주량/NNG,38,0.7550541479204105,Dovish
16,33, 대외경제협력기금/NNG,49,0.7040131915341822,Dovish
42,125, 금융지원/NNG;강화/NNG,167,0.48788114173318825,Dovish
8,26, 미주개발은행/NNG,34,0.44677760231976943,Dovish
7,14, 기업/NNG;실적/NNG;나쁘/VA,21,0.7260136037696254,Dovish
845,1669,만약/NNG,2514,0.7351485862017179,Dovish
7,16,황금연휴/NNG,23,0.6352619032984222,Dovish
33,67,거듭/MAG,100,0.7151775798327653,Dovish
110,220,체이스/NNG,330,0.7260136037696254,Dovish
23,51, 봤으나/VV,74,0.6548357994784856,Dovish
65,171, 탑재/NNG,236,0.5519401666084871,Dovish
8,16, 동아리/NNG,24,0.7260136037696253,Dovish
4,16, 명세/NNG,20,0.36300680188481266,Dovish
41,84, 외압/NNG,125,0.7087275655846343,Dovish
17,35, 뚫릴/VV,52,0.7052703579476362,Dovish
42,83, 채권전략가/NNG,125,0.7347607556222715,Dovish
157,317,신청/NNG,474,0.7191428125667582,Dovish
56,136,국무총리/NNG,192,0.5978935560455738,Dovish
188,384, 바란다고/VV,572,0.7108883203577581,Dovish
7,14, 순이익/NNG;많/VA,21,0.7260136037696254,Dovish
9,24, 뒤졌/VV,33,0.5445102028272191,Dovish
502,1190, 고용/NNG;지표/NNG;호조/NNG,1692,0.6125358472140369,Dovish
1660,3202,서부텍사스산원유/NNG,4862,0.7527686335150394,Dovish
44,89,운송장/NNG,133,0.7178561475474947,Dovish
72,142,신중/NNG,214,0.7362391474846905,Dovish
19,46,놓/VV,65,0.5997503683314297,Dovish
21,43,증권거래위원회/NNG,64,0.7091295664726573,Dovish
7,18, 조우/NNG,25,0.5646772473763753,Dovish
111,247,국채입찰/NNG,358,0.6525304454933475,Dovish
8,17, 제조업/NNG;활동/NNG;둔화/NNG,25,0.6833069211949414,Dovish
17,45, 대동소이/NNG,62,0.5485436117370504,Dovish
3011,5939,엔/NNG,8950,0.7361599464389096,Dovish
5,17, 부동산/NNG;문제/NNG;심각/NNG,22,0.42706682574683846,Dovish
1548,3007,업종별/NNG,4555,0.7475018680647689,Dovish
888,1756,시가총액상위종목/NNG,2644,0.7342825514207602,Dovish
194,398, 가격제한폭/NNG,592,0.7077720559362177,Dovish
12,32, 실적/NNG;부진/NNG;하락/NNG,44,0.5445102028272191,Dovish
6,13, oecd/NNG;경제/NNG;성장/NNG,19,0.6701664034796543,Dovish
577,1549,유럽연합/NNG,2126,0.540877791317074,Dovish
32,85, 경제/NNG;성장률/NNG;전망/NNG;낮/VV,117,0.5466455369559532,Dovish
12,48, 지이/NNG,60,0.3630068018848127,Dovish
12,32, 효도/NNG,44,0.5445102028272191,Dovish
24,53,글로벌본드/NNG,77,0.6575217543573967,Dovish
2326,4664,s&p/NNG,6990,0.7241456442402009,Dovish
507,1121, bbb-등급/NNG,1628,0.6567152490833187,Dovish
20,58, 컬/VV,78,0.5006990370825003,Dovish
9,20, 손실/NNG;작/VA,29,0.6534122433926629,Dovish
9,26, 회복/NNG;늦/VA,35,0.5026248026097407,Dovish
22,44, 오르내릴/VV,66,0.7260136037696254,Dovish
14,27, 가치관/NNG,41,0.7529029965018337,Dovish
5,12, 위업/NNG,17,0.6050113364746877,Dovish
19,37,광범위/NNG,56,0.7456355930606964,Dovish
11,32,시장경제/NNG,43,0.4991343525916174,Dovish
42,81, 폭로/NNG,123,0.7529029965018338,Dovish
16,31, 오도/NNG,47,0.7494333974396133,Dovish
15,32, 휘말릴/VV,47,0.6806377535340238,Dovish
6,12,이라크전쟁/NNG,18,0.7260136037696254,Dovish
22,54, 유세/NNG,76,0.5915666401085836,Dovish
21,42, 당권/NNG,63,0.7260136037696254,Dovish
5,20, 치적/NNG,25,0.3630068018848127,Dovish
490,939,대형주/NNG,1429,0.7577138782686187,Dovish
348,878,미결제약정/NNG,1226,0.5755187565189741,Dovish
8,20,신용불량자/NNG,28,0.5808108830157003,Dovish
37,125,태풍/NNG,162,0.42980005343161826,Dovish
5,17,철저히/MAG,22,0.42706682574683846,Dovish
9,27,본래/NNG,36,0.4840090691797503,Dovish
19,41,낙관론자/NNG,60,0.6728906571523358,Dovish
5,13, 부진/NNG;유가/NNG;상승/NNG,18,0.5584720028997119,Dovish
18,47, 튈지/VV,65,0.5560955262916281,Dovish
18,36, 앞선다/VV,54,0.7260136037696254,Dovish
6,12, 거대/NNG;불확실성/NNG,18,0.7260136037696254,Dovish
269,602,bis/NNG,871,0.6488294332692002,Dovish
6,12,무작정/MAG,18,0.7260136037696254,Dovish
7,14, 실으며/VV,21,0.7260136037696254,Dovish
8,21, 국채선물/NNG;가격/NNG;오르/VV,29,0.5531532219197145,Dovish
9,27, 현물시장/NNG;강세/NNG,36,0.4840090691797503,Dovish
5,11, 금리/NNG;튀/VV;오르/VV,16,0.6600123670632958,Dovish
146,296, 국고채/NNG;떨어/VV,442,0.71620260912409,Dovish
169,430, 달러엔/NNG;상승/NNG,599,0.5706804606375195,Dovish
6,12, 더해준다/VV,18,0.7260136037696254,Dovish
6,13, 점차/MAG;고점/NNG;높/VV,19,0.6701664034796543,Dovish
26,75, 달러엔/NNG;오르/VV,101,0.5033694319469403,Dovish
9,18, 경상/NNG;적자/NNG;확대/NNG,27,0.7260136037696254,Dovish
35,68, fed/NNG;불확실성/NNG;해소/NNG,103,0.7473669450569673,Dovish
40,95,보름/NNG,135,0.6113798768586319,Dovish
18,69,가뭄/NNG,87,0.3787897063145872,Dovish
7,47, 해갈/NNG,54,0.2162593713356331,Dovish
5,19, 내렸으니/VV,24,0.38211242303664494,Dovish
4,15, 둘러볼/VV,19,0.3872072553438002,Dovish
7,29, 은행/NNG;금리/NNG;하락/NNG,36,0.3504893259577502,Dovish
1559,3057,외국/NNG,4616,0.7405006269393825,Dovish
5,14, 소비/NNG;지출/NNG;견조/NNG,19,0.5185811455497324,Dovish
27,55, 가격결정력/NNG,82,0.7128133564283595,Dovish
12,55, 정책/NNG;제거/NNG,67,0.316805936190382,Dovish
7,15, 인플레이션/NNG;잘/MAG;억제/NNG,22,0.6776126968516504,Dovish
1,15, 인플레이션/NNG;전망/NNG;잘/MAG;억제/NNG,16,0.09680181383595005,Dovish
583,1122, cac40/NNG,1705,0.7544847254860814,Dovish
568,1326,밤/NNG,1894,0.6219845051902674,Dovish
11,32, 담보대출/NNG;최저/NNG,43,0.4991343525916174,Dovish
65,138,韓/NNG,203,0.68392585862356,Dovish
7,21,불가피/NNG,28,0.4840090691797503,Dovish
7,16, 판정승/NNG,23,0.6352619032984222,Dovish
27,54,표현/NNG,81,0.7260136037696253,Dovish
5,12, 쓸모없/VA,17,0.6050113364746877,Dovish
43,97, 되밀리/VV,140,0.6436821641668844,Dovish
10,20, 금리/NNG;인상/NNG;부담/NNG;완화/NNG,30,0.7260136037696254,Dovish
89,182, 나눴/VV,271,0.7100572608296336,Dovish
1110,2405,금융위기/NNG,3515,0.6701664034796542,Dovish
45,157,화폐/NNG,202,0.41618614228832024,Dovish
5,39, 리디노미네이션/NNG,44,0.18615733429990394,Dovish
5,18,단점/NNG,23,0.4033408909831252,Dovish
158,310,역내/NNG,468,0.7400654799716182,Dovish
205,445,필요/NNG,650,0.668911410214711,Dovish
31,84, 느낀다/VV,115,0.5358671837347235,Dovish
37,93, 이자비용/NNG;줄/VV,130,0.5776882438597019,Dovish
57,126, 낭패/NNG,183,0.656869451029661,Dovish
74,161,신탁/NNG,235,0.6673913873161774,Dovish
98,218, 달러엔/NNG;하락/NNG,316,0.6527461758662688,Dovish
15,29, 건설/NNG;상승/NNG,44,0.7510485556237504,Dovish
6,13, 사리/NNG,19,0.6701664034796543,Dovish
5,12, 하락/NNG;압력/NNG;제한적/VAX,17,0.6050113364746877,Dovish
317,826,개별종목/NNG,1143,0.5572549936924244,Dovish
720,1378,시/NNG,2098,0.7586789473354576,Dovish
40,81, 종지부/NNG,121,0.7170504728588893,Dovish
10,55, fed/NNG;금리/NNG;인상/NNG;없/VA,65,0.26400494682531833,Dovish
211,416,거래대금/NNG,627,0.7364849538239949,Dovish
361,748,종목별/NNG,1109,0.7007778367936759,Dovish
10,21, 활력/NNG;없/VA,31,0.6914415273996433,Dovish
254,499,대변인/NNG,753,0.7391080375049494,Dovish
37,82,일비/NNG,119,0.6551830082799059,Dovish
1513,3031,간밤/NNG,4544,0.7248159567822127,Dovish
3,19, 금리/NNG;오르/VV;불확실성/NNG,22,0.229267453821987,Dovish
7,18,주임/NNG,25,0.5646772473763753,Dovish
12,23,바다/NNG,35,0.7575794126291744,Dovish
4,12, 짜릿/NNG,16,0.4840090691797502,Dovish
45,97, 배달/NNG,142,0.673620869476972,Dovish
16,39,실수/NNG,55,0.5957034697596926,Dovish
5,12, 수출업체/NNG;타격/NNG,17,0.6050113364746877,Dovish
250,496,항셍지수/NNG,746,0.7318685521871224,Dovish
25,69,벤처/NNG,94,0.5260968143258156,Dovish
13,37,노상/MAG,50,0.5101717215678448,Dovish
1611,3621,crs/NNG,5232,0.6460137617635274,Dovish
32,126,연차/NNG,158,0.36876881461314304,Dovish
13,32, 쌍방/NNG,45,0.5898860530628207,Dovish
21,43, 큰일/NNG,64,0.7091295664726573,Dovish
533,1105, ftse100/NNG,1638,0.7003895942248151,Dovish
136,329,cac40/NNG,465,0.6002300918703286,Dovish
38,82,빌/VA,120,0.6728906571523358,Dovish
7,20, 경제/NNG;지표/NNG;하락/NNG,27,0.5082095226387378,Dovish
7,15, 앵글/NNG,22,0.6776126968516504,Dovish
80,154, 어스/NNG,234,0.7542998480723381,Dovish
46,109,보험회사/NNG,155,0.6127821242826196,Dovish
4,16,노리/VV,20,0.36300680188481266,Dovish
57,122,덕/NNG,179,0.6784061543421089,Dovish
8,16,중동/NNG,24,0.7260136037696253,Dovish
305,601,매체/NNG,906,0.7368856876863086,Dovish
67,139, 내다본/VV,206,0.6998980065117251,Dovish
21,41,성장동력/NNG,62,0.7437212526420554,Dovish
88,195, 물가안정목표제/NNG,283,0.6552738167356619,Dovish
22,48, 해인/NNG,70,0.6655124701221565,Dovish
40,125, 난국/NNG,165,0.4646487064125603,Dovish
4,13, 수입/NNG;수요/NNG;줄/VV,17,0.44677760231976943,Dovish
11,33,합류/NNG,44,0.48400906917975023,Dovish
190,371, 표면금리/NNG,561,0.7436257936184842,Dovish
45,102, 안전자산/NNG;선호/NNG;크/VV,147,0.6406002386202576,Dovish
14,29, 날아들/VV,43,0.7009786519155004,Dovish
75,156,언제/MAG,231,0.6980900036246398,Dovish
7,14, 산악/NNG,21,0.7260136037696254,Dovish
10,23, 테니스/NNG,33,0.6313161771909785,Dovish
40,78,대장/NNG,118,0.7446293371996158,Dovish
30,58, 왔다갔다/MAG,88,0.7510485556237504,Dovish
7,18,터널/NNG,25,0.5646772473763753,Dovish
7,17, 햇빛/NNG,24,0.5978935560455738,Dovish
97,273,테러/NNG,370,0.5159217550597338,Dovish
17,33,이대로/MAG,50,0.7480140160050687,Dovish
70,160, 채권/NNG;가격/NNG;떨어/VV,230,0.6352619032984222,Dovish
106,240,단순/NNG,346,0.6413120166631691,Dovish
6,14, 공론화/NNG,20,0.622297374659679,Dovish
5,14,컴퍼니/NNG,19,0.5185811455497324,Dovish
71,275,세월/NNG,346,0.37488702449195205,Dovish
5,13, 벚꽃/NNG,18,0.5584720028997119,Dovish
8,17, 내뱉/VV,25,0.6833069211949414,Dovish
9,22, 맸/VV,31,0.5940111303569663,Dovish
21,79, 잠겨/VV,100,0.3859819159281553,Dovish
28,65,어렵/VV,93,0.6254886432476773,Dovish
9,65, 황사/NNG,74,0.2010499210438963,Dovish
7,21, 항간/NNG,28,0.4840090691797503,Dovish
8,17, 배회/NNG,25,0.6833069211949414,Dovish
5,13, 골탕/NNG,18,0.5584720028997119,Dovish
6,12,켠/NNG,18,0.7260136037696254,Dovish
10,22, 순진/NNG,32,0.6600123670632958,Dovish
83,164,아무리/MAG,247,0.7348674282058404,Dovish
37,72, 내쉬/VV,109,0.7461806483187817,Dovish
884,1766,닛케이/NNG,2650,0.7268358162314257,Dovish
8,16, 제조업체/NNG;오르/VV,24,0.7260136037696253,Dovish
36,86, 고용/NNG;지표/NNG;좋/VA,122,0.6078253426908492,Dovish
275,545,일자리/NNG,820,0.7326742790335669,Dovish
583,1171,떨어/VV,1754,0.7229136310806006,Dovish
85,163,회계/NNG,248,0.7571921020910203,Dovish
14,32, 대수롭/VA,46,0.6352619032984222,Dovish
32,76,대화/NNG,108,0.6113798768586319,Dovish
37,79, 녹음/NNG,116,0.6800633756829403,Dovish
34,69,지지부진/NNG,103,0.7154916674831091,Dovish
66,134,실망/NNG,200,0.7151775798327653,Dovish
11,34, 오피/NNG,45,0.46977350832152226,Dovish
9,23, 부닥치/VV,32,0.5681845594718807,Dovish
606,1171,수입/NNG,1777,0.7514333798196294,Dovish
249,476,법/NNG,725,0.7595688543640199,Dovish
2277,4377, 회견/NNG,6654,0.7553726185896444,Dovish
61,127, 도중/NNG,188,0.6974303910227898,Dovish
18,35, 울/NNG,53,0.7467568495916148,Dovish
13,26,개시/NNG,39,0.7260136037696254,Dovish
29,63, 통했/VV,92,0.6683934764863217,Dovish
5,15, 수서/NNG,20,0.48400906917975023,Dovish
32,74,경고/NNG,106,0.6279036573142706,Dovish
9,20,이면/NNG,29,0.6534122433926629,Dovish
57,126,전쟁/NNG,183,0.656869451029661,Dovish
25,51, 뗄/VV,76,0.7117780429113975,Dovish
27,53,활동/NNG,80,0.7397119736520712,Dovish
27,61,적립금/NNG,88,0.6427005672714716,Dovish
34,82,여유자금/NNG,116,0.6020600616626163,Dovish
8,20, 일구/VV,28,0.5808108830157003,Dovish
13,32,연방예금보험공사/NNG,45,0.5898860530628207,Dovish
109,240,대장주/NNG,349,0.6594623567574097,Dovish
146,367, 고용/NNG;지표/NNG;개선/NNG,513,0.577645701091909,Dovish
159,314, 토픽스/NNG,473,0.7352621847093658,Dovish
39,80, 일렉트론/NNG,119,0.7078632636753848,Dovish
71,145, 당첨자/NNG,216,0.7109926326571504,Dovish
59,155, 호수/NNG,214,0.5527071306117148,Dovish
32,71, 고꾸라졌/VV,103,0.6544347977641692,Dovish
22,45,금리연동/NNG,67,0.7098799681303004,Dovish
31,78, 경제/NNG;지표/NNG;좋/VA;않/VX,109,0.5770877363297022,Dovish
162,340, ftse/NNG,502,0.6918482577098783,Dovish
11,31, 제조업/NNG;생산/NNG;감소/NNG,42,0.5152354607397341,Dovish
48,95, 유포/NNG,143,0.7336558522303583,Dovish
75,147,있/VA,222,0.7408302079281892,Dovish
16,34, 창단/NNG,50,0.6833069211949414,Dovish
14,32, 세계/NNG;경제/NNG;부정적/VAX,46,0.6352619032984222,Dovish
6,14, 혼조/NNG;끝/NNG,20,0.622297374659679,Dovish
33,73, 인증서/NNG,106,0.656395860942401,Dovish
45,92,공적자금/NNG,137,0.7102306993398508,Dovish
6,12, 부채/NNG;많이/MAG;늘/VV,18,0.7260136037696254,Dovish
5,13, 수출/NNG;수요/NNG;감소/NNG,18,0.5584720028997119,Dovish
27,52, 오일달러/NNG,79,0.7539372039146109,Dovish
121,241,현상/NNG,362,0.7290261083495824,Dovish
29,63,급격/MAG,92,0.6683934764863217,Dovish
6,16, 곁들여/VV,22,0.5445102028272191,Dovish
5,14, 미증유/NNG,19,0.5185811455497324,Dovish
544,1056,아니/VCN,1600,0.7480140160050687,Dovish
26,57, 바싹/MAG,83,0.6623281999301845,Dovish
14,36, 볼멘/VV,50,0.5646772473763753,Dovish
34,67, 싹쓸이/NNG,101,0.7368496277064855,Dovish
11,33, 맞선다/VV,44,0.48400906917975023,Dovish
56,112, 대표지수/NNG,168,0.7260136037696254,Dovish
157,305, db/NNG,462,0.7474369560120077,Dovish
85,178,파트/NNG,263,0.6933837788811029,Dovish
187,379,부사장/NNG,566,0.7164355878887597,Dovish
5,23, 도가니/NNG,28,0.3156580885954893,Dovish
25,59, 일삼/VV,84,0.6152657659064623,Dovish
30,83, 금융시장/NNG;패닉/NNG,113,0.5248291111587653,Dovish
17,35, 위기/NNG;크/VV,52,0.7052703579476362,Dovish
10,28, 세계/NNG;경기/NNG;위축/NNG,38,0.5185811455497324,Dovish
14,30,하늘/NNG,44,0.6776126968516504,Dovish
7,24, 경제/NNG;과열/NNG;막/VV,31,0.42350793553228144,Dovish
35,78, 들쭉날쭉/MAG,113,0.6515506700496638,Dovish
16,40, 주택/NNG;경기/NNG;살/VV,56,0.5808108830157003,Dovish
17,38, 신디케이트/NNG,55,0.6495911191622965,Dovish
72,152,절반/NNG,224,0.687802361465961,Dovish
11,28, 경제/NNG;지표/NNG;부정적/VAX,39,0.5704392601047057,Dovish
180,361,팀/NNG,541,0.724002485753643,Dovish
21,50, 주주이익/NNG,71,0.6098514271664853,Dovish
106,214,비중/NNG,320,0.7192284299026196,Dovish
11,22, 경제/NNG;전망/NNG;자신/NNG,33,0.7260136037696254,Dovish
660,1291,공개/NNG,1951,0.742322197502638,Dovish
76,185,설명/NNG,261,0.5965084744485571,Dovish
1323,2590,그러/VV,3913,0.7417111952024822,Dovish
35,75, 적자/NNG;줄/VV,110,0.6776126968516504,Dovish
242,495,단금/NNG,737,0.7098799681303003,Dovish
18,49, 재정방출/NNG,67,0.5333977497082962,Dovish
13,30, 이자수익/NNG;줄/VV,43,0.6292117899336753,Dovish
13,25, 금융실명제/NNG,38,0.7550541479204105,Dovish
10,23, 이천/NNG,33,0.6313161771909785,Dovish
56,116,시티/NNG,172,0.7009786519155004,Dovish
7,14,실적배당형/NNG,21,0.7260136037696254,Dovish
40,88, 도저히/MAG,128,0.6600123670632958,Dovish
50,102, 실적배당형/NNG,152,0.7117780429113975,Dovish
44,103, 노년층/NNG,147,0.6202834672983207,Dovish
77,172,자유/NNG,249,0.6500354359332693,Dovish
76,178,비즈니스/NNG,254,0.6199666728819273,Dovish
25,55,기능/NNG,80,0.6600123670632958,Dovish
21,47, 투자심리/NNG;압박/NNG,68,0.6487781140068993,Dovish
15,30,에버/NNG,45,0.7260136037696253,Dovish
22,62, 개발부담금/NNG,84,0.5152354607397341,Dovish
13,31, 건설부/NNG,44,0.6089146354196858,Dovish
9,19, 불입금/NNG,28,0.687802361465961,Dovish
5,12,벌인/VV,17,0.6050113364746877,Dovish
82,159,시장조사기관/NNG,241,0.7488442202403683,Dovish
83,166,공시/NNG,249,0.7260136037696253,Dovish
206,493, opec/NNG;감산/NNG,699,0.6067294214058533,Dovish
20,39, 군림/NNG,59,0.7446293371996158,Dovish
13,28, 맞아떨어졌/VV,41,0.6741554892146522,Dovish
11,24,불/NNG,35,0.6655124701221565,Dovish
144,278,최악/NNG,422,0.7521292010275256,Dovish
395,772,끝/VV,1167,0.7429413820958601,Dovish
71,136,실제/MAG,207,0.7580436157006383,Dovish
211,491, 쏠린다/VV,702,0.6239872521197187,Dovish
21,50, 문제삼/VV,71,0.6098514271664853,Dovish
30,64,담배가격/NNG,94,0.6806377535340238,Dovish
13,57,경영자/NNG,70,0.3311640999650923,Dovish
86,185,시절/NNG,271,0.674996431612841,Dovish
9,30, 항아리/NNG,39,0.43560816226177523,Dovish
15,34,다퉈/VV,49,0.6406002386202576,Dovish
90,174,한국자금중개/NNG,264,0.7510485556237504,Dovish
39,76,신속/NNG,115,0.7451192249214577,Dovish
9,26,중개사/NNG,35,0.5026248026097407,Dovish
36,115, 중징계/NNG,151,0.45454764757750465,Dovish
9,41, 선위/NNG,50,0.318737679703738,Dovish
18,41, 건넸/VV,59,0.637475359407476,Dovish
9,24, 유가/NNG;하락/NNG;상승/NNG,33,0.5445102028272191,Dovish
7,18, 기대/NNG;저점/NNG,25,0.5646772473763753,Dovish
16,49, 정책/NNG;쏟/VV,65,0.47413133307404104,Dovish
5,13, 실가과세/NNG,18,0.5584720028997119,Dovish
30,76, 개발이익/NNG,106,0.5731686345549674,Dovish
5,17, 제책/NNG,22,0.42706682574683846,Dovish
345,660,주재/NNG,1005,0.7590142221227901,Dovish
68,145, 해외/NNG;투자/NNG;활성화/NNG,213,0.6809506904322004,Dovish
1,16, 수출/NNG;경쟁력/NNG;하락/NNG,17,0.09075170047120316,Dovish
6,15, 성장/NNG;잠재력/NNG;떨어/VV,21,0.5808108830157004,Dovish
65,137,상장사/NNG,202,0.6889180181755569,Dovish
22,44, 써왔/VV,66,0.7260136037696254,Dovish
46,105, 기준시가/NNG,151,0.6361262052076717,Dovish
30,58, 가장/NNG,88,0.7510485556237504,Dovish
26,58, 부양가족/NNG,84,0.6509087482072504,Dovish
9,31,실직/NNG,40,0.42155628605978257,Dovish
13,25, 콜/NNG;금리/NNG;내리/VV,38,0.7550541479204105,Dovish
12,23, 물가/NNG;상승률/NNG;내리/VV,35,0.7575794126291744,Dovish
36,102,유출/NNG,138,0.5124801908962061,Dovish
10,25,수도권규제/NNG,35,0.5808108830157004,Dovish
2,14, 빠져든/VV,16,0.20743245821989298,Dovish
76,171,양측/NNG,247,0.6453454255730003,Dovish
27,53, 에버/NNG,80,0.7397119736520712,Dovish
6,13, 비용/NNG;부담/NNG;경감/NNG,19,0.6701664034796543,Dovish
47,105, 몰두/NNG,152,0.6499550357556646,Dovish
34,65,고가/NNG,99,0.7595219239436083,Dovish
26,55, 방불/NNG,81,0.6864128617458277,Dovish
11,24, 인승/NNG,35,0.6655124701221565,Dovish
99,221,긴급/NNG,320,0.6504556269067233,Dovish
28,57, 시립/NNG,85,0.7132765230017372,Dovish
35,70, 착륙/NNG,105,0.7260136037696254,Dovish
6,13, 외침/NNG,19,0.6701664034796543,Dovish
29,56,밥/NNG,85,0.751942661047112,Dovish
16,40, 지르/VV,56,0.5808108830157003,Dovish
19,50,소개/NNG,69,0.5517703388649153,Dovish
34,96,함/NNG,130,0.5142596360034847,Dovish
86,173, 된다면서/VV,259,0.7218169933432114,Dovish
13,32, 쉼터/NNG,45,0.5898860530628207,Dovish
34,67,검토/NNG,101,0.7368496277064855,Dovish
16,31,장점/NNG,47,0.7494333974396133,Dovish
118,235,지자체/NNG,353,0.7291030233601344,Dovish
3,21, 휴학/NNG,24,0.20743245821989298,Dovish
108,212, 교육부/NNG,320,0.7397119736520712,Dovish
19,45, 대출/NNG;불가능/NNG,64,0.6130781542943504,Dovish
84,178, 학부모/NNG,262,0.6852263226589722,Dovish
62,125, 학점/NNG,187,0.7202054949394684,Dovish
68,137, 대환/NNG,205,0.7207142343990443,Dovish
6,17, 가격/NNG;좋/VA,23,0.5124801908962061,Dovish
41,84,믿/VV,125,0.7087275655846343,Dovish
14,40, 심술/NNG,54,0.5082095226387378,Dovish
85,173,단독/NNG,258,0.7134237724903834,Dovish
175,387,msci/NNG,562,0.6566014504376457,Dovish
26,50, 바닥권/NNG,76,0.7550541479204105,Dovish
34,95, 지표/NNG;혼조/NNG,129,0.5196728953298372,Dovish
6,12, 독약/NNG,18,0.7260136037696254,Dovish
46,95, 난다며/VV,141,0.7030868583874267,Dovish
6,26, 이미/MAG;경기/NNG;침체/NNG,32,0.33508320173982714,Dovish
154,311,추진/NNG,465,0.7190102571094682,Dovish
5,13, 양방/NNG,18,0.5584720028997119,Dovish
28,65,주의/NNG,93,0.6254886432476773,Dovish
328,917, 수익형/NNG,1245,0.519372872489503,Dovish
103,208, 그해/NNG,311,0.719032703733379,Dovish
15,33, 암호/NNG,48,0.6600123670632958,Dovish
124,242,낮/NNG,366,0.7440139410531699,Dovish
3374,6897,장중/NNG,10271,0.7103290993529697,Dovish
38,79,페니/NNG,117,0.6984434669176144,Dovish
164,409,초저금리/NNG,573,0.5822309585242962,Dovish
10,30, 전망/NNG;하락/NNG;압력/NNG,40,0.48400906917975023,Dovish
27,73,대폭/NNG,100,0.5370511589528736,Dovish
278,591, 경제/NNG;지표/NNG;개선/NNG,869,0.6830178742739623,Dovish
67,167, 기대/NNG;웃돌/VV,234,0.5825498377552683,Dovish
7,22,중단기물/NNG,29,0.4620086569443071,Dovish
54,114,행복/NNG,168,0.6878023614659609,Dovish
25,64,암/NNG,89,0.5671981279450199,Dovish
34,78, 책자/NNG,112,0.6329349366196735,Dovish
51,107, 강좌/NNG,158,0.6920877344345961,Dovish
11,25, 어렵/VA;경고/NNG,36,0.6388919713172704,Dovish
3,15, 투기/NNG;잡/VV,18,0.2904054415078502,Dovish
151,336,세금/NNG,487,0.6525479414834132,Dovish
125,242,매월/MAG,367,0.750014053481018,Dovish
280,566,포함/NNG,846,0.7183173464858486,Dovish
16,45, 발매/NNG,61,0.5162763404584002,Dovish
10,25,추첨/NNG,35,0.5808108830157004,Dovish
10,23,기부금/NNG,33,0.6313161771909785,Dovish
7,22, 수프/NNG,29,0.4620086569443071,Dovish
13,34, 관서/NNG,47,0.55518687347089,Dovish
1003,2034,도쿄/NNG,3037,0.7160193162054418,Dovish
45,92, 취재진/NNG,137,0.7102306993398508,Dovish
73,246,힐/NNG,319,0.4308861225624606,Dovish
63,121, 병역/NNG,184,0.7560141659088662,Dovish
3,14, 엉덩이/NNG,17,0.3111486873298395,Dovish
96,200,사전/NNG,296,0.6969730596188405,Dovish
44,90, 사무처장/NNG,134,0.7098799681303004,Dovish
13,27, 임모/NNG,40,0.6991242110374171,Dovish
38,83,경찰서/NNG,121,0.6647835408011028,Dovish
26,63, 휴면/NNG,89,0.5992493237463574,Dovish
46,89,상장기업/NNG,135,0.7504859724360172,Dovish
19,39, 등록업체/NNG,58,0.707397870339635,Dovish
14,27, 이익률/NNG;개선/NNG,41,0.7529029965018337,Dovish
4,13,현금결제/NNG,17,0.44677760231976943,Dovish
48,135,협력사/NNG,183,0.5162763404584003,Dovish
19,39, 듀얼/NNG,58,0.707397870339635,Dovish
8,17, 헌장/NNG,25,0.6833069211949414,Dovish
4,16,기술개발/NNG,20,0.36300680188481266,Dovish
27,54,구미/NNG,81,0.7260136037696253,Dovish
15,55, 원스톱서비스/NNG,70,0.39600742023797747,Dovish
122,244,중소/NNG,366,0.7260136037696254,Dovish
30,61, 피트/NNG,91,0.7141117414127462,Dovish
8,25, 급사/NNG,33,0.46464870641256023,Dovish
31,63,일방적/VAX,94,0.7144895783129647,Dovish
307,617,직접/MAG,924,0.722483553832334,Dovish
4,19, 불쑥/MAG,23,0.30568993842931597,Dovish
20,43, 들러/VV,63,0.6753614918787213,Dovish
4,16, 실가/NNG,20,0.36300680188481266,Dovish
61,126,양도세/NNG,187,0.702965552856304,Dovish
111,213,정책위/NNG,324,0.7566902349148208,Dovish
46,102,극심한/VAX,148,0.6548357994784856,Dovish
43,84, 기업가정신/NNG,127,0.7432996419546165,Dovish
23,48, 우려/NNG;투자심리/NNG;위축/NNG,71,0.6957630369458909,Dovish
63,122, 숲/NNG,185,0.7498173284833837,Dovish
9,20,멀리/MAG,29,0.6534122433926629,Dovish
241,565,els/NNG,806,0.6193602779061229,Dovish
13,27, 떠올라/VV,40,0.6991242110374171,Dovish
47,122,지도부/NNG,169,0.5593875307733179,Dovish
11,24, 바젤ii/NNG,35,0.6655124701221565,Dovish
2,21, cd/NNG;낮/VA,23,0.13828830547992862,Dovish
9,19, 망가뜨리/VV,28,0.687802361465961,Dovish
6,12, 현기증/NNG,18,0.7260136037696254,Dovish
96,186,벌써/MAG,282,0.7494333974396133,Dovish
26,52, 과세표준/NNG,78,0.7260136037696254,Dovish
78,181,바뀌/VV,259,0.6257354817019976,Dovish
19,51, 입지조건/NNG,70,0.540951312612662,Dovish
34,133,확산/NNG,167,0.37119492523559794,Dovish
28,59, 실물/NNG;경제/NNG;타격/NNG,87,0.6890976578152377,Dovish
5,12, 부동산/NNG;가격/NNG;뛰/VV,17,0.6050113364746877,Dovish
19,40,땅값/NNG,59,0.6897129235811441,Dovish
7,15, 우려/NNG;증시/NNG;약세/NNG,22,0.6776126968516504,Dovish
46,134, 밑그림/NNG,180,0.4984571010955637,Dovish
8,18, 답사/NNG,26,0.6453454255730003,Dovish
12,28, 해소책/NNG,40,0.622297374659679,Dovish
17,39,턴/VV,56,0.6329349366196735,Dovish
40,101, 스쿨/NNG,141,0.5750602802135647,Dovish
34,98, 없앨/VV,132,0.5037645413911687,Dovish
4,12,총저축률/NNG,16,0.4840090691797502,Dovish
62,119, 휘청거리/VV,181,0.7565183770372568,Dovish
32,66, 지수/NNG;발목/NNG;잡/VV,98,0.7040131915341822,Dovish
142,300,밀리/VV,442,0.6872928782352454,Dovish
20,55,자금중개회사/NNG,75,0.5280098936506367,Dovish
182,389,외화자금/NNG,571,0.6793546318049964,Dovish
12,24,본/NNG,36,0.7260136037696254,Dovish
541,1243,opec/NNG,1784,0.6319764435066249,Dovish
2,16, opec/NNG;유가/NNG;하락/NNG,18,0.18150340094240633,Dovish
3,13, 필라델피아반도체지수/NNG;오르/VV,16,0.33508320173982714,Dovish
22,45,분사/NNG,67,0.7098799681303004,Dovish
46,141,엠파이어스테이트/NNG,187,0.4737110038780534,Dovish
192,383,노동시장/NNG,575,0.7279092006463085,Dovish
24,49,오찬/NNG,73,0.7111969996110616,Dovish
24,47,사회간접자본/NNG,71,0.7414607017221707,Dovish
20,45, 끌어들여/VV,65,0.6453454255730003,Dovish
4,13, 경제/NNG;침체/NNG;가속/NNG,17,0.44677760231976943,Dovish
4,12, 채권/NNG;발행/NNG;중단/NNG,16,0.4840090691797502,Dovish
6,12, 인플레이션/NNG;예상/NNG;높/VA,18,0.7260136037696254,Dovish
25,67, 근원/NNG;생산자/NNG;물가/NNG;상승/NNG,92,0.5418011968430041,Dovish
6,13, 기업/NNG;부담/NNG;크/VV,19,0.6701664034796543,Dovish
10,20, 일궈낸/VV,30,0.7260136037696254,Dovish
8,20,농수산/NNG,28,0.5808108830157003,Dovish
5,11, 자막/NNG,16,0.6600123670632958,Dovish
25,48, 오인/NNG,73,0.7562641705933597,Dovish
25,65,가이드라인/NNG,90,0.5584720028997119,Dovish
2,18, 숙박비/NNG,20,0.16133635639325009,Dovish
13,44, 여실/NNG,57,0.42900803859114234,Dovish
10,24, 정중동/NNG,34,0.6050113364746877,Dovish
7,16, 기업/NNG;실적/NNG;감소/NNG,23,0.6352619032984222,Dovish
16,34,나스닥선물/NNG,50,0.6833069211949414,Dovish
45,101,약관/NNG,146,0.6469428152402602,Dovish
84,174,국무원/NNG,258,0.7009786519155004,Dovish
20,40, 도난/NNG,60,0.7260136037696254,Dovish
15,36, 다친/VV,51,0.6050113364746877,Dovish
8,16, 기라/NNG,24,0.7260136037696253,Dovish
6,13, 실적/NNG;내리/VV,19,0.6701664034796543,Dovish
1771,3844,계약/NNG,5615,0.6689750740249774,Dovish
155,334,트레이더/NNG,489,0.6738449615825864,Dovish
43,113,대대/NNG,156,0.5525413267627237,Dovish
27,61, 셰퍼드/NNG,88,0.6427005672714716,Dovish
146,304, 리볼빙/NNG,450,0.6973551720418771,Dovish
6,20, 분활/NNG,26,0.43560816226177523,Dovish
2,14, 쪼들리/VV,16,0.20743245821989298,Dovish
11,25,상환액/NNG,36,0.6388919713172704,Dovish
6,23, 소비자/NNG;물가/NNG;예상/NNG;밑돌/VV,29,0.3787897063145872,Dovish
7,20, 인플레이션/NNG;부담/NNG;줄/VV,27,0.5082095226387378,Dovish
15,31, 제조업체인/NNG,46,0.7025938100996375,Dovish
9,20, 돈/NNG;흡수/NNG,29,0.6534122433926629,Dovish
8,16, 예상/NNG;빨리/MAG;금리/NNG;오르/VV,24,0.7260136037696253,Dovish
14,41, 생산자금/NNG,55,0.4958141684280369,Dovish
7,26, 당분간/MAG;금리/NNG;오르/VV,33,0.3909304020297983,Dovish
24,65, 지피/VV,89,0.5361331227837235,Dovish
2,14, 잠수/NNG,16,0.20743245821989298,Dovish
9,20, 화기애애/NNG,29,0.6534122433926629,Dovish
31,61,투자수익률/NNG,92,0.7379154661265046,Dovish
16,34, 실적/NNG;전망/NNG;긍정적/VAX,50,0.6833069211949414,Dovish
82,175, 갈지/VV,257,0.6803784629612489,Dovish
32,69,페더/NNG,101,0.6734039223370438,Dovish
51,101,연례/NNG,152,0.7332018572722949,Dovish
6,17, 내수/NNG;살/VV;않/VX,23,0.5124801908962061,Dovish
5,12, 수출/NNG;억제/NNG,17,0.6050113364746877,Dovish
7,22,식음료/NNG,29,0.4620086569443071,Dovish
16,31, 기웃거리/VV,47,0.7494333974396133,Dovish
14,27, 수익/NNG;부진/NNG,41,0.7529029965018337,Dovish
18,44, 기형/NNG,62,0.5940111303569663,Dovish
11,28, 세금우대저축/NNG,39,0.5704392601047057,Dovish
75,166, 부친다/VV,241,0.6560363889484567,Dovish
4,14, 성장동력/NNG;회복/NNG,18,0.41486491643978596,Dovish
193,441,저성장/NNG,634,0.6354676894672912,Dovish
5,18, 붙여야/VV,23,0.4033408909831252,Dovish
42,88, 내놔야/VV,130,0.6930129854164606,Dovish
10,21,잊/VV,31,0.6914415273996433,Dovish
16,38, 시들/VV,54,0.6113798768586319,Dovish
32,68,계절조정/NNG,100,0.6833069211949414,Dovish
5,12, 성장/NNG;증가/NNG,17,0.6050113364746877,Dovish
108,211,두/VV,319,0.7432177176030288,Dovish
7,19,지연/NNG,26,0.5349573922513029,Dovish
13,30, 건설/NNG;경기/NNG;부양/NNG,43,0.6292117899336753,Dovish
18,43,거래세/NNG,61,0.6078253426908492,Dovish
14,34,보유세/NNG,48,0.5978935560455738,Dovish
41,87,인식/NNG,128,0.6842886840127503,Dovish
29,68, 가계/NNG;소득/NNG;늘/VV,97,0.6192468973329157,Dovish
20,56,일반은행/NNG,76,0.5185811455497324,Dovish
215,453,수익/NNG,668,0.6891519859181874,Dovish
17,38, 적잖/VA;부담/NNG,55,0.6495911191622965,Dovish
57,113,짐/NNG,170,0.7324385029180291,Dovish
24,72, 담당관/NNG,96,0.4840090691797503,Dovish
73,159,금속/NNG,232,0.6666540009456938,Dovish
90,177,별다른/VA,267,0.7383189190877546,Dovish
67,133,이례적/VAX,200,0.7314723526701488,Dovish
2,15,대회의실/NNG,17,0.1936036276719001,Dovish
39,105,설명회/NNG,144,0.5393243913717217,Dovish
22,48, 관은/NNG,70,0.6655124701221565,Dovish
8,22, 건설/NNG;경기/NNG;살/VV,30,0.5280098936506367,Dovish
19,50, 지표/NNG;회복/NNG,69,0.5517703388649153,Dovish
4,17, 민간사업/NNG,21,0.3416534605974707,Dovish
8,18, 경기/NNG;부진/NNG;금리/NNG;인상/NNG,26,0.6453454255730003,Dovish
52,110, 경영계획/NNG,162,0.6864128617458277,Dovish
25,82, 병의원/NNG,107,0.4426912218107472,Dovish
5,11, 담보력/NNG;취약/NNG,16,0.6600123670632958,Dovish
22,64, gdp/NNG;성장률/NNG;부진/NNG,86,0.4991343525916174,Dovish
25,50, 최저/NNG;낮/VA,75,0.7260136037696254,Dovish
22,59, 집값/NNG;거품/NNG,81,0.5414338739976867,Dovish
54,114,비아/NNG,168,0.6878023614659609,Dovish
46,89,파이낸셜그룹/NNG,135,0.7504859724360172,Dovish
43,88,혼합형/NNG,131,0.709513294593043,Dovish
8,24,중도환매/NNG,32,0.4840090691797502,Dovish
15,47,내심/NNG,62,0.4634129385763566,Dovish
4,19,후분양제/NNG,23,0.30568993842931597,Dovish
135,342, 지하층/NNG,477,0.5731686345549675,Dovish
48,108, 경제/NNG;성장률/NNG;그치/VV,156,0.6453454255730003,Dovish
116,265,총액/NNG,381,0.6356043625454834,Dovish
32,72, 수두룩/NNG,104,0.6453454255730003,Dovish
5,13,대리점/NNG,18,0.5584720028997119,Dovish
21,43,파이낸스/NNG,64,0.7091295664726573,Dovish
16,35,배정/NNG,51,0.6637838663036575,Dovish
3,14, 스킨십/NNG,17,0.3111486873298395,Dovish
17,58, 시찰/NNG,75,0.4255941815201253,Dovish
5,26, 끈끈/NNG,31,0.27923600144985594,Dovish
141,273, 대출/NNG;금리/NNG;낮/VV,414,0.749948118179613,Dovish
16,34, 가계/NNG;부채/NNG;취약/NNG,50,0.6833069211949414,Dovish
21,65, 장기물/NNG;금리/NNG;오르/VV,86,0.469116482435758,Dovish
5,22, 금리/NNG;당분간/MAG;낮/VA,27,0.3300061835316479,Dovish
11,28, 마우스/NNG,39,0.5704392601047057,Dovish
8,19, 내점/NNG,27,0.6113798768586319,Dovish
71,144,응찰액/NNG,215,0.7159300814950473,Dovish
20,58,유례없/VA,78,0.5006990370825003,Dovish
233,450, 국채/NNG;수익률/NNG;오르/VV,683,0.7518274207925454,Dovish
7,16, 돌아선다/VV,23,0.6352619032984222,Dovish
5,13, 功/NNG,18,0.5584720028997119,Dovish
3,16, 고구려/NNG,19,0.27225510141360953,Dovish
6,13,탑픽/NNG,19,0.6701664034796543,Dovish
536,1147, pbr/NNG,1683,0.6785410490331633,Dovish
16,34, 특별이익/NNG,50,0.6833069211949414,Dovish
10,22, ff/NNG;금리/NNG;목표/NNG;인상/NNG,32,0.6600123670632958,Dovish
11,23, 마식/NNG,34,0.6944477949100765,Dovish
20,43,빼/VV,63,0.6753614918787213,Dovish
38,97,임시국회/NNG,135,0.5688354008916653,Dovish
42,81,국세/NNG,123,0.7529029965018338,Dovish
125,272,세수/NNG,397,0.6672919152294351,Dovish
4,25, 추경/NNG;편성/NNG;경기/NNG;부양/NNG,29,0.23232435320628012,Dovish
22,48, 별칭/NNG,70,0.6655124701221565,Dovish
7,19,보리/NNG,26,0.5349573922513029,Dovish
131,272, 뛸/VV,403,0.6993219271604479,Dovish
14,37,단기자금/NNG,51,0.5494157001499868,Dovish
6,12, 가라앉힐/VV,18,0.7260136037696254,Dovish
46,111,토론/NNG,157,0.6017410049261759,Dovish
174,372, 지표/NNG;개선/NNG,546,0.6791740164296495,Dovish
6,20, 애쓸/VV,26,0.43560816226177523,Dovish
27,54,환위험/NNG,81,0.7260136037696253,Dovish
96,211, 국채/NNG;금리/NNG;떨어/VV,307,0.6606379712026923,Dovish
113,305, 합해/VV,418,0.5379641785309355,Dovish
3,15, 경제/NNG;지표/NNG;부진/NNG;일시적/VAX,18,0.2904054415078502,Dovish
8,31, 예상/NNG;일찍/MAG;금리/NNG;인상/NNG,39,0.3747166987198067,Dovish
4,12, 돌아선다고/VV,16,0.4840090691797502,Dovish
6,26, 논객/NNG,32,0.33508320173982714,Dovish
12,25, 가계/NNG;대출/NNG;위험/NNG,37,0.6969730596188405,Dovish
16,35, 공적/NNG,51,0.6637838663036575,Dovish
47,103, 문책/NNG,150,0.6625755218868425,Dovish
33,100,경제동향간담회/NNG,133,0.47916897848795276,Dovish
6,18, 건설업/NNG;약세/NNG,24,0.4840090691797503,Dovish
29,59, 시총상위/NNG,88,0.7137082884514961,Dovish
21,46, 만인/NNG,67,0.6628819860505275,Dovish
6,16, 프라이머리cbo/NNG,22,0.5445102028272191,Dovish
96,200,재판부/NNG,296,0.6969730596188405,Dovish
9,28,원고/NNG,37,0.46672303099475926,Dovish
4,32, 서신/NNG,36,0.18150340094240633,Dovish
12,35, 농정/NNG,47,0.49783789972774317,Dovish
25,62, 숙원/NNG,87,0.585494841749698,Dovish
43,128,경제부/NNG,171,0.48779039003271707,Dovish
51,109,지적/NNG,160,0.6793888769220349,Dovish
21,45,달성/NNG,66,0.6776126968516504,Dovish
323,624, 꼬집/VV,947,0.7516102372358622,Dovish
64,128, 휘청/MAG,192,0.7260136037696253,Dovish
53,110, 상승곡선/NNG;그리/VV,163,0.6996131090870936,Dovish
20,39,데이/NNG,59,0.7446293371996158,Dovish
5,15, 적자/NNG;심각/NNG,20,0.48400906917975023,Dovish
24,70, ecb/NNG;금리/NNG;낮/VV,94,0.49783789972774317,Dovish
30,64, 호간/NNG,94,0.6806377535340238,Dovish
9,21, 맞바람/NNG,30,0.6222973746596789,Dovish
20,46, 엉망/NNG,66,0.6313161771909785,Dovish
17,40, 금리/NNG;내리/VV;경기/NNG;부양/NNG,57,0.6171115632041816,Dovish
9,24, 버렸/VV,33,0.5445102028272191,Dovish
26,70, 명가/NNG,96,0.5393243913717217,Dovish
42,82,단일/NNG,124,0.7437212526420554,Dovish
51,107,일간지/NNG,158,0.6920877344345961,Dovish
90,174,fx스왑/NNG,264,0.7510485556237504,Dovish
16,31,전통/NNG,47,0.7494333974396133,Dovish
5,14,은행그룹/NNG,19,0.5185811455497324,Dovish
101,220, 경제/NNG;지표/NNG;긍정적/VAX,321,0.6666124907339288,Dovish
5,15, 신규/NNG;주택/NNG;판매/NNG;하향/NNG,20,0.48400906917975023,Dovish
72,142, 경제/NNG;지표/NNG;좋/VA,214,0.7362391474846905,Dovish
173,358,퇴직연금/NNG,531,0.7016779522466212,Dovish
5,13,콥/NNG,18,0.5584720028997119,Dovish
93,227, 경제/NNG;지표/NNG;악화/NNG,320,0.594883393397138,Dovish
23,44, 부동산/NNG;거품/NNG;우려/NNG,67,0.7590142221227901,Dovish
6,15,실증분석/NNG,21,0.5808108830157004,Dovish
36,70,국립/NNG,106,0.7467568495916148,Dovish
16,36, 사지/NNG,52,0.6453454255730003,Dovish
12,28, 무덤/NNG,40,0.622297374659679,Dovish
24,48, 정설/NNG,72,0.7260136037696254,Dovish
88,211, 표했/VV,299,0.6055848069358013,Dovish
25,80,존경/NNG,105,0.4537585023560159,Dovish
5,16,안정화/NNG,21,0.4537585023560159,Dovish
27,56, gdp/NNG;넘/VV,83,0.7000845464921388,Dovish
17,61,건전/NNG,78,0.4046633201338896,Dovish
129,267, 그림자/NNG,396,0.7015412351032335,Dovish
35,81,제로/NNG,116,0.6274191637515282,Dovish
14,35, 금리/NNG;잡/VV,49,0.5808108830157003,Dovish
104,218, 원금보장형/NNG,322,0.6927102274499178,Dovish
13,34, 국도/NNG,47,0.55518687347089,Dovish
15,39,구제안/NNG,54,0.5584720028997118,Dovish
105,236,금융안정/NNG,341,0.6460290542017854,Dovish
23,46, 뒤흔드/VV,69,0.7260136037696253,Dovish
20,47,지금껏/MAG,67,0.6178839181018089,Dovish
23,67,빨리/MAG,90,0.4984571010955637,Dovish
13,31, 대칭/NNG,44,0.6089146354196858,Dovish
5,15,민심/NNG,20,0.48400906917975023,Dovish
8,16,맞이/NNG,24,0.7260136037696253,Dovish
6,12, 그려냈/VV,18,0.7260136037696254,Dovish
250,1584, 국민투표/NNG,1834,0.2291709607858666,Dovish
26,51,자금흐름/NNG,77,0.7402491646278533,Dovish
77,168,상업/NNG,245,0.6655124701221566,Dovish
5,19, 은행/NNG;금리/NNG;낮/VV,24,0.38211242303664494,Dovish
2,31,적자국채발행/NNG,33,0.09367917467995167,Dovish
102,231, aa등급/NNG,333,0.6411548708614874,Dovish
5,18, 거시/NNG;지표/NNG;안정/NNG,23,0.4033408909831252,Dovish
27,52, 전망/NNG;나쁘/VA;않/VX,79,0.7539372039146109,Dovish
56,130, 혈세/NNG,186,0.6254886432476773,Dovish
61,123, 표류/NNG,184,0.7201110541454822,Dovish
4,14, 주먹구구/NNG,18,0.41486491643978596,Dovish
18,54, 발코니/NNG,72,0.4840090691797503,Dovish
6,34, 친정/NNG,40,0.25624009544810306,Dovish
68,164, 공동대표/NNG,232,0.6020600616626163,Dovish
62,124,지주/NNG,186,0.7260136037696255,Dovish
5,29,현금배당/NNG,34,0.25034951854125015,Dovish
20,52, 시가배당률/NNG,72,0.5584720028997119,Dovish
9,33, 지표/NNG;부정적/VAX,42,0.3960074202379775,Dovish
42,93, 기업/NNG;실적/NNG;좋/VA,135,0.6557542227596616,Dovish
7,15, 대외/NNG;위험/NNG;완화/NNG,22,0.6776126968516504,Dovish
8,20, 걸림돌/NNG;많/VA,28,0.5808108830157003,Dovish
26,54, 경기/NNG;지표/NNG;악화/NNG,80,0.6991242110374171,Dovish
9,21, 지표/NNG;예상/NNG;밑돌/VV,30,0.6222973746596789,Dovish
253,591, 지표/NNG;부진/NNG,844,0.6215954035658722,Dovish
6,14, 낙관주의/NNG,20,0.622297374659679,Dovish
5,13, 비관주의/NNG,18,0.5584720028997119,Dovish
18,35, 재정정책/NNG;확장/NNG,53,0.7467568495916148,Dovish
5,18, 신흥시장/NNG;긍정적/VAX,23,0.4033408909831252,Dovish
81,181, 대표팀/NNG,262,0.6498022309982282,Dovish
7,20, 맞히/VV,27,0.5082095226387378,Dovish
7,19, 순이자마진율/NNG,26,0.5349573922513029,Dovish
65,140,거주자/NNG,205,0.6741554892146521,Dovish
101,206, 남자/NNG,307,0.7119162522401182,Dovish
22,58,베스/NNG,80,0.5507689407907503,Dovish
6,32, 욕실/NNG,38,0.27225510141360953,Dovish
7,15,무시/NNG,22,0.6776126968516504,Dovish
44,109,시장조사업체/NNG,153,0.5861394232268535,Dovish
22,52, 일손/NNG,74,0.614319203189683,Dovish
20,76,영세자영업자/NNG,96,0.38211242303664494,Dovish
6,28,오죽/MAG,34,0.3111486873298395,Dovish
15,31,이맘때/NNG,46,0.7025938100996375,Dovish
6,13, 낭떠러지/NNG,19,0.6701664034796543,Dovish
80,177, 고배당주/NNG,257,0.6562834836335597,Dovish
6,14, 창업보육센터/NNG,20,0.622297374659679,Dovish
16,31, 모태펀드/NNG,47,0.7494333974396133,Dovish
5,11,재개발사업/NNG,16,0.6600123670632958,Dovish
24,71,민간기업/NNG,95,0.490826098323127,Dovish
5,24, 비판/NNG;목소리/NNG;높/VA,29,0.30250566823734387,Dovish
87,167,예산정책처/NNG,254,0.7564453117120647,Dovish
9,27, 차일피일/NNG,36,0.4840090691797503,Dovish
21,56, 불로/NNG,77,0.5445102028272191,Dovish
6,12,미숙/NNG,18,0.7260136037696254,Dovish
49,97,환율정책/NNG,146,0.7334982800971473,Dovish
23,65, 일절/MAG,88,0.5137942426677349,Dovish
5,18, 갈취/NNG,23,0.4033408909831252,Dovish
15,50, 대부잔액/NNG,65,0.43560816226177523,Dovish
34,67,채무자/NNG,101,0.7368496277064855,Dovish
150,303, 과태료/NNG,453,0.7188253502669558,Dovish
11,34, 피해신고센터/NNG,45,0.46977350832152226,Dovish
52,105, 사범/NNG,157,0.7190991884956289,Dovish
94,231, 국채/NNG;수익률/NNG;떨어/VV,325,0.5908682143233315,Dovish
2,15, pmi/NNG;낮/VA,17,0.1936036276719001,Dovish
24,55,헌법/NNG,79,0.633611872380764,Dovish
198,401,이르/VV,599,0.716961065069256,Dovish
29,57,법정/NNG,86,0.7387506845375135,Dovish
24,46, 돈/NNG;줄/VV,70,0.7575794126291744,Dovish
16,39, 합칠/VV,55,0.5957034697596926,Dovish
16,52, 지킴/NNG,68,0.44677760231976943,Dovish
5,11,시판/NNG,16,0.6600123670632958,Dovish
180,487,cp/NNG,667,0.5366835674683063,Dovish
7,26,이슬람국가/NNG,33,0.3909304020297983,Dovish
5,18, 투자수익률/NNG;떨어/VV,23,0.4033408909831252,Dovish
35,68,의하/VV,103,0.7473669450569673,Dovish
11,24, 국채/NNG;낮/VA,35,0.6655124701221565,Dovish
5,15, 전무후무/NNG,20,0.48400906917975023,Dovish
32,83,전문위원/NNG,115,0.5598177185693496,Dovish
6,17, 일군/VV,23,0.5124801908962061,Dovish
114,229, 증인/NNG,343,0.722843238687662,Dovish
18,40,흐르/VV,58,0.6534122433926629,Dovish
16,33, 두둔/NNG,49,0.7040131915341822,Dovish
11,44, 우방/NNG,55,0.3630068018848127,Dovish
15,30, 명운/NNG,45,0.7260136037696253,Dovish
21,51, 노크/NNG,72,0.5978935560455738,Dovish
9,30,문제점/NNG,39,0.43560816226177523,Dovish
25,50,열흘/NNG,75,0.7260136037696254,Dovish
23,44, 토론자/NNG,67,0.7590142221227901,Dovish
4,14, 가계/NNG;소득/NNG;확대/NNG,18,0.41486491643978596,Dovish
21,50,언젠가/MAG,71,0.6098514271664853,Dovish
22,51, 성장/NNG;잠재력/NNG;높/VA,73,0.6263646777620296,Dovish
27,60, 입문/NNG,87,0.6534122433926628,Dovish
17,42,목적/NNG,59,0.5877252982896968,Dovish
15,33, 청약부금/NNG,48,0.6600123670632958,Dovish
19,65, 민영주택/NNG,84,0.42443872220378104,Dovish
122,250, 주어진다/VV,372,0.7085892772791544,Dovish
59,141,연금저축/NNG,200,0.607585852800112,Dovish
5,14,저축금액/NNG,19,0.5185811455497324,Dovish
16,42, 캠/NNG,58,0.5531532219197145,Dovish
81,172, 비아/NNG,253,0.6838035105272053,Dovish
13,28, 차려/VV,41,0.6741554892146522,Dovish
27,74,달러자산/NNG,101,0.5297937108589158,Dovish
5,14, 우려/NNG;충격/NNG,19,0.5185811455497324,Dovish
12,27, 영업세/NNG,39,0.6453454255730003,Dovish
3,14,부동산개발업자/NNG,17,0.3111486873298395,Dovish
25,62, 부동산/NNG;경기/NNG;살/VV,87,0.585494841749698,Dovish
26,311,국민투표/NNG,337,0.12139134210939073,Dovish
109,272, 경제/NNG;지표/NNG;실망/NNG,381,0.5818785500800674,Dovish
7,20, 내무/NNG,27,0.5082095226387378,Dovish
41,82,맥/NNG,123,0.7260136037696254,Dovish
5,16, 불자/NNG,21,0.4537585023560159,Dovish
4,30, 금리/NNG;최저/NNG;떨어/VV,34,0.1936036276719001,Dovish
46,91, 국고채/NNG;금리/NNG;떨어/VV,137,0.7339917752396212,Dovish
21,51, 내몰린/VV,72,0.5978935560455738,Dovish
69,150, 회의장/NNG,219,0.6679325154680554,Dovish
5,13, 업황/NNG;바닥/NNG,18,0.5584720028997119,Dovish
9,47, 차년/NNG,56,0.27804776314581403,Dovish
42,92, 약효/NNG,134,0.6628819860505275,Dovish
126,254,지출/NNG,380,0.7202969612202583,Dovish
6,18, 자본지출/NNG;늘/VV,24,0.4840090691797503,Dovish
5,13,반장/NNG,18,0.5584720028997119,Dovish
16,56, 이닝/NNG,72,0.41486491643978596,Dovish
52,115, 트일/VV,167,0.6565688242786178,Dovish
6,14, 세계/NNG;최대/NNG;오르/VV,20,0.622297374659679,Dovish
14,30, 꺼린/VV,44,0.6776126968516504,Dovish
6,13, 국채/NNG;수익률/NNG;금리/NNG;인상/NNG,19,0.6701664034796543,Dovish
66,170, 국채/NNG;수익률/NNG;낮/VA,236,0.5637282099858267,Dovish
48,95,예외/NNG,143,0.7336558522303583,Dovish
22,54, 제조업/NNG;pmi/NNG;최저/NNG,76,0.5915666401085836,Dovish
12,24, 감퇴/NNG,36,0.7260136037696254,Dovish
5,13, 찬반양론/NNG,18,0.5584720028997119,Dovish
140,301,원금/NNG,441,0.6753614918787214,Dovish
6,18, 불어왔/VV,24,0.4840090691797503,Dovish
5,13, 바닷물/NNG,18,0.5584720028997119,Dovish
5,22, 위험/NNG;넘/VV,27,0.3300061835316479,Dovish
13,28, 기업/NNG;실적/NNG;좋/VA;않/VX,41,0.6741554892146522,Dovish
3,13, 좋/VA;않/VX;영향/NNG;줄/VV,16,0.33508320173982714,Dovish
23,95, 예금보험기금/NNG,118,0.35154342919371334,Dovish
11,36,환란/NNG,47,0.44367498008143774,Dovish
4,17, 대방/NNG,21,0.3416534605974707,Dovish
53,138, gdp/NNG;감소/NNG,191,0.5576626231853644,Dovish
322,684, 피해자/NNG,1006,0.6835566678766648,Dovish
18,56, 모기지보험/NNG,74,0.46672303099475926,Dovish
6,16,모기지보험/NNG,22,0.5445102028272191,Dovish
17,53,채널/NNG,70,0.465744576003156,Dovish
4,14, 연장전/NNG,18,0.41486491643978596,Dovish
7,21,보가/NNG,28,0.4840090691797503,Dovish
22,56, 교정/NNG,78,0.5704392601047057,Dovish
45,103, 대출/NNG;금리/NNG;최저/NNG,148,0.634380818827828,Dovish
5,33, 사단법인/NNG,38,0.22000412235443192,Dovish
380,870, 비차익거래/NNG,1250,0.6342187803045004,Dovish
11,22, 건설업/NNG;강세/NNG,33,0.7260136037696254,Dovish
7,15, 중단/NNG;없/VA,22,0.6776126968516504,Dovish
30,59,약하/VA,89,0.7383189190877547,Dovish
99,241, 유동성랠리/NNG,340,0.5964759068314766,Dovish
19,85,가격제한폭/NNG,104,0.3245707875675973,Dovish
9,26,자기매매/NNG,35,0.5026248026097407,Dovish
9,27, 끝난다는/VV,36,0.4840090691797503,Dovish
7,14, 금리/NNG;인상/NNG;우려/NNG;희석/NNG,21,0.7260136037696254,Dovish
1,19, 인플레이션/NNG;압력/NNG;감소/NNG,20,0.07642248460732899,Dovish
14,35, 상향/NNG;힘입/VV;오르/VV,49,0.5808108830157003,Dovish
11,24, 판매/NNG;실적/NNG;부진/NNG,35,0.6655124701221565,Dovish
25,73, 미/NNG;국채/NNG;가격/NNG;상승/NNG,98,0.49726959162303114,Dovish
28,61, 하락/NNG;떨어/VV,89,0.6665042919852299,Dovish
203,399,파고/NNG,602,0.7387506845375135,Dovish
707,1506,안/NNG,2213,0.6816621751196882,Dovish
5,21, 부딪쳤/VV,26,0.34572076369982163,Dovish
33,89, 트리플위칭데이/NNG,122,0.538392110660621,Dovish
21,44, 프로그램/NNG;매물/NNG;부담/NNG,65,0.6930129854164606,Dovish
32,69,사이버/NNG,101,0.6734039223370438,Dovish
6,39, 미/NNG;고용/NNG;지표/NNG;부진/NNG,45,0.22338880115988474,Dovish
55,107,유통시장/NNG,162,0.7463691253706429,Dovish
9,23,직접금융/NNG,32,0.5681845594718807,Dovish
8,23, 개인비중/NNG,31,0.5050529417527828,Dovish
7,19, 위탁증거금/NNG,26,0.5349573922513029,Dovish
39,106, 순유입세/NNG,145,0.5342364254153847,Dovish
5,12, 웅크리/VV,17,0.6050113364746877,Dovish
326,632,진행/NNG,958,0.748988717812968,Dovish
8,18, 수출/NNG;가격/NNG;인하/NNG,26,0.6453454255730003,Dovish
4,22, 매수설/NNG,26,0.26400494682531833,Dovish
25,63, 흉흉/NNG,88,0.576201272833036,Dovish
70,135,실업/NNG,205,0.7529029965018338,Dovish
40,85,의도/NNG,125,0.6833069211949416,Dovish
23,45, 악셀/NNG,68,0.7421472394089503,Dovish
101,227,회동/NNG,328,0.6460561584205478,Dovish
8,16, oecd/NNG;높/VA,24,0.7260136037696253,Dovish
17,50,소위/NNG,67,0.49368925056334534,Dovish
9,18, 달가워하/VV,27,0.7260136037696254,Dovish
8,19, pmi/NNG;최저/NNG,27,0.6113798768586319,Dovish
8,17, 기업/NNG;고용/NNG;늘/VV,25,0.6833069211949414,Dovish
14,30, 앞지를/VV,44,0.6776126968516504,Dovish
4,14,연수원/NNG,18,0.41486491643978596,Dovish
16,48, 당정청/NNG,64,0.4840090691797502,Dovish
12,23, 영세민/NNG,35,0.7575794126291744,Dovish
82,160,지급/NNG,242,0.744163943863866,Dovish
5,11, 제조업/NNG;지수/NNG;최저/NNG,16,0.6600123670632958,Dovish
8,26, 지수/NNG;우려/NNG,34,0.44677760231976943,Dovish
36,69, 국채/NNG;수익률/NNG;최저/NNG,105,0.7575794126291744,Dovish
17,44, 린치/NNG,61,0.5610105120038015,Dovish
3,14,린치/NNG,17,0.3111486873298395,Dovish
9,28,유학/NNG,37,0.46672303099475926,Dovish
63,149, 자격증/NNG,212,0.6139443897649182,Dovish
58,121, 개발계획/NNG,179,0.6960130416303847,Dovish
8,20, 초동/NNG,28,0.5808108830157003,Dovish
30,60, 평수/NNG,90,0.7260136037696253,Dovish
5,14,재래시장/NNG,19,0.5185811455497324,Dovish
5,11,차상위계층/NNG,16,0.6600123670632958,Dovish
107,261,저소득층/NNG,368,0.5952755218647503,Dovish
6,13, 건설/NNG;경기/NNG;연착륙/NNG,19,0.6701664034796543,Dovish
25,67, 체가/NNG,92,0.5418011968430041,Dovish
8,18,용역/NNG,26,0.6453454255730003,Dovish
17,43, 거래법/NNG,60,0.5740572680969132,Dovish
5,14, 금융상품/NNG;확대/NNG,19,0.5185811455497324,Dovish
10,27, 국제공항/NNG,37,0.5377878546441669,Dovish
15,31, 들려왔/VV,46,0.7025938100996375,Dovish
53,126, 프라이빗뱅크/NNG,179,0.6107733492030182,Dovish
43,84,부족/NNG,127,0.7432996419546165,Dovish
64,140, 고용/NNG;지표/NNG;악화/NNG,204,0.6637838663036575,Dovish
6,19, 고용/NNG;최저/NNG,25,0.458534907643974,Dovish
3,21, 바꾼다면/VV,24,0.20743245821989298,Dovish
17,39,국제통화/NNG,56,0.6329349366196735,Dovish
6,14, 버나드/NNG,20,0.622297374659679,Dovish
9,18, 바우/NNG,27,0.7260136037696254,Dovish
40,79, 무릎/NNG,119,0.7352036493869625,Dovish
12,26,수명/NNG,38,0.6701664034796543,Dovish
3,14, 월물간/NNG,17,0.3111486873298395,Dovish
9,18, 누그러져/VV,27,0.7260136037696254,Dovish
26,51, 털어놓/VV,77,0.7402491646278533,Dovish
30,94, 서부텍사스산원유/NNG;오르/VV,124,0.4634129385763566,Dovish
168,429,출석/NNG,597,0.5686260393160701,Dovish
67,156, 프리워크아웃/NNG,223,0.6236270699046782,Dovish
20,47, 발벗고/MAG,67,0.6178839181018089,Dovish
12,62, 배당지수/NNG,74,0.28103752403985505,Dovish
75,144, 시들/NNG,219,0.7562641705933598,Dovish
14,27, 여겨진다고/VV,41,0.7529029965018337,Dovish
15,56, 대표부/NNG,71,0.38893585916229934,Dovish
1,22,부결/NNG,23,0.06600123670632958,Dovish
34,78, 준다며/VV,112,0.6329349366196735,Dovish
9,19, 대출/NNG;원리금/NNG;상환/NNG;유예/NNG,28,0.687802361465961,Dovish
12,24,증인/NNG,36,0.7260136037696254,Dovish
28,59,금융서비스/NNG,87,0.6890976578152377,Dovish
97,234,트레이드/NNG,331,0.6019087142363561,Dovish
6,12,거래처/NNG,18,0.7260136037696254,Dovish
39,83,집행위원회/NNG,122,0.682277844506395,Dovish
4,19,관찰/NNG,23,0.30568993842931597,Dovish
13,42,트럭/NNG,55,0.4494369928097681,Dovish
7,25, 햇볕/NNG,32,0.40656761811099024,Dovish
4,14,화제/NNG,18,0.41486491643978596,Dovish
56,111, 아름다운/VA,167,0.732554266866649,Dovish
11,22, 새집/NNG,33,0.7260136037696254,Dovish
4,12,자연히/MAG,16,0.4840090691797502,Dovish
5,12, 사그라드/VV,17,0.6050113364746877,Dovish
6,15, 언사/NNG,21,0.5808108830157004,Dovish
293,737,선거/NNG,1030,0.5772645479090915,Dovish
23,65,방카슈랑스/NNG,88,0.5137942426677349,Dovish
6,29, 노래방/NNG,35,0.3004194222495002,Dovish
3,13, 수출/NNG;약세/NNG,16,0.33508320173982714,Dovish
3,26, 심인성/NNG,29,0.16754160086991357,Dovish
17,57, 매길/VV,74,0.4330607461081976,Dovish
5,16, 정년퇴직/NNG,21,0.4537585023560159,Dovish
8,26,사법/NNG,34,0.44677760231976943,Dovish
573,1272,회견/NNG,1845,0.6540971618867851,Dovish
8,23, 경제/NNG;성장률/NNG;예상/NNG;낮/VA,31,0.5050529417527828,Dovish
8,24,노동력/NNG,32,0.4840090691797502,Dovish
11,26, 햇살/NNG,37,0.614319203189683,Dovish
35,74,이르/VA,109,0.6867696251874835,Dovish
5,23, 실적/NNG;추정/NNG;하향/NNG,28,0.3156580885954893,Dovish
58,124,제약/NNG,182,0.6791740164296496,Dovish
16,54,개혁안/NNG,70,0.4302302837153335,Dovish
193,385,중요/NNG,578,0.7278993533898063,Dovish
48,97,아예/MAG,145,0.7185289274421036,Dovish
35,100, 떼일/VV,135,0.5082095226387379,Dovish
12,45,투자처/NNG,57,0.38720725534380024,Dovish
9,19, 외양간/NNG,28,0.687802361465961,Dovish
8,16, 산더미/NNG,24,0.7260136037696253,Dovish
39,97, 사업소득/NNG,136,0.5838047535467091,Dovish
5,26, 막후/NNG,31,0.27923600144985594,Dovish
9,20,해결책/NNG,29,0.6534122433926629,Dovish
25,70,맡/VV,95,0.5185811455497324,Dovish
71,174,불황/NNG,245,0.5924938605476254,Dovish
15,38, 드리워/VV,53,0.5731686345549674,Dovish
13,34, 자금원/NNG,47,0.55518687347089,Dovish
9,19, 부실/NNG;가능성/NNG;높/VA,28,0.687802361465961,Dovish
19,49, 매주/NNG,68,0.5630309580254238,Dovish
7,15, 가격/NNG;폭등/NNG,22,0.6776126968516504,Dovish
11,23, 돼선/XSV,34,0.6944477949100765,Dovish
7,24, 가격/NNG;잡/VV,31,0.42350793553228144,Dovish
32,67,고속/NNG,99,0.6935055319590451,Dovish
18,55,릭/NNG,73,0.475208904285573,Dovish
10,32,해고/NNG,42,0.4537585023560159,Dovish
7,14, 진퇴/NNG,21,0.7260136037696254,Dovish
12,29, 야스쿠니/NNG,41,0.6008388444990004,Dovish
11,27, 고노/NNG,38,0.5915666401085836,Dovish
74,196, 野/NNG,270,0.54821435386686,Dovish
121,302, 만나/NNG,423,0.5817724904379117,Dovish
70,162, 英/NNG,232,0.6274191637515282,Dovish
10,22, 朱/NNG,32,0.6600123670632958,Dovish
37,79,與/NNG,116,0.6800633756829403,Dovish
18,38, 유급/NNG,56,0.687802361465961,Dovish
8,20, 법위/NNG,28,0.5808108830157003,Dovish
5,17,鄭/NNG,22,0.42706682574683846,Dovish
283,568, 東/NNG,851,0.723457217840859,Dovish
14,46, 불쾌/NNG,60,0.441921324033685,Dovish
8,19, 正/NNG,27,0.6113798768586319,Dovish
74,214,기초/NNG,288,0.5021028661584326,Dovish
7,14, 예상/NNG;빨리/MAG;회복/NNG,21,0.7260136037696254,Dovish
13,27, 사법당국/NNG,40,0.6991242110374171,Dovish
8,24, 국가인권위원회/NNG,32,0.4840090691797502,Dovish
30,74, 검사장/NNG,104,0.5886596787321287,Dovish
11,31, 뇌출혈/NNG,42,0.5152354607397341,Dovish
30,60,정규직/NNG,90,0.7260136037696253,Dovish
22,48,미약/NNG,70,0.6655124701221565,Dovish
63,135,경매/NNG,198,0.6776126968516504,Dovish
9,28, 퇴거/NNG,37,0.46672303099475926,Dovish
234,466, 국민주택기금/NNG,700,0.729129541983229,Dovish
28,61, 주택임대차보호법/NNG,89,0.6665042919852299,Dovish
26,70,준공/NNG,96,0.5393243913717217,Dovish
12,28, 대통령직/NNG,40,0.622297374659679,Dovish
14,48, 상임이사국/NNG,62,0.42350793553228144,Dovish
12,36,남측/NNG,48,0.4840090691797503,Dovish
13,27,선언/NNG,40,0.6991242110374171,Dovish
15,61,관광객/NNG,76,0.3570558707063731,Dovish
2,16,사이언스/NNG,18,0.18150340094240633,Dovish
9,23, 난치병/NNG,32,0.5681845594718807,Dovish
59,133,층/NNG,192,0.6441323702617728,Dovish
149,311, 저널/NNG,460,0.6956657682422777,Dovish
3,17, 왕래/NNG,20,0.25624009544810306,Dovish
8,21,재외/NNG,29,0.5531532219197145,Dovish
5,13, 인부/NNG,18,0.5584720028997119,Dovish
6,16, 육체/NNG,22,0.5445102028272191,Dovish
21,45, 수사대/NNG,66,0.6776126968516504,Dovish
45,93, 신분증/NNG,138,0.7025938100996374,Dovish
22,112, 지표/NNG;금리/NNG;내리/VV,134,0.28521963005235285,Dovish
5,23, 지수/NNG;하락/NNG;상승/NNG,28,0.3156580885954893,Dovish
33,96, 수와/NNG,129,0.49913435259161737,Dovish
14,28, 한탄/NNG,42,0.7260136037696254,Dovish
42,102, 표준이율/NNG,144,0.5978935560455738,Dovish
19,57,표준이율/NNG,76,0.4840090691797503,Dovish
18,53,잭/NNG,71,0.4931413157680475,Dovish
7,16,정규시장/NNG,23,0.6352619032984222,Dovish
11,33,고리/NNG,44,0.48400906917975023,Dovish
7,21, 손댈/VV,28,0.4840090691797503,Dovish
2,22, 심주/NNG,24,0.13200247341265917,Dovish
18,42,주총/NNG,60,0.6222973746596789,Dovish
6,17, 누른/VV,23,0.5124801908962061,Dovish
10,25, 선화/NNG,35,0.5808108830157004,Dovish
53,144, 머니매니저/NNG,197,0.5344266805526409,Dovish
18,37, 컬/NNG,55,0.7063916144785545,Dovish
66,218,리보금리/NNG,284,0.43960456742014015,Dovish
18,43,리파이낸싱/NNG,61,0.6078253426908492,Dovish
9,18,상장채권/NNG,27,0.7260136037696254,Dovish
8,17, 가격/NNG;지나치/VA;높/VA,25,0.6833069211949414,Dovish
4,13,협조융자/NNG,17,0.44677760231976943,Dovish
91,190,빅/NNG,281,0.6954446099266938,Dovish
6,18, 발행/NNG;금리/NNG;인하/NNG,24,0.4840090691797503,Dovish
35,87, 산다는/VV,122,0.5841488765962504,Dovish
6,30,트리플위칭데이/NNG,36,0.2904054415078502,Dovish
27,60, 마녀/NNG,87,0.6534122433926628,Dovish
6,17, 기업/NNG;이익/NNG;전망/NNG;상향/NNG,23,0.5124801908962061,Dovish
72,182,독립성/NNG,254,0.5744283458397037,Dovish
38,90,재직/NNG,128,0.6130781542943504,Dovish
9,43, cd/NNG;금리/NNG;높/VA,52,0.3039126713454246,Dovish
5,21,수직/NNG,26,0.34572076369982163,Dovish
35,104, 주거지/NNG,139,0.4886630025372479,Dovish
119,269,대내/NNG,388,0.6423466085396685,Dovish
8,40, 집값/NNG;최대/NNG,48,0.29040544150785014,Dovish
43,101,직장인/NNG,144,0.618189801229582,Dovish
51,120,근로/NNG,171,0.6171115632041816,Dovish
12,31, 금리/NNG;떨어/VV;않/VX,43,0.5620750480797101,Dovish
17,33,캐/VV,50,0.7480140160050687,Dovish
4,12, 경기/NNG;과열/NNG;위험/NNG,16,0.4840090691797502,Dovish
10,23, 늘어놓/VV,33,0.6313161771909785,Dovish
6,21,마녀/NNG,27,0.41486491643978596,Dovish
13,26,국민계정/NNG,39,0.7260136037696254,Dovish
10,34, 혈관/NNG,44,0.42706682574683846,Dovish
11,23, 외국계기업/NNG,34,0.6944477949100765,Dovish
11,24,극복/NNG,35,0.6655124701221565,Dovish
22,52, 상용/NNG,74,0.614319203189683,Dovish
8,16, 최대/NNG;관심사/NNG;떠오르/VV,24,0.7260136037696253,Dovish
9,24, 수칙/NNG,33,0.5445102028272191,Dovish
10,20, 자기계발/NNG,30,0.7260136037696254,Dovish
11,23, 계명/NNG,34,0.6944477949100765,Dovish
8,23, 금리/NNG;역사적/VAX;낮/VA,31,0.5050529417527828,Dovish
8,16, 가꾸/VV,24,0.7260136037696253,Dovish
10,20, 일목요연/NNG,30,0.7260136037696254,Dovish
13,25,절약/NNG,38,0.7550541479204105,Dovish
5,25, 윤택/NNG,30,0.2904054415078502,Dovish
6,28, 기를/VV,34,0.3111486873298395,Dovish
4,16, 발병률/NNG,20,0.36300680188481266,Dovish
16,33,투자자산/NNG,49,0.7040131915341822,Dovish
18,38,서류/NNG,56,0.687802361465961,Dovish
84,230, 캐쉬백/NNG,314,0.530305588840422,Dovish
4,14, 딸/VV,18,0.41486491643978596,Dovish
62,179, 안정책/NNG,241,0.5029367981420869,Dovish
8,16, 취한다는/VV,24,0.7260136037696253,Dovish
35,72,쓰/VV,107,0.7058465592204692,Dovish
14,55, 법대/NNG,69,0.36960692555544566,Dovish
11,24, 자금/NNG;낮/VA,35,0.6655124701221565,Dovish
13,25, 재탕/NNG,38,0.7550541479204105,Dovish
13,37,g8/NNG,50,0.5101717215678448,Dovish
13,29,요소/NNG,42,0.6509087482072504,Dovish
8,18, 해로운/VA,26,0.6453454255730003,Dovish
30,75,수요자/NNG,105,0.5808108830157003,Dovish
4,12,직격탄/NNG,16,0.4840090691797502,Dovish
91,186, 집값/NNG;안정/NNG,277,0.7104004079896333,Dovish
42,105,루/NNG,147,0.5808108830157003,Dovish
6,16, 갈구/NNG,22,0.5445102028272191,Dovish
13,54,잡/VV,67,0.34956210551870853,Dovish
5,24, 부동산정책/NNG;실패/NNG,29,0.30250566823734387,Dovish
86,188,국정/NNG,274,0.6642252119594445,Dovish
55,135, 재건축시장/NNG,190,0.5915666401085836,Dovish
12,26,부상/NNG,38,0.6701664034796543,Dovish
57,119,유입/NNG,176,0.6955088305019941,Dovish
15,34, 갸우뚱/MAG,49,0.6406002386202576,Dovish
14,33, 모기지/NNG;금리/NNG;내리/VV,47,0.6160115425924094,Dovish
4,19, 오리/VV,23,0.30568993842931597,Dovish
6,20, 대단위/NNG,26,0.43560816226177523,Dovish
47,101, 마이너스/NNG;성장/NNG,148,0.6756958292509384,Dovish
8,16, 안정/NNG;못하/VX,24,0.7260136037696253,Dovish
7,20,특정지역/NNG,27,0.5082095226387378,Dovish
6,17,발달/NNG,23,0.5124801908962061,Dovish
8,26, 몰라서/VV,34,0.44677760231976943,Dovish
7,22,주거환경/NNG,29,0.4620086569443071,Dovish
7,20, 이자소득/NNG;줄/VV,27,0.5082095226387378,Dovish
4,15, 주택매매/NNG;활성화/NNG,19,0.3872072553438002,Dovish
5,12, 신규/NNG;주택/NNG;판매가격/NNG;감소/NNG,17,0.6050113364746877,Dovish
18,36, 저층/NNG,54,0.7260136037696254,Dovish
34,74,마진/NNG,108,0.6671476358964126,Dovish
56,137, bbb등급/NNG,193,0.5935293695050953,Dovish
5,34, 무보증채/NNG,39,0.21353341287341923,Dovish
7,19, 얻어맞/VV,26,0.5349573922513029,Dovish
50,110, 기득권/NNG,160,0.6600123670632958,Dovish
50,106,흔히/MAG,156,0.6849184941222882,Dovish
38,80,갑작/MAG,118,0.6897129235811441,Dovish
52,101,나중/NNG,153,0.7475783642776341,Dovish
51,102,카드채/NNG,153,0.7260136037696253,Dovish
15,31,실태/NNG,46,0.7025938100996375,Dovish
148,302,이때/NNG,450,0.7115894924364541,Dovish
7,22,발행기업/NNG,29,0.4620086569443071,Dovish
27,112,환자/NNG,139,0.3500422732460694,Dovish
22,69, 몰려오/VV,91,0.46296519660671764,Dovish
6,13, 금리/NNG;약간/MAG;오르/VV,19,0.6701664034796543,Dovish
27,55, 국제/NNG;유가/NNG;떨어/VV,82,0.7128133564283595,Dovish
34,94, 항변/NNG,128,0.5252013303865376,Dovish
5,16,길거리/NNG,21,0.4537585023560159,Dovish
28,76,정당/NNG,104,0.5349573922513029,Dovish
7,15, 은근슬쩍/MAG,22,0.6776126968516504,Dovish
26,80, 경정/NNG,106,0.4719088424502565,Dovish
62,134,중견/NNG,196,0.6718334840853251,Dovish
5,24, 상류/NNG,29,0.30250566823734387,Dovish
10,36, 이남/NNG,46,0.4033408909831252,Dovish
31,70, 급팽창/NNG,101,0.6430406204816682,Dovish
32,64,해결/NNG,96,0.7260136037696253,Dovish
53,123,투기지역/NNG,176,0.6256702601591894,Dovish
8,23, 가계/NNG;가처분/NNG;소득/NNG;늘/VV,31,0.5050529417527828,Dovish
22,45,의지/NNG,67,0.7098799681303004,Dovish
3,18,평범/NNG,21,0.24200453458987514,Dovish
367,729,배/NNG,1096,0.7309931209422565,Dovish
18,42,파트너/NNG,60,0.6222973746596789,Dovish
68,133,유사/NNG,201,0.7423898504711959,Dovish
3,13, 미끼상품/NNG,16,0.33508320173982714,Dovish
7,16, 부녀회/NNG,23,0.6352619032984222,Dovish
15,54, 인문/NNG,69,0.4033408909831252,Dovish
7,16,의학/NNG,23,0.6352619032984222,Dovish
14,41, 엉터리/NNG,55,0.4958141684280369,Dovish
2,25, 대출/NNG;개선/NNG,27,0.11616217660314006,Dovish
21,45, 경제/NNG;지표/NNG;상승/NNG,66,0.6776126968516504,Dovish
21,42,첨단/NNG,63,0.7260136037696254,Dovish
6,19, 대식/NNG,25,0.458534907643974,Dovish
7,26, 일정표/NNG,33,0.3909304020297983,Dovish
8,33, 완주/NNG,41,0.3520065957670911,Dovish
9,27, 동호회/NNG,36,0.4840090691797503,Dovish
24,50, 돌려준다/VV,74,0.6969730596188405,Dovish
8,33,실효/NNG,41,0.3520065957670911,Dovish
50,98,부동산업/NNG,148,0.7408302079281892,Dovish
7,14, 실적/NNG;떨어/VV,21,0.7260136037696254,Dovish
35,69,가치주/NNG,104,0.7365355400561417,Dovish
85,176,배당주/NNG,261,0.7012631400047519,Dovish
4,17,공채/NNG,21,0.3416534605974707,Dovish
31,75,퇴직/NNG,106,0.6001712457828904,Dovish
11,26, 위험/NNG;매우/MAG;낮/VA,37,0.614319203189683,Dovish
37,92,상태/NNG,129,0.5839674639016552,Dovish
33,72, 정해야/VV,105,0.6655124701221565,Dovish
3,15, 미공개/NNG,18,0.2904054415078502,Dovish
46,90, 남겨뒀/VV,136,0.7421472394089503,Dovish
39,78, 유로존/NNG;최대/NNG,117,0.7260136037696254,Dovish
14,39,바야흐로/MAG,53,0.5212405360397311,Dovish
7,22, 호령/NNG,29,0.4620086569443071,Dovish
36,76, 부른/VV,112,0.687802361465961,Dovish
5,12,결의/NNG,17,0.6050113364746877,Dovish
7,24,스쿨/NNG,31,0.42350793553228144,Dovish
13,46,캐시/NNG,59,0.4103555151741361,Dovish
8,22,알리/NNG,30,0.5280098936506367,Dovish
22,43, opec/NNG;증산/NNG,65,0.7428976410665934,Dovish
9,20, 선부/NNG,29,0.6534122433926629,Dovish
178,367,제출/NNG,545,0.7042529780435602,Dovish
5,16, 써먹/VV,21,0.4537585023560159,Dovish
14,28,행정지도/NNG,42,0.7260136037696254,Dovish
21,41, 월급쟁이/NNG,62,0.7437212526420554,Dovish
9,29, 원망/NNG,38,0.45062913337425026,Dovish
7,18, 토하/VV,25,0.5646772473763753,Dovish
15,50,월급/NNG,65,0.43560816226177523,Dovish
104,201,담보/NNG,305,0.7512976596222989,Dovish
30,63, 꿈쩍/MAG,93,0.6914415273996432,Dovish
46,100,국회의원/NNG,146,0.6679325154680553,Dovish
7,19, 어이없/VA,26,0.5349573922513029,Dovish
11,25, 국감장/NNG,36,0.6388919713172704,Dovish
184,363,야당/NNG,547,0.7360137911493723,Dovish
99,211,평소/NNG,310,0.6812829078027764,Dovish
34,68, 일쑤/NNG,102,0.7260136037696254,Dovish
25,53, 바닥/NNG;떨어/VV,78,0.6849184941222882,Dovish
7,28, 경제정책/NNG;실패/NNG,35,0.3630068018848127,Dovish
7,21, 재진/NNG,28,0.4840090691797503,Dovish
6,14, 국제/NNG;유가/NNG;부담/NNG,20,0.622297374659679,Dovish
58,119,출발/NNG,177,0.7077107398090466,Dovish
4,15, 금리/NNG;오르/VV;모르/VV;우려/NNG,19,0.3872072553438002,Dovish
24,54, 통안채/NNG;낮/VA,78,0.6453454255730003,Dovish
2,15,클릭/NNG,17,0.1936036276719001,Dovish
71,137, 영수증/NNG,208,0.7525104506225315,Dovish
31,67,출금액/NNG,98,0.6718334840853251,Dovish
108,217, 학과/NNG,325,0.7226679189596271,Dovish
42,87,강의/NNG,129,0.7009786519155004,Dovish
24,58, 문답/NNG,82,0.6008388444990004,Dovish
13,25, 추스르/VV,38,0.7550541479204105,Dovish
22,44, 최대/NNG;떨어/VV,66,0.7260136037696254,Dovish
16,42, 원자재/NNG;가격/NNG;떨어/VV,58,0.5531532219197145,Dovish
10,30,文/NNG,40,0.48400906917975023,Dovish
7,15,安/NNG,22,0.6776126968516504,Dovish
6,14, 重/NNG,20,0.622297374659679,Dovish
8,22, 慶/NNG,30,0.5280098936506367,Dovish
6,16, 秀/NNG,22,0.5445102028272191,Dovish
1,17, 善/NNG,18,0.08541336514936768,Dovish
8,22,주무/NNG,30,0.5280098936506367,Dovish
13,26, 집값/NNG;많이/MAG;오르/VV,39,0.7260136037696254,Dovish
9,18, 흘러나온다/VV,27,0.7260136037696254,Dovish
93,206,정부정책/NNG,299,0.655526846122089,Dovish
13,36,남편/NNG,49,0.5243431582780628,Dovish
11,23, 매달릴/VV,34,0.6944477949100765,Dovish
33,79,속/NNG,112,0.606543010744244,Dovish
14,45, 침체/NNG;벗어나/VV;못하/VX,59,0.45174179790110025,Dovish
25,49, 배당소득세/NNG,74,0.7408302079281892,Dovish
118,270,이사장/NNG,388,0.634589668480117,Dovish
7,16, 국제자유도시/NNG,23,0.6352619032984222,Dovish
153,349, 달러엔/NNG;환율/NNG;상승/NNG,502,0.6365620709269495,Dovish
21,54,표준/NNG,75,0.5646772473763753,Dovish
9,20, 노란/VA,29,0.6534122433926629,Dovish
11,22, 과소비/NNG,33,0.7260136037696254,Dovish
7,25, 재충전/NNG,32,0.40656761811099024,Dovish
10,22, 기러기/NNG,32,0.6600123670632958,Dovish
63,141, 파격/NNG,204,0.6487781140068993,Dovish
9,20, 핵전쟁/NNG,29,0.6534122433926629,Dovish
64,125, 체불/NNG,189,0.7434379302600964,Dovish
5,16, 투자/NNG;늦/VV,21,0.4537585023560159,Dovish
6,13, 하락/NNG;위험/NNG;줄/VV,19,0.6701664034796543,Dovish
15,32,안건/NNG,47,0.6806377535340238,Dovish
23,48,현안/NNG,71,0.6957630369458909,Dovish
2,14, 주택/NNG;높/VA,16,0.20743245821989298,Dovish
4,21, 경제/NNG;장기/NNG;불황/NNG,25,0.27657661095985725,Dovish
17,41, 잠재/NNG;성장률/NNG;낮/VA,58,0.6020600616626163,Dovish
16,32,부유층/NNG,48,0.7260136037696253,Dovish
7,21, 재간/NNG,28,0.4840090691797503,Dovish
18,37, 공범/NNG,55,0.7063916144785545,Dovish
73,165, 범행/NNG,238,0.6424120372749413,Dovish
13,27, 자백/NNG,40,0.6991242110374171,Dovish
23,57, 사고파/VV,80,0.5859057153228555,Dovish
30,69, 자본/NNG;유출/NNG;가속/NNG,99,0.6313161771909785,Dovish
4,17, 기대/NNG;강하/VA;않/VX,21,0.3416534605974707,Dovish
6,15, 낙폭/NNG;줄/VV;하락/NNG,21,0.5808108830157004,Dovish
23,53,외국환은행/NNG,76,0.630125014592505,Dovish
13,25, 위급/NNG,38,0.7550541479204105,Dovish
4,29, bis/NNG;비율/NNG;오르/VV,33,0.2002796148330001,Dovish
9,32,초안/NNG,41,0.4083826521204143,Dovish
6,23, 금리/NNG;인하/NNG;압력/NNG;크/VV,29,0.3787897063145872,Dovish
6,25, 애국심/NNG,31,0.34848652980942024,Dovish
5,23, 자포/NNG,28,0.3156580885954893,Dovish
17,37, 즉흥/NNG,54,0.6671476358964126,Dovish
3,17, 陽/NNG,20,0.25624009544810306,Dovish
22,44, 공영개발/NNG,66,0.7260136037696254,Dovish
351,757,피치/NNG,1108,0.6732649271417135,Dovish
15,44, 적힌/VV,59,0.49500927529747185,Dovish
27,73,인덱스펀드/NNG,100,0.5370511589528736,Dovish
11,24, 우려/NNG;벗어나/VV,35,0.6655124701221565,Dovish
4,14, roic/NNG,18,0.41486491643978596,Dovish
5,11, 강력/NNG;경제/NNG;성장/NNG,16,0.6600123670632958,Dovish
16,46,비자금/NNG,62,0.5050529417527828,Dovish
10,31, 용처/NNG,41,0.46839587339975836,Dovish
3,13, 초여름/NNG,16,0.33508320173982714,Dovish
22,64, 개별주식선물/NNG,86,0.4991343525916174,Dovish
7,16,처방/NNG,23,0.6352619032984222,Dovish
53,111,중장기물/NNG,164,0.6933102882845071,Dovish
17,41,에쿼티/NNG,58,0.6020600616626163,Dovish
7,25, 퍼티/NNG,32,0.40656761811099024,Dovish
6,24, 부동산/NNG;선호/NNG,30,0.3630068018848127,Dovish
5,17, 모기지/NNG;증가/NNG,22,0.42706682574683846,Dovish
4,16,객장/NNG,20,0.36300680188481266,Dovish
16,31, 실물/NNG;지표/NNG;부진/NNG,47,0.7494333974396133,Dovish
9,18, 和/NNG,27,0.7260136037696254,Dovish
19,38, 지수/NNG;추락/NNG,57,0.7260136037696254,Dovish
4,13,에어버스/NNG,17,0.44677760231976943,Dovish
8,16, 정신없이/MAG,24,0.7260136037696253,Dovish
1,20, 속기록/NNG,21,0.07260136037696253,Dovish
95,194, 예정자/NNG,289,0.7110442511145817,Dovish
4,21, 수박/NNG,25,0.27657661095985725,Dovish
16,40, 걸어야/VV,56,0.5808108830157003,Dovish
22,52, 돌려줄/VV,74,0.614319203189683,Dovish
5,12, 심리/NNG;좀처럼/MAG;살/VV,17,0.6050113364746877,Dovish
18,42, 주택/NNG;판매가격/NNG;늘/VV,60,0.6222973746596789,Dovish
50,105, 지수/NNG;넘/VV,155,0.6914415273996433,Dovish
166,320, 청소년/NNG,486,0.7532391139109863,Dovish
10,25, 동점/NNG,35,0.5808108830157004,Dovish
40,90, 객장/NNG,130,0.6453454255730003,Dovish
23,48,청소년/NNG,71,0.6957630369458909,Dovish
4,12, 겹친다는/VV,16,0.4840090691797502,Dovish
19,38,필라델피아제조업지수/NNG,57,0.7260136037696254,Dovish
5,20,간단/NNG,25,0.3630068018848127,Dovish
8,29, fed/NNG;금리/NNG;인상/NNG;압력/NNG,37,0.4005592296660002,Dovish
5,19, 수익성/NNG;호전/NNG,24,0.38211242303664494,Dovish
7,15, 멈춘다면/VV,22,0.6776126968516504,Dovish
39,96, 전망/NNG;떨어/VV,135,0.5898860530628206,Dovish
8,19, 구입가격/NNG,27,0.6113798768586319,Dovish
13,37, 주거지역/NNG,50,0.5101717215678448,Dovish
16,44, 층고/NNG,60,0.5280098936506367,Dovish
6,14, 안정장치/NNG,20,0.622297374659679,Dovish
247,521,외화/NNG,768,0.6883890983919289,Dovish
18,36, 동동/MAG,54,0.7260136037696254,Dovish
17,38, 구르/VV,55,0.6495911191622965,Dovish
15,40, 자금/NNG;조달/NNG;비용/NNG;높/VA,55,0.544510202827219,Dovish
21,43,한꺼번에/MAG,64,0.7091295664726573,Dovish
5,25, 연체/NNG;위험/NNG,30,0.2904054415078502,Dovish
74,153,외평기금/NNG,227,0.7022876690059122,Dovish
20,43, 표한/VV,63,0.6753614918787213,Dovish
11,28, 메자닌펀드/NNG,39,0.5704392601047057,Dovish
234,586,채권단/NNG,820,0.5798197381641377,Dovish
3,13, 일본식/NNG;장기/NNG;불황/NNG;빠지/VV,16,0.33508320173982714,Dovish
9,19, 심각/NNG;피해/NNG,28,0.687802361465961,Dovish
68,141, 주택정책/NNG,209,0.7002684405153834,Dovish
5,17, 논설위원/NNG,22,0.42706682574683846,Dovish
12,29, 심각/NNG;경고/NNG,41,0.6008388444990004,Dovish
5,14, 부동산/NNG;거품/NNG;위험/NNG,19,0.5185811455497324,Dovish
12,25, 경제/NNG;지표/NNG;예상/NNG;좋/VA,37,0.6969730596188405,Dovish
5,11, 지표/NNG;예상/NNG;좋/VA;않/VX,16,0.6600123670632958,Dovish
6,36, 지수/NNG;낙폭/NNG;제한/NNG,42,0.24200453458987514,Dovish
119,439,협상/NNG,558,0.39360190819401103,Dovish
4,12, 필라델피아제조업지수/NNG;마이너스/NNG,16,0.4840090691797502,Dovish
35,75, 고꾸라지/VV,110,0.6776126968516504,Dovish
25,56,설리/NNG,81,0.6482264319371656,Dovish
7,16,전향/NNG,23,0.6352619032984222,Dovish
6,13, 국가안전보장회의/NNG,19,0.6701664034796543,Dovish
16,31,국방위원장/NNG,47,0.7494333974396133,Dovish
6,12,복병/NNG,18,0.7260136037696254,Dovish
19,43,사퇴/NNG,62,0.6415934172847853,Dovish
52,111, 죄기/NNG,163,0.6802289620904598,Dovish
13,44, 부동산/NNG;경기/NNG;과열/NNG,57,0.42900803859114234,Dovish
117,228,정밀/NNG,345,0.7451192249214575,Dovish
6,25,석화/NNG,31,0.34848652980942024,Dovish
21,44, 주먹구구식/NNG,65,0.6930129854164606,Dovish
63,149,책임/NNG,212,0.6139443897649182,Dovish
5,11, 뱉/VV,16,0.6600123670632958,Dovish
11,23, 설익/VV,34,0.6944477949100765,Dovish
14,34,신청자/NNG,48,0.5978935560455738,Dovish
26,51, 엄선/NNG,77,0.7402491646278533,Dovish
13,40, 겔/NNG,53,0.4719088424502565,Dovish
12,23,전문업체/NNG,35,0.7575794126291744,Dovish
58,127,전환/NNG,185,0.663130535726587,Dovish
97,208,분양가/NNG,305,0.6771473035159007,Dovish
14,29, 부추긴다는/VV,43,0.7009786519155004,Dovish
11,23, 부진/NNG;해소/NNG,34,0.6944477949100765,Dovish
4,12, 중소기업/NNG;금리/NNG;인하/NNG,16,0.4840090691797502,Dovish
5,13, 제빵/NNG,18,0.5584720028997119,Dovish
8,32, 세탁/NNG,40,0.36300680188481266,Dovish
11,26, 걸어왔/VV,37,0.614319203189683,Dovish
58,118, 권위/NNG,176,0.7137082884514961,Dovish
12,63,유동성함정/NNG,75,0.2765766109598573,Dovish
15,32, 해야지/VV,47,0.6806377535340238,Dovish
171,341,개정안/NNG,512,0.7281426759214426,Dovish
12,25, 속설/NNG,37,0.6969730596188405,Dovish
5,12, 들러리/NNG,17,0.6050113364746877,Dovish
21,51, 금리/NNG;소폭/MAG;내리/VV,72,0.5978935560455738,Dovish
12,24, 어소/NNG,36,0.7260136037696254,Dovish
5,13, 금리/NNG;인상/NNG;필요/NNG;않/VX,18,0.5584720028997119,Dovish
231,610, dc/NNG,841,0.5498660408878147,Dovish
3,13, 미실현이익/NNG,16,0.33508320173982714,Dovish
11,30, 상환/NNG;어렵/VA,41,0.5324099760977252,Dovish
6,16, 주택가격/NNG;최대/NNG,22,0.5445102028272191,Dovish
10,24, 제대/NNG,34,0.6050113364746877,Dovish
100,196,중기청/NNG,296,0.7408302079281892,Dovish
21,45,재해/NNG,66,0.6776126968516504,Dovish
137,280,피해/NNG,417,0.7104561694031335,Dovish
24,58, 특별재난지역/NNG,82,0.6008388444990004,Dovish
21,46, 정책/NNG;자금/NNG;금리/NNG;인하/NNG,67,0.6628819860505275,Dovish
6,16, 유로존/NNG;금리/NNG;인하/NNG,22,0.5445102028272191,Dovish
19,42, 개리/NNG,61,0.6568694510296611,Dovish
4,18, 숏커버/NNG;상승/NNG,22,0.32267271278650017,Dovish
8,17, 찾아냈/VV,25,0.6833069211949414,Dovish
6,13,형제/NNG,19,0.6701664034796543,Dovish
9,19, 받들/VV,28,0.687802361465961,Dovish
52,114,형/NNG,166,0.6623281999301845,Dovish
12,55,대주단/NNG,67,0.316805936190382,Dovish
19,37,송도/NNG,56,0.7456355930606964,Dovish
5,17, 자금/NNG;유입/NNG;촉진/NNG,22,0.42706682574683846,Dovish
16,35, 가져올지/VV,51,0.6637838663036575,Dovish
14,51, 東京/NNG,65,0.3985957040303825,Dovish
16,31,비전/NNG,47,0.7494333974396133,Dovish
30,65,이동/NNG,95,0.6701664034796543,Dovish
5,15, 면키/VV,20,0.48400906917975023,Dovish
10,24,쇼/NNG,34,0.6050113364746877,Dovish
13,31, 하락/NNG;국채/NNG;가격/NNG;상승/NNG,44,0.6089146354196858,Dovish
48,92,디/NNG,140,0.7575794126291744,Dovish
65,126, 발부/NNG,191,0.7490616546829467,Dovish
8,17, 망언/NNG,25,0.6833069211949414,Dovish
1,16, 반일/NNG,17,0.09075170047120316,Dovish
4,20, 개체/NNG,24,0.29040544150785014,Dovish
20,45, 채취/NNG,65,0.6453454255730003,Dovish
5,16, 멸종/NNG,21,0.4537585023560159,Dovish
6,21, 산림청/NNG,27,0.41486491643978596,Dovish
2,14, 스폿/NNG,16,0.20743245821989298,Dovish
21,42,부서/NNG,63,0.7260136037696254,Dovish
16,40, 종잡/VV,56,0.5808108830157003,Dovish
8,16, 중장거리/NNG,24,0.7260136037696253,Dovish
321,710,인도분/NNG,1031,0.6564799065071825,Dovish
11,29, 경제/NNG;추락/NNG,40,0.5507689407907503,Dovish
15,42,펜/NNG,57,0.5185811455497324,Dovish
47,96, 금리/NNG;빠지/VV,143,0.7108883203577581,Dovish
12,29, 투자심리/NNG;취약/NNG,41,0.6008388444990004,Dovish
91,174, 좇/VV,265,0.7593935395751253,Dovish
19,44,여름철/NNG,63,0.6270117487101311,Dovish
8,19,소매점/NNG,27,0.6113798768586319,Dovish
9,18,석유회사/NNG,27,0.7260136037696254,Dovish
19,43,쉐/NNG,62,0.6415934172847853,Dovish
13,35,당내/NNG,48,0.5393243913717217,Dovish
9,21, 악영향/NNG;줄/VV;우려/NNG,30,0.6222973746596789,Dovish
6,12, 산업/NNG;활력/NNG,18,0.7260136037696254,Dovish
38,82,참가/NNG,120,0.6728906571523358,Dovish
10,20, 동석/NNG,30,0.7260136037696254,Dovish
6,14, 섭외/NNG,20,0.622297374659679,Dovish
8,20, 판다고/VV,28,0.5808108830157003,Dovish
8,24, 금기시/NNG,32,0.4840090691797502,Dovish
28,75, 상금/NNG,103,0.5420901574813203,Dovish
76,163, 영농/NNG,239,0.6770188206931476,Dovish
78,171, 농업인/NNG,249,0.6623281999301845,Dovish
3,13, 전환형펀드/NNG,16,0.33508320173982714,Dovish
15,43, 동문/NNG,58,0.506521118909041,Dovish
15,32, 명부/NNG,47,0.6806377535340238,Dovish
37,91, 내규/NNG,128,0.5903846887796954,Dovish
16,42, 연구회/NNG,58,0.5531532219197145,Dovish
79,153,본관/NNG,232,0.7497395385333386,Dovish
41,80,토론회/NNG,121,0.744163943863866,Dovish
7,25, 빗발쳤/VV,32,0.40656761811099024,Dovish
8,27, 이택/NNG,35,0.4302302837153335,Dovish
6,22,메/NNG,28,0.3960074202379775,Dovish
8,17, 리플/NNG,25,0.6833069211949414,Dovish
15,43, 연구진/NNG,58,0.506521118909041,Dovish
37,91, 공영/NNG,128,0.5903846887796954,Dovish
2,15,공영개발/NNG,17,0.1936036276719001,Dovish
40,99, 극약/NNG,139,0.5866776596118185,Dovish
19,49, 누를/VV,68,0.5630309580254238,Dovish
2,17, 투자금액/NNG;줄/VV,19,0.17082673029873535,Dovish
19,41, 베스트셀러/NNG,60,0.6728906571523358,Dovish
29,56,부대표/NNG,85,0.751942661047112,Dovish
7,27,바람직/NNG,34,0.37645149825091684,Dovish
35,155, 확진/NNG,190,0.3278771113798309,Dovish
4,14, 골수/NNG,18,0.41486491643978596,Dovish
14,29, 함량/NNG,43,0.7009786519155004,Dovish
8,27, 나트륨/NNG,35,0.4302302837153335,Dovish
18,37, 섭취/NNG,55,0.7063916144785545,Dovish
52,115, 중앙지/NNG,167,0.6565688242786178,Dovish
147,319,감사원/NNG,466,0.6691159859193413,Dovish
81,166,권한/NNG,247,0.7085193000643332,Dovish
18,59, 인베스트먼츠/NNG,77,0.44299135145265284,Dovish
19,37, 저축률/NNG;높/VA,56,0.7456355930606964,Dovish
5,13, 좋/VA;않/VX;금리/NNG;인하/NNG,18,0.5584720028997119,Dovish
35,78, 소비/NNG;지출/NNG;감소/NNG,113,0.6515506700496638,Dovish
13,32,악사/NNG,45,0.5898860530628207,Dovish
5,13, 불안/NNG;가라앉/VV;않/VX,18,0.5584720028997119,Dovish
42,111, 사표/NNG,153,0.5494157001499868,Dovish
54,113, 총기/NNG,167,0.6938891080276066,Dovish
19,39,의구심/NNG,58,0.707397870339635,Dovish
2,15, 과욕/NNG,17,0.1936036276719001,Dovish
32,72, 도피/NNG,104,0.6453454255730003,Dovish
16,40,서면/NNG,56,0.5808108830157003,Dovish
55,146, 현장조사/NNG,201,0.5469965507853343,Dovish
5,13, 건전성/NNG;해치/VV;않/VX,18,0.5584720028997119,Dovish
7,28,실무진/NNG,35,0.3630068018848127,Dovish
11,45, 농업정책자금/NNG,56,0.3549399840651502,Dovish
5,23, 자금/NNG;금리/NNG;인하/NNG,28,0.3156580885954893,Dovish
6,15,농어민/NNG,21,0.5808108830157004,Dovish
23,51, 양육비/NNG,74,0.6548357994784856,Dovish
523,1006,낙찰/NNG,1529,0.7548809438797497,Dovish
17,49, 모기지/NNG;금리/NNG;낮/VA,66,0.5037645413911687,Dovish
43,95, 거래기업/NNG,138,0.6572333676230293,Dovish
97,188,신보/NNG,285,0.7491842506984433,Dovish
8,20,은행지점/NNG,28,0.5808108830157003,Dovish
5,13, 맞닥뜨렸/VV,18,0.5584720028997119,Dovish
8,26, 경기/NNG;불투명/NNG,34,0.44677760231976943,Dovish
18,40,개편/NNG,58,0.6534122433926629,Dovish
50,169,독립/NNG,219,0.42959384838439374,Dovish
60,122, 휩싸인/VV,182,0.7141117414127462,Dovish
147,322,합병/NNG,469,0.6628819860505275,Dovish
12,34,원활/NNG,46,0.5124801908962061,Dovish
48,116,실수요자/NNG,164,0.6008388444990004,Dovish
4,12, 하방/NNG;경직/NNG;크/VV,16,0.4840090691797502,Dovish
2,14,라지/NNG,16,0.20743245821989298,Dovish
77,161,조기상환/NNG,238,0.6944477949100765,Dovish
42,82,도로/NNG,124,0.7437212526420554,Dovish
14,40, 다시/VV,54,0.5082095226387378,Dovish
7,19, 격앙/NNG,26,0.5349573922513029,Dovish
10,25,허용/NNG,35,0.5808108830157004,Dovish
8,17, 투자등급/NNG;상향/NNG,25,0.6833069211949414,Dovish
12,41,태도/NNG,53,0.42498357293831734,Dovish
9,19, 오줌/NNG,28,0.687802361465961,Dovish
9,18, 누기/NNG,27,0.7260136037696254,Dovish
24,60, 통념/NNG,84,0.5808108830157004,Dovish
44,103,신축/NNG,147,0.6202834672983207,Dovish
7,14,기다렸/VV,21,0.7260136037696254,Dovish
7,27,직매입/NNG,34,0.37645149825091684,Dovish
8,19, 금융지원/NNG;활성화/NNG,27,0.6113798768586319,Dovish
6,13, 정책/NNG;자금/NNG;확대/NNG,19,0.6701664034796543,Dovish
32,65, 신용/NNG;대출/NNG;확대/NNG,97,0.7148441637116312,Dovish
5,11, 증제/NNG,16,0.6600123670632958,Dovish
34,66, 불이익/NNG,100,0.7480140160050687,Dovish
36,108,손절/NNG,144,0.4840090691797503,Dovish
10,24, 사그라졌/VV,34,0.6050113364746877,Dovish
15,32, 모기지/NNG;금리/NNG;떨어/VV,47,0.6806377535340238,Dovish
3,14, 좀처럼/MAG;좁혀/VV;지지/NNG;않/VX,17,0.3111486873298395,Dovish
35,74,취업기회/NNG,109,0.6867696251874835,Dovish
4,13, 사그라진/VV,17,0.44677760231976943,Dovish
70,275,정무위원회/NNG,345,0.36960692555544566,Dovish
58,126, 오갔/VV,184,0.6683934764863217,Dovish
5,14, 인출기/NNG,19,0.5185811455497324,Dovish
49,103, 수표/NNG,152,0.6907702249458573,Dovish
5,19, 차터/NNG,24,0.38211242303664494,Dovish
11,26,상장주식/NNG,37,0.614319203189683,Dovish
8,18, 잠그/VV,26,0.6453454255730003,Dovish
10,20, 정진/NNG,30,0.7260136037696254,Dovish
20,45, 휩쓸리/VV,65,0.6453454255730003,Dovish
8,20, 위법성/NNG,28,0.5808108830157003,Dovish
8,19, 일회용비밀번호/NNG,27,0.6113798768586319,Dovish
21,54,년대말/NNG,75,0.5646772473763753,Dovish
7,23, 일으킨다/VV,30,0.441921324033685,Dovish
18,58,여전/NNG,76,0.45062913337425026,Dovish
4,12, 정책/NNG;압박/NNG,16,0.4840090691797502,Dovish
7,18,여기저기/NNG,25,0.5646772473763753,Dovish
7,20, 간다며/VV,27,0.5082095226387378,Dovish
5,12,방지/NNG,17,0.6050113364746877,Dovish
4,12,마땅히/MAG,16,0.4840090691797502,Dovish
17,33,집권당/NNG,50,0.7480140160050687,Dovish
4,15, 끌기/NNG,19,0.3872072553438002,Dovish
6,14, 나타날까/VV,20,0.622297374659679,Dovish
3,14, 유가/NNG;많이/MAG;오르/VV,17,0.3111486873298395,Dovish
4,13,단과/NNG,17,0.44677760231976943,Dovish
321,645,고정/NNG,966,0.7226367963102318,Dovish
7,21,끌/VV,28,0.4840090691797503,Dovish
8,17, 독설/NNG,25,0.6833069211949414,Dovish
15,30, 내파/NNG,45,0.7260136037696253,Dovish
26,56, 南/NNG,82,0.6741554892146522,Dovish
7,20, 여직/MAG,27,0.5082095226387378,Dovish
29,56, 자금/NNG;쏟/VV,85,0.751942661047112,Dovish
7,17, 수은주/NNG,24,0.5978935560455738,Dovish
20,65,들/NNG,85,0.44677760231976954,Dovish
4,12, 자금순환동향/NNG,16,0.4840090691797502,Dovish
14,32, 행방/NNG,46,0.6352619032984222,Dovish
13,33,부르/VV,46,0.572010718121523,Dovish
7,22, 주택/NNG;공급/NNG;감소/NNG,29,0.4620086569443071,Dovish
9,22, 공공분양주택/NNG,31,0.5940111303569663,Dovish
7,18, 하락/NNG;부진/NNG,25,0.5646772473763753,Dovish
18,36, 소비자/NNG;자신/NNG,54,0.7260136037696254,Dovish
10,22, 기업/NNG;실적/NNG;부정적/VAX,32,0.6600123670632958,Dovish
149,290, 점쳐진다/VV,439,0.7460415652529253,Dovish
10,21,등급별/NNG,31,0.6914415273996433,Dovish
8,20, 이익/NNG;증대/NNG,28,0.5808108830157003,Dovish
6,12, 집값/NNG;상승/NNG;우려/NNG,18,0.7260136037696254,Dovish
8,18,신디케이트론/NNG,26,0.6453454255730003,Dovish
26,51, 터무니없/VA,77,0.7402491646278533,Dovish
6,14,경쟁국/NNG,20,0.622297374659679,Dovish
11,33, 암진단/NNG,44,0.48400906917975023,Dovish
3,21, 초음파/NNG,24,0.20743245821989298,Dovish
10,32, 병실/NNG,42,0.4537585023560159,Dovish
10,22,가입연령/NNG,32,0.6600123670632958,Dovish
46,105, 공급/NNG;많/VA,151,0.6361262052076717,Dovish
7,17,산업단지공단/NNG,24,0.5978935560455738,Dovish
8,16, 역외/NNG;많/VA,24,0.7260136037696253,Dovish
5,14, 주가연계상품/NNG,19,0.5185811455497324,Dovish
15,38,시니어/NNG,53,0.5731686345549674,Dovish
24,52, 주력상품/NNG,76,0.6701664034796543,Dovish
335,699,출시/NNG,1034,0.6958928677047912,Dovish
69,146, 촬영/NNG,215,0.686232036439783,Dovish
66,133, 곤두박질쳤/VV,199,0.7205548548691018,Dovish
18,46, 수신/NNG;금리/NNG;하락/NNG,64,0.5681845594718807,Dovish
7,27,홍제/NNG,34,0.37645149825091684,Dovish
63,140, 입건/NNG,203,0.6534122433926629,Dovish
276,578,경찰/NNG,854,0.6933555523889849,Dovish
17,49, 담긴다/VV,66,0.5037645413911687,Dovish
125,299, 광장/NNG,424,0.6070347857605564,Dovish
5,13, 금식/NNG,18,0.5584720028997119,Dovish
45,94, 수강/NNG,139,0.695119407864535,Dovish
33,79,이동평균/NNG,112,0.606543010744244,Dovish
343,672,당선/NNG,1015,0.7411388871814926,Dovish
7,14,두드러지/VA,21,0.7260136037696254,Dovish
7,25, 상환능력/NNG;심사/NNG;강화/NNG,32,0.40656761811099024,Dovish
19,38, 강하/VA;경제/NNG;성장/NNG,57,0.7260136037696254,Dovish
49,110, 자금난/NNG;해소/NNG,159,0.6468121197220299,Dovish
10,26, 모자랐/VV,36,0.5584720028997119,Dovish
11,31, 두드렸/VV,42,0.5152354607397341,Dovish
29,57, 은행/NNG;금리/NNG;높/VA,86,0.7387506845375135,Dovish
3,17,배당기준일/NNG,20,0.25624009544810306,Dovish
97,215,세미나/NNG,312,0.6551006471223597,Dovish
28,63,세션/NNG,91,0.6453454255730003,Dovish
18,60,野/NNG,78,0.43560816226177523,Dovish
11,24, 단련/NNG,35,0.6655124701221565,Dovish
29,76, 건의안/NNG,105,0.5540630134031351,Dovish
5,16, 몰아붙이/VV,21,0.4537585023560159,Dovish
23,82, 교섭단체/NNG,105,0.4072759240658874,Dovish
21,46, 대법원장/NNG,67,0.6628819860505275,Dovish
300,644, 원내대표/NNG,944,0.6764101898474771,Dovish
15,42, 특검법/NNG,57,0.5185811455497324,Dovish
15,35,개각/NNG,50,0.6222973746596789,Dovish
34,65, 남구/NNG,99,0.7595219239436083,Dovish
18,88, 국회법/NNG,106,0.29700556517848314,Dovish
6,12, 증권저축/NNG,18,0.7260136037696254,Dovish
5,19, 핵융합/NNG,24,0.38211242303664494,Dovish
12,31,경총/NNG,43,0.5620750480797101,Dovish
7,29, 인사권/NNG,36,0.3504893259577502,Dovish
16,42,농어촌/NNG,58,0.5531532219197145,Dovish
49,94, ecb/NNG;금리/NNG;내리/VV,143,0.7569077996747159,Dovish
3,15, 하락/NNG;채권시장/NNG;강세/NNG,18,0.2904054415078502,Dovish
14,60,보조금/NNG,74,0.3388063484258252,Dovish
6,12,상대방/NNG,18,0.7260136037696254,Dovish
85,186,사건/NNG,271,0.6635608206496576,Dovish
6,25, 바늘/NNG,31,0.34848652980942024,Dovish
15,42,시리즈/NNG,57,0.5185811455497324,Dovish
14,34, 에어버스/NNG,48,0.5978935560455738,Dovish
6,14,우드/NNG,20,0.622297374659679,Dovish
13,32, 솔깃/NNG,45,0.5898860530628207,Dovish
7,18, 섭렵/NNG,25,0.5646772473763753,Dovish
14,28, 금의/NNG,42,0.7260136037696254,Dovish
13,33, 가격/NNG;변동성/NNG;크/VV,46,0.572010718121523,Dovish
5,14, 금리/NNG;스프레드/NNG;줄/VV,19,0.5185811455497324,Dovish
9,33, 세계/NNG;경기/NNG;불안/NNG,42,0.3960074202379775,Dovish
4,16,통관기준/NNG,20,0.36300680188481266,Dovish
4,13,부서장/NNG,17,0.44677760231976943,Dovish
6,15, 최대/NNG;급등/NNG,21,0.5808108830157004,Dovish
28,56, 지수/NNG;내림/NNG,84,0.7260136037696254,Dovish
9,37, 원유/NNG;재고/NNG;늘/VV,46,0.35319580723927724,Dovish
7,14, 지수/NNG;상승/NNG;탄력/NNG;둔화/NNG,21,0.7260136037696254,Dovish
30,60,전기가스업/NNG,90,0.7260136037696253,Dovish
10,27, 밀어붙였/VV,37,0.5377878546441669,Dovish
41,87, 공시가격/NNG,128,0.6842886840127503,Dovish
4,23, 등기부/NNG,27,0.2525264708763914,Dovish
12,46, 속이/VV,58,0.3787897063145872,Dovish
16,35, 경제/NNG;성장/NNG;발목/NNG;잡/VV,51,0.6637838663036575,Dovish
3,15, 재정정책/NNG;한계/NNG,18,0.2904054415078502,Dovish
20,50, 잠재/NNG;성장률/NNG;높/VV,70,0.5808108830157004,Dovish
35,78,마이너스성장/NNG,113,0.6515506700496638,Dovish
5,20, 세계/NNG;경제/NNG;발목/NNG;잡/VV,25,0.3630068018848127,Dovish
9,22,완연/NNG,31,0.5940111303569663,Dovish
77,159, 지표/NNG;금리/NNG;상승/NNG,236,0.7031829872988825,Dovish
66,153,심각/NNG,219,0.6263646777620296,Dovish
28,78,pbr/NNG,106,0.5212405360397311,Dovish
5,13, 채권시장/NNG;금리/NNG;내리/VV,18,0.5584720028997119,Dovish
4,24, 프라임레이트/NNG,28,0.2420045345898751,Dovish
20,48, 금리/NNG;오르/VV;힘들/VA,68,0.6050113364746877,Dovish
8,39, 재정/NNG;투자/NNG;확대/NNG,47,0.2978517348798463,Dovish
5,15, 회복/NNG;강하/VA;않/VX,20,0.48400906917975023,Dovish
9,19, 맨/VV,28,0.687802361465961,Dovish
22,46,전직/NNG,68,0.6944477949100765,Dovish
15,30,양쪽/NNG,45,0.7260136037696253,Dovish
5,20, 매겨진/VV,25,0.3630068018848127,Dovish
25,73,딜/NNG,98,0.49726959162303114,Dovish
9,20, 예상/NNG;밑돌/VV;최저/NNG,29,0.6534122433926629,Dovish
83,177,노후/NNG,260,0.6808941142698182,Dovish
101,196,은퇴/NNG,297,0.7482385100074711,Dovish
24,54,형태/NNG,78,0.6453454255730003,Dovish
13,30,대표기업/NNG,43,0.6292117899336753,Dovish
45,94, 달인/NNG,139,0.695119407864535,Dovish
3,15, 주거/NNG;안정/NNG;강화/NNG,18,0.2904054415078502,Dovish
38,74,상호/NNG,112,0.7456355930606964,Dovish
2,15, fed/NNG;목표/NNG;금리/NNG;인상/NNG,17,0.1936036276719001,Dovish
21,56, 유망업종/NNG,77,0.5445102028272191,Dovish
5,21, 바움/NNG,26,0.34572076369982163,Dovish
11,24, 기명/NNG,35,0.6655124701221565,Dovish
8,20, 기업/NNG;금융/NNG;비용/NNG;부담/NNG,28,0.5808108830157003,Dovish
29,117,분리/NNG,146,0.3599041796464809,Dovish
120,283, 축산/NNG,403,0.6157005827021558,Dovish
4,16,출자금/NNG,20,0.36300680188481266,Dovish
15,30,채권자금/NNG,45,0.7260136037696253,Dovish
26,55, 전망/NNG;낮/VV;잡/VV,81,0.6864128617458277,Dovish
110,214, 전망/NNG;밑돌/VV,324,0.7463691253706429,Dovish
27,54, 안정/NNG;확보/NNG,81,0.7260136037696253,Dovish
9,18, 서머타임/NNG,27,0.7260136037696254,Dovish
16,32, 희소가치/NNG,48,0.7260136037696253,Dovish
15,41,관심사/NNG,56,0.5312294661728967,Dovish
24,66,점유율/NNG,90,0.5280098936506367,Dovish
24,56,돈줄/NNG,80,0.622297374659679,Dovish
41,83, 변칙/NNG,124,0.7172664519169792,Dovish
16,38,파인/NNG,54,0.6113798768586319,Dovish
6,15, 기금법/NNG,21,0.5808108830157004,Dovish
12,32,겨냥/NNG,44,0.5445102028272191,Dovish
24,55, 출범식/NNG,79,0.633611872380764,Dovish
36,77, 게을리/MAG,113,0.6788698632651042,Dovish
5,12, 달러엔/NNG;상승/NNG;확대/NNG,17,0.6050113364746877,Dovish
6,17, 금리/NNG;인상/NNG;절대/MAG;없/VA,23,0.5124801908962061,Dovish
27,56,화재/NNG,83,0.7000845464921388,Dovish
17,50, 왈가왈부/NNG,67,0.49368925056334534,Dovish
17,39, 포식/NNG,56,0.6329349366196735,Dovish
17,38, 눌린/VV,55,0.6495911191622965,Dovish
7,16, 취득자/NNG,23,0.6352619032984222,Dovish
12,44, 스팸/NNG,56,0.3960074202379775,Dovish
24,56, 성토/NNG,80,0.622297374659679,Dovish
6,14,취소/NNG,20,0.622297374659679,Dovish
10,23,대인/NNG,33,0.6313161771909785,Dovish
5,11, 나무랄/VV,16,0.6600123670632958,Dovish
6,12, 불인/NNG,18,0.7260136037696254,Dovish
184,475, 전환율/NNG,659,0.5624694867099413,Dovish
4,12, 놔라/VV,16,0.4840090691797502,Dovish
12,23, 달아오를/VV,35,0.7575794126291744,Dovish
9,19, 불러들였/VV,28,0.687802361465961,Dovish
12,23, 지수/NNG;상승/NNG;지지/NNG,35,0.7575794126291744,Dovish
7,22,자유무역/NNG,29,0.4620086569443071,Dovish
5,11, 글로브/NNG,16,0.6600123670632958,Dovish
9,20,고속철/NNG,29,0.6534122433926629,Dovish
6,27, 국토연구원/NNG,33,0.32267271278650017,Dovish
23,46,구속/NNG,69,0.7260136037696253,Dovish
34,82, 주심/NNG,116,0.6020600616626163,Dovish
15,30, 강모/NNG,45,0.7260136037696253,Dovish
19,72,조합원/NNG,91,0.38317384643396896,Dovish
5,22, fed/NNG;시장/NNG;친화/NNG,27,0.3300061835316479,Dovish
26,75, 대출/NNG;상환/NNG;부담/NNG,101,0.5033694319469403,Dovish
20,50, 상환/NNG;부담/NNG;크/VV,70,0.5808108830157004,Dovish
4,12,오가/VV,16,0.4840090691797502,Dovish
4,14,유노/NNG,18,0.41486491643978596,Dovish
60,116, 총력전/NNG,176,0.7510485556237504,Dovish
4,13,석유기업/NNG,17,0.44677760231976943,Dovish
13,30,당사자/NNG,43,0.6292117899336753,Dovish
6,34, 유노/NNG,40,0.25624009544810306,Dovish
26,63,손해보험/NNG,89,0.5992493237463574,Dovish
26,85, 실적/NNG;늘/VV,111,0.44414949877671206,Dovish
19,56,단칸지수/NNG,75,0.4926520882722459,Dovish
7,20, 기업단기경제관측조사/NNG,27,0.5082095226387378,Dovish
5,14, 금치/VV,19,0.5185811455497324,Dovish
4,14,멈추/VV,18,0.41486491643978596,Dovish
7,16, 지수/NNG;cac40/NNG;상승/NNG,23,0.6352619032984222,Dovish
8,20,메시/NNG,28,0.5808108830157003,Dovish
6,20,독점/NNG,26,0.43560816226177523,Dovish
2,16, 많/VA;자신/NNG,18,0.18150340094240633,Dovish
47,116, 지표/NNG;실망/NNG,163,0.5883213685719378,Dovish
10,30, 내달리/VV,40,0.48400906917975023,Dovish
48,96,기저효과/NNG,144,0.7260136037696254,Dovish
12,26, 보여줄지/VV,38,0.6701664034796543,Dovish
18,35, 주택담보대출/NNG;억제/NNG,53,0.7467568495916148,Dovish
49,121, 파탄/NNG,170,0.5880110179291181,Dovish
13,26,마냥/MAG,39,0.7260136037696254,Dovish
14,37, 우려/NNG;심각/NNG,51,0.5494157001499868,Dovish
14,34, 타격/NNG;주지/NNG;않/VX,48,0.5978935560455738,Dovish
51,146, 승객/NNG,197,0.5072149834554918,Dovish
35,86, 꺼렸/VV,121,0.5909413053938811,Dovish
3,16, 아전/NNG,19,0.27225510141360953,Dovish
10,29, 유상감자/NNG,39,0.5006990370825003,Dovish
35,79, 지표/NNG;둔화/NNG,114,0.6433031932135922,Dovish
15,30, 금시/NNG,45,0.7260136037696253,Dovish
7,15, 포대/NNG,22,0.6776126968516504,Dovish
50,96, 금리/NNG;인상/NNG;기대/NNG;크/VV,146,0.7562641705933597,Dovish
10,20, 고용/NNG;임금/NNG;상승/NNG,30,0.7260136037696254,Dovish
17,35, 구겼/VV,52,0.7052703579476362,Dovish
78,186, 입점/NNG,264,0.6089146354196858,Dovish
35,88, 선납/NNG,123,0.5775108211803839,Dovish
5,11,테러사태/NNG,16,0.6600123670632958,Dovish
45,87,바탕/NNG,132,0.7510485556237504,Dovish
16,59, 펜션/NNG,75,0.3937700901801358,Dovish
3,24, 유니버설보험/NNG,27,0.18150340094240636,Dovish
7,14,수출금액/NNG,21,0.7260136037696254,Dovish
12,29, 수출/NNG;가격/NNG;오르/VV,41,0.6008388444990004,Dovish
5,11, 가격/NNG;상승효과/NNG,16,0.6600123670632958,Dovish
23,73,근무/NNG,96,0.4574880242931886,Dovish
63,125,잠재성/NNG,188,0.7318217125997825,Dovish
5,12, 교역/NNG;신장/NNG,17,0.6050113364746877,Dovish
34,84,문구/NNG,118,0.5877252982896968,Dovish
7,14, 강하/VA;충격/NNG,21,0.7260136037696254,Dovish
44,97,수장/NNG,141,0.6586515168219282,Dovish
9,21, 물리치/VV,30,0.6222973746596789,Dovish
19,51,공인중개사/NNG,70,0.540951312612662,Dovish
19,41,안보/NNG,60,0.6728906571523358,Dovish
103,213, 朴/NNG,316,0.7021540017678067,Dovish
20,53, 수사관/NNG,73,0.5479347952978305,Dovish
19,41, 하락/NNG;접/VV;상승/NNG,60,0.6728906571523358,Dovish
18,35, 구매/NNG;늘/VV,53,0.7467568495916148,Dovish
5,19, 환테크/NNG,24,0.38211242303664494,Dovish
20,58, 알아본다/VV,78,0.5006990370825003,Dovish
62,127,외화예금/NNG,189,0.7088636761215241,Dovish
14,27, 환위험/NNG;줄/VV,41,0.7529029965018337,Dovish
14,27, 거시/NNG;지표/NNG;개선/NNG,41,0.7529029965018337,Dovish
5,12, 부동산/NNG;가격/NNG;상승/NNG;막/VV,17,0.6050113364746877,Dovish
10,20, 수출기업/NNG;실적/NNG;개선/NNG,30,0.7260136037696254,Dovish
16,34,힘들/VA,50,0.6833069211949414,Dovish
26,51, 은행/NNG;금리/NNG;오르/VV,77,0.7402491646278533,Dovish
18,40, 돈/NNG;빠지/VV,58,0.6534122433926629,Dovish
5,22, 금리/NNG;인하/NNG;효과/NNG;없/VA,27,0.3300061835316479,Dovish
12,26, 샘/NNG,38,0.6701664034796543,Dovish
50,99, 끊겼/VV,149,0.7333470745147731,Dovish
7,14, 지역인/NNG,21,0.7260136037696254,Dovish
5,12, 소비구조/NNG,17,0.6050113364746877,Dovish
4,13, 주택거래신고지역/NNG,17,0.44677760231976943,Dovish
17,51, 엄단/NNG,68,0.4840090691797503,Dovish
3,13, 돌고래/NNG,16,0.33508320173982714,Dovish
7,14, 짓밟/VV,21,0.7260136037696254,Dovish
6,18, 섬나라/NNG,24,0.4840090691797503,Dovish
18,42,여유/NNG,60,0.6222973746596789,Dovish
24,50,연정/NNG,74,0.6969730596188405,Dovish
9,21,모르/VV,30,0.6222973746596789,Dovish
48,99, 소년/NNG,147,0.7040131915341822,Dovish
11,24, 개탄/NNG,35,0.6655124701221565,Dovish
37,103, 부동산/NNG;살/VV,140,0.5216020065917698,Dovish
5,13,각료/NNG,18,0.5584720028997119,Dovish
21,48, 찼/VV,69,0.6352619032984221,Dovish
28,65, 돼야만/XSV,93,0.6254886432476773,Dovish
5,13, 탁/NNG,18,0.5584720028997119,Dovish
121,258, 찬성표/NNG,379,0.6809895043110439,Dovish
95,196,투표/NNG,291,0.7037886975317797,Dovish
25,61,국토연구원/NNG,86,0.5950931178439552,Dovish
64,131, 구청/NNG,195,0.7093873380344431,Dovish
20,42, 선거전/NNG,62,0.6914415273996433,Dovish
8,19,약발/NNG,27,0.6113798768586319,Dovish
7,22, 구기/VV,29,0.4620086569443071,Dovish
16,41,개헌/NNG,57,0.5666447639177564,Dovish
15,33, 천국/NNG,48,0.6600123670632958,Dovish
23,58, 지옥/NNG,81,0.5758038926448753,Dovish
4,15,액면가/NNG,19,0.3872072553438002,Dovish
8,42, 꼽혀왔/VV,50,0.27657661095985725,Dovish
31,65,센/NNG,96,0.6925052835956428,Dovish
3,14, 품위/NNG,17,0.3111486873298395,Dovish
5,12, 이만저만/MAG,17,0.6050113364746877,Dovish
6,26, 가계/NNG;부채/NNG;잡/VV,32,0.33508320173982714,Dovish
4,17,탈세/NNG,21,0.3416534605974707,Dovish
5,13,부정/NNG,18,0.5584720028997119,Dovish
14,28, 해라/XSV,42,0.7260136037696254,Dovish
31,69, 깔렸/VV,100,0.6523600497640113,Dovish
50,100, 폭리/NNG,150,0.7260136037696254,Dovish
6,13,끊임없이/MAG,19,0.6701664034796543,Dovish
7,20, 뭉치/VV,27,0.5082095226387378,Dovish
57,114,재벌/NNG,171,0.7260136037696253,Dovish
78,154,선진/NNG,232,0.7354423518705296,Dovish
30,58,합리적/VAX,88,0.7510485556237504,Dovish
6,12, 부닥쳐/VV,18,0.7260136037696254,Dovish
19,40, 접대비/NNG,59,0.6897129235811441,Dovish
19,45,약간/MAG,64,0.6130781542943504,Dovish
12,65,인내심/NNG,77,0.26806656139186175,Dovish
31,61, 예상/NNG;늦/VA,92,0.7379154661265046,Dovish
24,49,시설자금/NNG,73,0.7111969996110616,Dovish
46,92, 망라/NNG,138,0.7260136037696253,Dovish
7,16, 벤더/NNG,23,0.6352619032984222,Dovish
17,48,전액/NNG,65,0.5142596360034847,Dovish
14,35,고소득/NNG,49,0.5808108830157003,Dovish
23,51, 뼈아프/VA,74,0.6548357994784856,Dovish
24,46, 낙하산/NNG,70,0.7575794126291744,Dovish
7,14, 밥통/NNG,21,0.7260136037696254,Dovish
10,34, 경기/NNG;회복/NNG;늦/VA,44,0.42706682574683846,Dovish
6,14, 국고채/NNG;금리/NNG;웃돌/VV,20,0.622297374659679,Dovish
13,25, 중압감/NNG,38,0.7550541479204105,Dovish
5,14, 구긴/VV,19,0.5185811455497324,Dovish
4,19, 내수/NNG;회복/NNG;더디/VA,23,0.30568993842931597,Dovish
10,27, 통화정책/NNG;위험/NNG,37,0.5377878546441669,Dovish
12,28, 환경/NNG;금리/NNG;인상/NNG,40,0.622297374659679,Dovish
9,24, 공급책/NNG,33,0.5445102028272191,Dovish
40,79,사안/NNG,119,0.7352036493869625,Dovish
12,26, 순공/NNG,38,0.6701664034796543,Dovish
48,99,가능/NNG,147,0.7040131915341822,Dovish
19,53,역전폭/NNG,72,0.520538055532939,Dovish
4,26, 수신자금/NNG,30,0.22338880115988471,Dovish
14,29, 둔다고/VV,43,0.7009786519155004,Dovish
12,28,장사/NNG,40,0.622297374659679,Dovish
11,47,보좌관/NNG,58,0.3398361549559949,Dovish
10,22, 선봉장/NNG,32,0.6600123670632958,Dovish
5,21, 고쳤/VV,26,0.34572076369982163,Dovish
11,22, 외출/NNG,33,0.7260136037696254,Dovish
37,91,수협/NNG,128,0.5903846887796954,Dovish
37,78,표결/NNG,115,0.6887821369096446,Dovish
10,36,정황/NNG,46,0.4033408909831252,Dovish
7,28, 엄정히/MAG,35,0.3630068018848127,Dovish
4,18,긴밀/NNG,22,0.32267271278650017,Dovish
165,365,센터/NNG,530,0.6563958609424011,Dovish
71,169,ftse/NNG,240,0.6100232647058391,Dovish
6,23, 세계/NNG;경제/NNG;악영향/NNG,29,0.3787897063145872,Dovish
35,98,집행/NNG,133,0.5185811455497324,Dovish
6,14, 주식매수청구권/NNG,20,0.622297374659679,Dovish
8,16, 순이자마진/NNG;낮/VA,24,0.7260136037696253,Dovish
17,37, 받쳤/VV,54,0.6671476358964126,Dovish
29,58,저항선/NNG,87,0.7260136037696254,Dovish
6,12,가격대/NNG,18,0.7260136037696254,Dovish
29,72, 농구/NNG,101,0.5848442919255316,Dovish
60,123,정규/NNG,183,0.7083059548971955,Dovish
43,83, 꼴찌/NNG,126,0.7522550593275636,Dovish
2,16, 플레이오프/NNG,18,0.18150340094240633,Dovish
23,46,초청/NNG,69,0.7260136037696253,Dovish
153,322,기금/NNG,475,0.6899383936444267,Dovish
22,48, 세계/NNG;경제/NNG;성장률/NNG;둔화/NNG,70,0.6655124701221565,Dovish
5,18, 실적/NNG;매우/MAG;좋/VA,23,0.4033408909831252,Dovish
4,22, 금융시장/NNG;불확실성/NNG;증대/NNG,26,0.26400494682531833,Dovish
9,27, 자금/NNG;일시적/VAX,36,0.4840090691797503,Dovish
9,27, 세계/NNG;경제/NNG;타격/NNG,36,0.4840090691797503,Dovish
9,22, 국제/NNG;금융시장/NNG;불확실성/NNG;크/VV,31,0.5940111303569663,Dovish
35,72,일련/NNG,107,0.7058465592204692,Dovish
12,27, 경제/NNG;불안/NNG;확산/NNG,39,0.6453454255730003,Dovish
23,49,러셀/NNG,72,0.681563791293934,Dovish
18,103, 크림/NNG,121,0.25375232753113125,Dovish
14,37,세운/VV,51,0.5494157001499868,Dovish
25,59, 왕립/NNG,84,0.6152657659064623,Dovish
12,52, 수출보험/NNG,64,0.33508320173982714,Dovish
11,27, 타당성조사/NNG,38,0.5915666401085836,Dovish
39,113,국토/NNG,152,0.5011421335754936,Dovish
6,17,탄생/NNG,23,0.5124801908962061,Dovish
40,117, 고용/NNG;지표/NNG;긍정적/VAX,157,0.4964195581330772,Dovish
7,14, 그리/MAG;심각/NNG;않/VX,21,0.7260136037696254,Dovish
6,22, 입지규제/NNG,28,0.3960074202379775,Dovish
27,62, 미혼/NNG,89,0.6323344290896737,Dovish
10,31, 혼수/NNG,41,0.46839587339975836,Dovish
10,21, 피고/NNG,31,0.6914415273996433,Dovish
16,35, 페이퍼컴퍼니/NNG,51,0.6637838663036575,Dovish
12,39, 판시/NNG,51,0.4467776023197695,Dovish
11,39, 삿/NNG,50,0.4095461354597887,Dovish
26,51,만성/NNG,77,0.7402491646278533,Dovish
28,65, 지표/NNG;fed/NNG;금리/NNG;인상/NNG,93,0.6254886432476773,Dovish
3,16, 평가전/NNG,19,0.27225510141360953,Dovish
29,68, 보건의료/NNG,97,0.6192468973329157,Dovish
38,146,朴/NNG,184,0.3779248896335037,Dovish
4,15, 차제/NNG,19,0.3872072553438002,Dovish
19,52,상임/NNG,71,0.5305484027547263,Dovish
6,15,比/NNG,21,0.5808108830157004,Dovish
11,23,축산/NNG,34,0.6944477949100765,Dovish
21,43, 전략회의/NNG,64,0.7091295664726573,Dovish
54,106, 정무/NNG,160,0.7397119736520712,Dovish
34,71, 직속/NNG,105,0.69533697262443,Dovish
13,26, 우편물/NNG,39,0.7260136037696254,Dovish
24,46, 인상/NNG;미루/VV,70,0.7575794126291744,Dovish
5,13, 보살피/VV,18,0.5584720028997119,Dovish
23,44, 임원회의/NNG,67,0.7590142221227901,Dovish
3,14, 샅바/NNG,17,0.3111486873298395,Dovish
6,26, 해묵/NNG,32,0.33508320173982714,Dovish
25,73, 순이익/NNG;넘/VV,98,0.49726959162303114,Dovish
6,19,충당금전입액/NNG,25,0.458534907643974,Dovish
10,30,배드뱅크/NNG,40,0.48400906917975023,Dovish
10,22, 지분매각이익/NNG,32,0.6600123670632958,Dovish
8,16, 위험/NNG;매우/MAG;높/VA,24,0.7260136037696253,Dovish
16,41, 심리/NNG;냉각/NNG,57,0.5666447639177564,Dovish
8,17, 극빈층/NNG,25,0.6833069211949414,Dovish
4,12, 여중생/NNG,16,0.4840090691797502,Dovish
5,14,날짜/NNG,19,0.5185811455497324,Dovish
15,36,미일/NNG,51,0.6050113364746877,Dovish
110,333,원내대표/NNG,443,0.47964862711506784,Dovish
7,18,휴면예금/NNG,25,0.5646772473763753,Dovish
25,65, 환급액/NNG,90,0.5584720028997119,Dovish
19,45, 수감/NNG,64,0.6130781542943504,Dovish
76,172, 피의자/NNG,248,0.6415934172847853,Dovish
55,165, 해군/NNG,220,0.4840090691797503,Dovish
5,39,해군/NNG,44,0.18615733429990394,Dovish
6,29,자살/NNG,35,0.3004194222495002,Dovish
6,15, 다방/NNG,21,0.5808108830157004,Dovish
12,24, 여종/NNG,36,0.7260136037696254,Dovish
17,44,정확/MAG,61,0.5610105120038015,Dovish
4,19, 강행군/NNG,23,0.30568993842931597,Dovish
21,49, 반열/NNG,70,0.6222973746596789,Dovish
15,30, 오징어/NNG,45,0.7260136037696253,Dovish
5,12, 해태/NNG,17,0.6050113364746877,Dovish
3,14, 철광/NNG,17,0.3111486873298395,Dovish
7,25, 수출/NNG;신장/NNG,32,0.40656761811099024,Dovish
15,38, 신기록/NNG,53,0.5731686345549674,Dovish
11,33, 랭킹/NNG,44,0.48400906917975023,Dovish
9,20, 시가배당/NNG,29,0.6534122433926629,Dovish
15,34, 準/NNG,49,0.6406002386202576,Dovish
11,26, 금리/NNG;오르/VV;좋/VA,37,0.614319203189683,Dovish
20,56,정작/NNG,76,0.5185811455497324,Dovish
22,60, 시속/NNG,82,0.5324099760977252,Dovish
18,56, 서쪽/NNG,74,0.46672303099475926,Dovish
7,14, 통화/NNG;증가율/NNG;하락/NNG,21,0.7260136037696254,Dovish
57,115,국민주택기금/NNG,172,0.7197004419977157,Dovish
40,101, 서민주택/NNG,141,0.5750602802135647,Dovish
71,148,연소득/NNG,219,0.696580619833019,Dovish
18,37, 대출/NNG;쉽/VA,55,0.7063916144785545,Dovish
28,58,대출채권/NNG,86,0.7009786519155004,Dovish
12,25,이차보전/NNG,37,0.6969730596188405,Dovish
14,37,농어/NNG,51,0.5494157001499868,Dovish
11,41, 연한/NNG,52,0.38956827519345755,Dovish
14,33, 주택담보대출/NNG;줄/VV,47,0.6160115425924094,Dovish
29,63, 대출/NNG;넘/VV,92,0.6683934764863217,Dovish
26,60, 최대/NNG;넘/VV,86,0.6292117899336753,Dovish
26,55, 일침/NNG,81,0.6864128617458277,Dovish
123,284, 꽁꽁/MAG,407,0.6288709384765065,Dovish
91,193, 금리/NNG;밑돌/VV,284,0.6846345900832737,Dovish
8,17,매수기회/NNG,25,0.6833069211949414,Dovish
6,15, 형성기/NNG,21,0.5808108830157004,Dovish
5,13, 일본식/NNG;거품/NNG,18,0.5584720028997119,Dovish
13,28, 변동성/NNG;크/VV;우려/NNG,41,0.6741554892146522,Dovish
5,19, 부동산/NNG;경기/NNG;상승/NNG,24,0.38211242303664494,Dovish
223,532,자금시장/NNG,755,0.6086505024083702,Dovish
11,26, 전광판/NNG,37,0.614319203189683,Dovish
117,272,부양책/NNG,389,0.6245852326547512,Dovish
26,50, 경제/NNG;성장률/NNG;최저/NNG,76,0.7550541479204105,Dovish
22,49, 경제/NNG;성장률/NNG;회복/NNG,71,0.6519305829768064,Dovish
4,26, 밝혀냈/VV,30,0.22338880115988471,Dovish
59,125, 숨진/VV,184,0.6853568419585263,Dovish
26,55,장도/NNG,81,0.6864128617458277,Dovish
2,16,상장법인/NNG,18,0.18150340094240633,Dovish
15,50, 항생/NNG,65,0.43560816226177523,Dovish
39,97, 프라이빗/NNG,136,0.5838047535467091,Dovish
6,30, 부조/NNG,36,0.2904054415078502,Dovish
9,29, 매듭짓/VV,38,0.45062913337425026,Dovish
31,65,투자신탁/NNG,96,0.6925052835956428,Dovish
1465,2815,전문/NNG,4280,0.755673129323269,Dovish
96,252,명목/NNG,348,0.5531532219197146,Dovish
37,82, 표본/NNG,119,0.6551830082799059,Dovish
59,121,모델/NNG,180,0.708013266486081,Dovish
4,12, 주택보급률/NNG;넘/VV,16,0.4840090691797502,Dovish
48,95, 지수/NNG;낮/VA,143,0.7336558522303583,Dovish
9,21, 최전선/NNG,30,0.6222973746596789,Dovish
2,14, 편집국장/NNG,16,0.20743245821989298,Dovish
95,193,국책은행/NNG,288,0.7147284182188023,Dovish
5,11, 식과/NNG,16,0.6600123670632958,Dovish
8,20, 유통주식수/NNG,28,0.5808108830157003,Dovish
2,18,파생결합상품/NNG,20,0.16133635639325009,Dovish
6,18, 농업진흥지역/NNG,24,0.4840090691797503,Dovish
19,60,특위/NNG,79,0.45980861572076276,Dovish
47,116, 연면적/NNG,163,0.5883213685719378,Dovish
13,35, 산책로/NNG,48,0.5393243913717217,Dovish
13,35, 개축/NNG,48,0.5393243913717217,Dovish
74,175, 원스톱/NNG,249,0.6140000763308832,Dovish
4,36, 기업/NNG;자금난/NNG;해소/NNG,40,0.16133635639325009,Dovish
21,58, 짓누를/VV,79,0.5257339889366253,Dovish
5,11, 이익/NNG;모멘텀/NNG;회복/NNG,16,0.6600123670632958,Dovish
5,19, 사기/VV,24,0.38211242303664494,Dovish
118,563, 빌라/NNG,681,0.3043325230721698,Dovish
10,42, 품종/NNG,52,0.34572076369982163,Dovish
2,14, 딸기/NNG,16,0.20743245821989298,Dovish
7,20, 원예/NNG,27,0.5082095226387378,Dovish
11,24,육성/NNG,35,0.6655124701221565,Dovish
8,26, 수출/NNG;부정적/VAX;영향/NNG;줄/VV,34,0.44677760231976943,Dovish
13,30, 재산소득/NNG,43,0.6292117899336753,Dovish
45,93, 소득/NNG;낮/VA,138,0.7025938100996374,Dovish
19,51,영/NNG,70,0.540951312612662,Dovish
6,25, 금융시장/NNG;변동성/NNG;증가/NNG,31,0.34848652980942024,Dovish
3,13, gdp/NNG;떨어/VV,16,0.33508320173982714,Dovish
7,20, 경제/NNG;장기/NNG;저성장/NNG,27,0.5082095226387378,Dovish
7,18, 목청/NNG,25,0.5646772473763753,Dovish
18,62,플랜/NNG,80,0.42155628605978257,Dovish
23,62,커뮤니케이션/NNG,85,0.5386552544097221,Dovish
39,84,소형주/NNG,123,0.6741554892146522,Dovish
20,43, 러셀지수/NNG,63,0.6753614918787213,Dovish
44,93,지점장/NNG,137,0.6869806143196454,Dovish
15,33, 가계/NNG;대출/NNG;줄/VV,48,0.6600123670632958,Dovish
39,76, 신용/NNG;낮/VA,115,0.7451192249214577,Dovish
13,34, 국교/NNG,47,0.55518687347089,Dovish
6,23, 쿠르/MAG,29,0.3787897063145872,Dovish
15,30,북/NNG,45,0.7260136037696253,Dovish
8,22, 풍속/NNG,30,0.5280098936506367,Dovish
7,14, 송두리/NNG,21,0.7260136037696254,Dovish
20,56, 추진단/NNG,76,0.5185811455497324,Dovish
4,12, 약분/NNG,16,0.4840090691797502,Dovish
53,118,지사/NNG,171,0.6521817118608499,Dovish
18,38, 항공편/NNG,56,0.687802361465961,Dovish
7,14,국공립/NNG,21,0.7260136037696254,Dovish
5,24, 도로는/NNG,29,0.30250566823734387,Dovish
5,16, 끊길/VV,21,0.4537585023560159,Dovish
6,15, 자금/NNG;운용/NNG;어렵/VA,21,0.5808108830157004,Dovish
4,12, 주택담보대출/NNG;막/VV,16,0.4840090691797502,Dovish
4,15, 마키/NNG,19,0.3872072553438002,Dovish
34,82, 백서/NNG,116,0.6020600616626163,Dovish
6,12,외견상/NNG,18,0.7260136037696254,Dovish
1,18, 토지공개념/NNG,19,0.08066817819662504,Dovish
5,11, 오럴/NNG,16,0.6600123670632958,Dovish
21,46,기타법인/NNG,67,0.6628819860505275,Dovish
57,109, 강당/NNG,166,0.759316980089333,Dovish
14,33, 자매/NNG,47,0.6160115425924094,Dovish
5,14, 취약/NNG;경고/NNG,19,0.5185811455497324,Dovish
6,15, 불러온다/VV,21,0.5808108830157004,Dovish
5,17,고발/NNG,22,0.42706682574683846,Dovish
28,54, 지점수/NNG,82,0.7529029965018337,Dovish
5,13, 하방/NNG;경직/NNG;높/VV,18,0.5584720028997119,Dovish
20,40, 女/NNG,60,0.7260136037696254,Dovish
5,11, 피처/NNG,16,0.6600123670632958,Dovish
4,12,후계자/NNG,16,0.4840090691797502,Dovish
12,43, 내외/NNG;금리갭/NNG;줄/VV,55,0.4052168951272328,Dovish
7,24,협조/NNG,31,0.42350793553228144,Dovish
1,19, 벌어/VV,20,0.07642248460732899,Dovish
40,87,통일/NNG,127,0.6675987161100003,Dovish
5,13, 정치권력/NNG,18,0.5584720028997119,Dovish
19,37, 진원/NNG,56,0.7456355930606964,Dovish
8,16, 경기/NNG;침체/NNG;탈출/NNG,24,0.7260136037696253,Dovish
22,60, 결혼자금/NNG,82,0.5324099760977252,Dovish
15,44, 기대/NNG;힘입/VV;상승/NNG,59,0.49500927529747185,Dovish
11,40, 도매시장/NNG,51,0.3993074820732939,Dovish
115,261,미분양/NNG,376,0.6397821029387503,Dovish
5,13, 건설/NNG;줄/VV,18,0.5584720028997119,Dovish
13,26, 투자/NNG;매력/NNG;크/VV,39,0.7260136037696254,Dovish
13,25, gdp/NNG;성장률/NNG;높/VA,38,0.7550541479204105,Dovish
8,16,순조/NNG,24,0.7260136037696253,Dovish
4,12,매도포지션/NNG,16,0.4840090691797502,Dovish
18,40, 벌인다고/VV,58,0.6534122433926629,Dovish
13,63, cd/NNG;금리/NNG;떨어/VV,76,0.2996246618731787,Dovish
23,68, 후분양제/NNG,91,0.49112684960886416,Dovish
5,11, 부동산/NNG;많/VA,16,0.6600123670632958,Dovish
17,35, 밀월/NNG,52,0.7052703579476362,Dovish
6,12,혹자/NNG,18,0.7260136037696254,Dovish
6,16, 때려/VV,22,0.5445102028272191,Dovish
10,23, 경륜/NNG,33,0.6313161771909785,Dovish
7,19,후임자/NNG,26,0.5349573922513029,Dovish
13,31, 가격/NNG;과도/NNG,44,0.6089146354196858,Dovish
11,23, 경제/NNG;성장/NNG;금리/NNG;인상/NNG,34,0.6944477949100765,Dovish
8,26, 천당/NNG,34,0.44677760231976943,Dovish
68,136, 상환금/NNG,204,0.7260136037696254,Dovish
28,80,낙관론/NNG,108,0.5082095226387378,Dovish
32,65, 굽히/VV,97,0.7148441637116312,Dovish
7,14, 연기론/NNG,21,0.7260136037696254,Dovish
20,47, 원은/NNG,67,0.6178839181018089,Dovish
27,67, 가로챈/VV,94,0.5851452925904443,Dovish
5,16, 송장/NNG,21,0.4537585023560159,Dovish
9,20, 원유/NNG;재고/NNG;예상/NNG;작/VA,29,0.6534122433926629,Dovish
4,13, 예상/NNG;작/VA;감소/NNG,17,0.44677760231976943,Dovish
9,18, 부진/NNG;실망/NNG,27,0.7260136037696254,Dovish
18,38, 이뤄낼/VV,56,0.687802361465961,Dovish
30,59, 관악/NNG,89,0.7383189190877547,Dovish
7,16,회원권/NNG,23,0.6352619032984222,Dovish
8,21, 주택시장/NNG;활황/NNG,29,0.5531532219197145,Dovish
11,24,보완/NNG,35,0.6655124701221565,Dovish
11,34, 난이/NNG,45,0.46977350832152226,Dovish
15,36, 타격/NNG;받/VV;없/VA,51,0.6050113364746877,Dovish
6,12, 불청객/NNG,18,0.7260136037696254,Dovish
25,63, 가쁘/VA,88,0.576201272833036,Dovish
24,74, 지역민/NNG,98,0.47092774298570295,Dovish
10,31, 하락/NNG;딛/VV;상승/NNG,41,0.46839587339975836,Dovish
15,41,전혀/MAG,56,0.5312294661728967,Dovish
76,182, 지표/NNG;금리/NNG;하락/NNG,258,0.6063410317196872,Dovish
9,21, 정규시장/NNG,30,0.6222973746596789,Dovish
7,14, 주력기업/NNG,21,0.7260136037696254,Dovish
19,38, 연기금투자풀/NNG,57,0.7260136037696254,Dovish
5,13, 인심/NNG,18,0.5584720028997119,Dovish
24,47,고액/NNG,71,0.7414607017221707,Dovish
15,34, 판매망/NNG,49,0.6406002386202576,Dovish
13,26, 받아들여진/VV,39,0.7260136037696254,Dovish
7,17, 국채/NNG;수요/NNG;줄/VV,24,0.5978935560455738,Dovish
11,38, 국채/NNG;수익률/NNG;상승/NNG;압력/NNG,49,0.42032366534030946,Dovish
15,32,자발/NNG,47,0.6806377535340238,Dovish
9,24, 고지의무/NNG,33,0.5445102028272191,Dovish
12,27,페그제/NNG,39,0.6453454255730003,Dovish
20,40,바스켓/NNG,60,0.7260136037696254,Dovish
10,20, 가격/NNG;부담/NNG;줄/VV,30,0.7260136037696254,Dovish
15,33, 묶였/VV,48,0.6600123670632958,Dovish
32,81,wto/NNG,113,0.5736403782871113,Dovish
20,40, 유학생/NNG,60,0.7260136037696254,Dovish
23,44, 수출/NNG;경쟁력/NNG;떨어/VV,67,0.7590142221227901,Dovish
8,17, 외화자금/NNG;이탈/NNG,25,0.6833069211949414,Dovish
10,26, 최후통첩/NNG,36,0.5584720028997119,Dovish
4,14, 떠넘겨/VV,18,0.41486491643978596,Dovish
18,41, 역과/NNG,59,0.637475359407476,Dovish
15,32, pmi/NNG;호조/NNG,47,0.6806377535340238,Dovish
34,86, 지수/NNG;긍정적/VAX,120,0.5740572680969132,Dovish
6,16, 모기지/NNG;주택담보대출/NNG;금리/NNG;상승/NNG,22,0.5445102028272191,Dovish
27,78,유동화/NNG,105,0.5026248026097406,Dovish
26,52,부실자산/NNG,78,0.7260136037696254,Dovish
20,46, 재예/NNG,66,0.6313161771909785,Dovish
6,12, 달러원/NNG;강하/VA,18,0.7260136037696254,Dovish
10,22, 둔화/NNG;막/VV,32,0.6600123670632958,Dovish
7,17,민/NNG,24,0.5978935560455738,Dovish
12,33, 내디뎠/VV,45,0.5280098936506367,Dovish
126,243,기준환율/NNG,369,0.7529029965018338,Dovish
62,145, 추심/NNG,207,0.6208668059823004,Dovish
12,28, 금리/NNG;그치/VV,40,0.622297374659679,Dovish
21,41, 실적/NNG;타격/NNG,62,0.7437212526420554,Dovish
15,31, 망가진/VV,46,0.7025938100996375,Dovish
14,41, gdp/NNG;성장률/NNG;전망/NNG;하향/NNG,55,0.4958141684280369,Dovish
7,32, 성장/NNG;전망/NNG;낮/VV,39,0.3176309516492111,Dovish
5,17, 축률/NNG,22,0.42706682574683846,Dovish
28,62,최고가/NNG,90,0.6557542227596617,Dovish
7,18,불황국면/NNG,25,0.5646772473763753,Dovish
115,227, 사업자금/NNG,342,0.7356084972115148,Dovish
7,17,재화/NNG,24,0.5978935560455738,Dovish
158,315,공기업/NNG,473,0.7283184088609576,Dovish
44,92,승인/NNG,136,0.6944477949100765,Dovish
40,86, 줄어든다고/VV,126,0.6753614918787213,Dovish
13,26, 민원인/NNG,39,0.7260136037696254,Dovish
35,82,접수/NNG,117,0.6197677105350462,Dovish
101,247,변/NNG,348,0.5937439188723252,Dovish
26,71,입지/NNG,97,0.5317282731833876,Dovish
58,113,저소득/NNG,171,0.7452883012148367,Dovish
7,18, 적잖/VA;타격/NNG,25,0.5646772473763753,Dovish
8,20, 지수/NNG;소폭/MAG;오르/VV,28,0.5808108830157003,Dovish
40,82,막상/MAG,122,0.7083059548971955,Dovish
5,14, 이자/NNG;감소/NNG,19,0.5185811455497324,Dovish
12,26, 취급고/NNG,38,0.6701664034796543,Dovish
11,23,선발/NNG,34,0.6944477949100765,Dovish
15,33,기평/NNG,48,0.6600123670632958,Dovish
9,26, 금리/NNG;스프레드/NNG;축소/NNG,35,0.5026248026097407,Dovish
9,19, 은행/NNG;순이익/NNG;증가/NNG,28,0.687802361465961,Dovish
7,34, 주식매각이익/NNG,41,0.2989467780227869,Dovish
30,103, 중수익/NNG,133,0.42292054588521866,Dovish
30,60,대하/VV,90,0.7260136037696253,Dovish
24,48, 생색내/VV,72,0.7260136037696254,Dovish
7,18, 무역/NNG;적자/NNG;늘/VV,25,0.5646772473763753,Dovish
11,24,錦/NNG,35,0.6655124701221565,Dovish
5,15,견제/NNG,20,0.48400906917975023,Dovish
28,66,전례/NNG,94,0.6160115425924094,Dovish
5,13, 인구통계학/NNG,18,0.5584720028997119,Dovish
2,20, 재가/NNG,22,0.14520272075392507,Dovish
21,44, 싱글/NNG,65,0.6930129854164606,Dovish
16,43,발효/NNG,59,0.540289193502977,Dovish
7,15, 수신/NNG;금리/NNG;낮/VV,22,0.6776126968516504,Dovish
6,15, 축포/NNG,21,0.5808108830157004,Dovish
55,119, 출퇴근/NNG,174,0.6711050118878891,Dovish
22,56,외화자산/NNG,78,0.5704392601047057,Dovish
5,12, 동북아개발은행/NNG,17,0.6050113364746877,Dovish
8,21, 기업/NNG;매출/NNG;감소/NNG,29,0.5531532219197145,Dovish
22,47, 브랜드파워/NNG,69,0.6796723099119898,Dovish
4,20,탐/NNG,24,0.29040544150785014,Dovish
4,40,파도/NNG,44,0.14520272075392507,Dovish
3,15, 보호자/NNG,18,0.2904054415078502,Dovish
7,16, 은근/NNG,23,0.6352619032984222,Dovish
7,16, 보듬/VV,23,0.6352619032984222,Dovish
36,74,통계국/NNG,110,0.7063916144785545,Dovish
4,14,일주일/NNG,18,0.41486491643978596,Dovish
16,59, 백기/NNG,75,0.3937700901801358,Dovish
10,32, 거르/VV,42,0.4537585023560159,Dovish
23,46, 매매이익/NNG,69,0.7260136037696253,Dovish
31,84, 명예퇴직/NNG,115,0.5358671837347235,Dovish
24,53,움직이/VV,77,0.6575217543573967,Dovish
16,31,그날/NNG,47,0.7494333974396133,Dovish
20,47, 경사/NNG,67,0.6178839181018089,Dovish
13,32,서로/NNG,45,0.5898860530628207,Dovish
37,77,홈/NNG,114,0.6977273594669127,Dovish
6,43, 고용/NNG;비용/NNG;지수/NNG;상승/NNG,49,0.2026084475636164,Dovish
18,39,가트/NNG,57,0.6701664034796543,Dovish
12,27, 지표/NNG;우려/NNG,39,0.6453454255730003,Dovish
18,43, 비위/NNG,61,0.6078253426908492,Dovish
13,29, 롤러/NNG,42,0.6509087482072504,Dovish
40,94,부동산펀드/NNG,134,0.6178839181018089,Dovish
30,67, 순회/NNG,97,0.6501614362116048,Dovish
24,51, 사죄/NNG,75,0.6833069211949415,Dovish
6,13, 해외/NNG;투자/NNG;촉진/NNG,19,0.6701664034796543,Dovish
16,34, 산업/NNG;생산/NNG;줄/VV,50,0.6833069211949414,Dovish
5,12,무더기/NNG,17,0.6050113364746877,Dovish
6,16, 전망/NNG;호전/NNG,22,0.5445102028272191,Dovish
15,31, 나도/VV,46,0.7025938100996375,Dovish
21,52, 국왕/NNG,73,0.5863956030446974,Dovish
8,20,유도/NNG,28,0.5808108830157003,Dovish
6,16,잔디/NNG,22,0.5445102028272191,Dovish
12,36, 뇌졸중/NNG,48,0.4840090691797503,Dovish
14,32,운/NNG,46,0.6352619032984222,Dovish
15,32, 지수/NNG;최대/NNG,47,0.6806377535340238,Dovish
6,12, 지수/NNG;시장/NNG;예상/NNG;웃돌/VV,18,0.7260136037696254,Dovish
28,55,수지/NNG,83,0.7392138511108913,Dovish
15,45, gdp/NNG;성장률/NNG;낮/VA,60,0.48400906917975023,Dovish
6,25, 구매/NNG;확대/NNG,31,0.34848652980942024,Dovish
20,68,로스/NNG,88,0.42706682574683846,Dovish
5,14, 풍향계/NNG,19,0.5185811455497324,Dovish
46,107, 대출/NNG;금리/NNG;최대/NNG,153,0.6242359957645377,Dovish
5,11, 소득/NNG;넘/VV;않/VX,16,0.6600123670632958,Dovish
24,46, 원리금균등상환방식/NNG,70,0.7575794126291744,Dovish
26,66,라인/NNG,92,0.572010718121523,Dovish
26,59, 꿀/VV,85,0.6398763965427208,Dovish
33,69,설상가상/NNG,102,0.6944477949100764,Dovish
12,28,기한/NNG,40,0.622297374659679,Dovish
9,18, 거금/NNG,27,0.7260136037696254,Dovish
5,18, 자산/NNG;비중/NNG;늘/VV,23,0.4033408909831252,Dovish
27,87,활용/NNG,114,0.45062913337425026,Dovish
34,73, 복선/NNG,107,0.6762866446073224,Dovish
28,60,일대/NNG,88,0.6776126968516504,Dovish
29,64, 통치/NNG,93,0.657949828416223,Dovish
8,30, 신흥시장/NNG;강세/NNG,38,0.3872072553438002,Dovish
14,30, 징구/NNG,44,0.6776126968516504,Dovish
10,33, 물가/NNG;상승률/NNG;그치/VV,43,0.44000824470886385,Dovish
16,39,미니/NNG,55,0.5957034697596926,Dovish
16,41,구용/NNG,57,0.5666447639177564,Dovish
13,35, 핏/NNG,48,0.5393243913717217,Dovish
7,15,완벽/NNG,22,0.6776126968516504,Dovish
73,237,대공황/NNG,310,0.44724888671040214,Dovish
7,14,국왕/NNG,21,0.7260136037696254,Dovish
11,22,대체에너지/NNG,33,0.7260136037696254,Dovish
24,50,대거/MAG,74,0.6969730596188405,Dovish
16,43,참/MAG,59,0.540289193502977,Dovish
7,15, 급조/NNG,22,0.6776126968516504,Dovish
23,50,실패/NNG,73,0.6679325154680553,Dovish
30,70,부작용/NNG,100,0.6222973746596789,Dovish
26,51, 지수/NNG;하락/NNG;막/VV,77,0.7402491646278533,Dovish
4,14, 관찰자/NNG,18,0.41486491643978596,Dovish
10,22, 다큐멘터리/NNG,32,0.6600123670632958,Dovish
38,79,홍익/NNG,117,0.6984434669176144,Dovish
5,18,초보/NNG,23,0.4033408909831252,Dovish
16,35,산출/NNG,51,0.6637838663036575,Dovish
6,14, 저평가주식/NNG,20,0.622297374659679,Dovish
7,15, 공급/NNG;안정/NNG,22,0.6776126968516504,Dovish
69,149, 구청장/NNG,218,0.6724152840282438,Dovish
32,104, 성폭력/NNG,136,0.44677760231976943,Dovish
4,12, 가출/NNG,16,0.4840090691797502,Dovish
20,53, 기대/NNG;많/VA,73,0.5479347952978305,Dovish
5,23, 투자상담사/NNG,28,0.3156580885954893,Dovish
210,553, 安/NNG,763,0.5514027370402218,Dovish
42,90,보장/NNG,132,0.6776126968516504,Dovish
15,32, 순이익/NNG;예상/NNG;웃돌/VV,47,0.6806377535340238,Dovish
10,24, 호전/NNG;추세/NNG,34,0.6050113364746877,Dovish
78,163,일제히/MAG,241,0.6948351054482305,Dovish
37,82, 늪/NNG;빠지/VV,119,0.6551830082799059,Dovish
11,22, 경제/NNG;회복/NNG;발목/NNG;잡/VV,33,0.7260136037696254,Dovish
5,11, 경제/NNG;회복/NNG;더디/VV,16,0.6600123670632958,Dovish
8,16, 외부충격/NNG;흡수/NNG,24,0.7260136037696253,Dovish
68,146, 잃어버린10년/NNG,214,0.6762866446073224,Dovish
9,22,대차거래/NNG,31,0.5940111303569663,Dovish
6,21,발레/NNG,27,0.41486491643978596,Dovish
5,19, 추락/NNG;최저/NNG,24,0.38211242303664494,Dovish
3,15,래스/NNG,18,0.2904054415078502,Dovish
5,20, 질렀/VV,25,0.3630068018848127,Dovish
9,22, 속전속결/NNG,31,0.5940111303569663,Dovish
4,14,한번/MAG,18,0.41486491643978596,Dovish
20,44, 파산/NNG;위험/NNG,64,0.6600123670632958,Dovish
9,25, 드레스/NNG,34,0.5227297947141304,Dovish
56,112, 파인/NNG,168,0.7260136037696254,Dovish
9,27,구직/NNG,36,0.4840090691797503,Dovish
12,23, 노동위원회/NNG,35,0.7575794126291744,Dovish
8,20, 맡긴다는/VV,28,0.5808108830157003,Dovish
15,40, 감청/NNG,55,0.544510202827219,Dovish
15,35, 달아오른/VV,50,0.6222973746596789,Dovish
12,25, 복심/NNG,37,0.6969730596188405,Dovish
17,51,의장국/NNG,68,0.4840090691797503,Dovish
329,652,앞선/VV,981,0.7326947105527813,Dovish
5,11, 투자/NNG;살/VV;않/VX,16,0.6600123670632958,Dovish
11,26, 옮/VV,37,0.614319203189683,Dovish
6,16, 죄다/MAG,22,0.5445102028272191,Dovish
24,52, 갈아탄/VV,76,0.6701664034796543,Dovish
8,18, 경기/NNG;완화/NNG,26,0.6453454255730003,Dovish
10,29, 고용/NNG;지표/NNG;예상/NNG;웃돌/VV,39,0.5006990370825003,Dovish
25,49, 내분/NNG,74,0.7408302079281892,Dovish
7,15, 우정/NNG,22,0.6776126968516504,Dovish
7,16, 지표/NNG;저점/NNG,23,0.6352619032984222,Dovish
8,22,깊/VA,30,0.5280098936506367,Dovish
34,79,사무총장/NNG,113,0.6249231019789182,Dovish
5,12, 망쳐/VV,17,0.6050113364746877,Dovish
21,44, 자문회의/NNG,65,0.6930129854164606,Dovish
14,35,정리/NNG,49,0.5808108830157003,Dovish
1,18, 공포/NNG;증폭/NNG,19,0.08066817819662504,Dovish
13,28, 대처/MAG,41,0.6741554892146522,Dovish
16,35, 랜딩/NNG,51,0.6637838663036575,Dovish
218,524,회전율/NNG,742,0.6040876550449555,Dovish
6,12, 투자심리/NNG;좀처럼/MAG;살/VV,18,0.7260136037696254,Dovish
5,13, 균형감/NNG,18,0.5584720028997119,Dovish
17,35, 유가/NNG;충격/NNG,52,0.7052703579476362,Dovish
12,33, 인수계획/NNG,45,0.5280098936506367,Dovish
6,16,빛/NNG,22,0.5445102028272191,Dovish
4,13, 모교/NNG,17,0.44677760231976943,Dovish
17,38, 가히/MAG,55,0.6495911191622965,Dovish
5,14, 명실공히/MAG,19,0.5185811455497324,Dovish
21,49,맞추/VV,70,0.6222973746596789,Dovish
11,27, 경기/NNG;회복/NNG;견조/NNG,38,0.5915666401085836,Dovish
6,12, 정채/NNG,18,0.7260136037696254,Dovish
19,50, 짰/VV,69,0.5517703388649153,Dovish
16,32, 덧붙/VV,48,0.7260136037696253,Dovish
13,38, 관리청/NNG,51,0.49674614994763844,Dovish
10,26, 제휴카드/NNG,36,0.5584720028997119,Dovish
15,34, 다방면/NNG,49,0.6406002386202576,Dovish
8,27, 맞춰왔/VV,35,0.4302302837153335,Dovish
11,35, 업종군/NNG,46,0.4563514080837645,Dovish
5,14, 동간/NNG,19,0.5185811455497324,Dovish
3,13, 경기/NNG;서서히/MAG;살/VV,16,0.33508320173982714,Dovish
8,16,속속/MAG,24,0.7260136037696253,Dovish
6,15,디시/NNG,21,0.5808108830157004,Dovish
17,40, 오간/VV,57,0.6171115632041816,Dovish
12,23,비차익/NNG,35,0.7575794126291744,Dovish
7,22, 경기/NNG;회복/NNG;늦/VV,29,0.4620086569443071,Dovish
10,27, 뒤섞이/VV,37,0.5377878546441669,Dovish
34,91, 경화/NNG,125,0.5425156599597202,Dovish
971,2207,irs/NNG,3178,0.6388393377981934,Dovish
68,202,여론조사/NNG,270,0.48880123818153004,Dovish
8,18, 날자/NNG,26,0.6453454255730003,Dovish
29,88, 관광지/NNG,117,0.4785089661208895,Dovish
10,31, 병영/NNG,41,0.46839587339975836,Dovish
9,27, fed/NNG;경제/NNG;자신/NNG,36,0.4840090691797503,Dovish
35,76,조합/NNG,111,0.6686967403141287,Dovish
14,37, 기대주/NNG,51,0.5494157001499868,Dovish
5,12, 외환시장/NNG;개입/NNG;줄/VV,17,0.6050113364746877,Dovish
8,25, 노동시장/NNG;부진/NNG,33,0.46464870641256023,Dovish
11,26,램/NNG,37,0.614319203189683,Dovish
16,45, 금리/NNG;오르/VV;필요/NNG;없/VA,61,0.5162763404584002,Dovish
122,256,법원/NNG,378,0.6919817160929242,Dovish
7,28, 전금/NNG,35,0.3630068018848127,Dovish
6,27, 화폭/NNG,33,0.32267271278650017,Dovish
8,16, 끝났으며/VV,24,0.7260136037696253,Dovish
15,30, 진의/NNG,45,0.7260136037696253,Dovish
39,84, 우려/NNG;내리/VV,123,0.6741554892146522,Dovish
6,31, 실적/NNG;개선/NNG;기대/NNG;상승/NNG,37,0.28103752403985505,Dovish
6,22, 공포/NNG;완화/NNG,28,0.3960074202379775,Dovish
7,15,장차/MAG,22,0.6776126968516504,Dovish
4,18, 우려/NNG;잠재우/VV;못하/VX,22,0.32267271278650017,Dovish
179,367,역대/NNG,546,0.7082094554482994,Dovish
5,16, 회복/NNG;견조/NNG,21,0.4537585023560159,Dovish
9,24, 기리/VV,33,0.5445102028272191,Dovish
5,15,수립/NNG,20,0.48400906917975023,Dovish
10,28,gni/NNG,38,0.5185811455497324,Dovish
28,70, 위험/NNG;증대/NNG,98,0.5808108830157003,Dovish
5,11, 경기/NNG;예상/NNG;부진/NNG,16,0.6600123670632958,Dovish
3,14,숏커버링/NNG,17,0.3111486873298395,Dovish
9,35, 주택/NNG;경기/NNG;냉각/NNG,44,0.3733784247958074,Dovish
5,16,리얼티/NNG,21,0.4537585023560159,Dovish
3,14, 젖줄/NNG,17,0.3111486873298395,Dovish
20,42, 마구잡이/NNG,62,0.6914415273996433,Dovish
27,53,수많/VA,80,0.7397119736520712,Dovish
161,308,채/MAG,469,0.7590142221227901,Dovish
6,19, 용퇴/NNG,25,0.458534907643974,Dovish
6,14, 굳어져/VV,20,0.622297374659679,Dovish
13,29, 곪/VV,42,0.6509087482072504,Dovish
8,28, 리셉션/NNG,36,0.41486491643978596,Dovish
5,14, 경기순환/NNG;회복/NNG,19,0.5185811455497324,Dovish
77,180,홍콩h지수/NNG,257,0.6211449721140129,Dovish
5,13, 기업/NNG;금리/NNG;부담/NNG,18,0.5584720028997119,Dovish
2,19, 개인/NNG;부담/NNG,21,0.15284496921465798,Dovish
8,17, 메타/NNG,25,0.6833069211949414,Dovish
12,25, 박설/NNG,37,0.6969730596188405,Dovish
12,30, 농부/NNG,42,0.5808108830157004,Dovish
140,296, 견줘/VV,436,0.6867696251874835,Dovish
5,11,업자/NNG,16,0.6600123670632958,Dovish
27,62, 위험/NNG;차단/NNG,89,0.6323344290896737,Dovish
22,43, 출렁거릴/VV,65,0.7428976410665934,Dovish
40,81, 상승률/NNG;웃돌/VV,121,0.7170504728588893,Dovish
19,42,손익/NNG,61,0.6568694510296611,Dovish
51,140, 불금/NNG,191,0.5289527684607271,Dovish
5,21, 농지은행/NNG,26,0.34572076369982163,Dovish
28,75, 농기계/NNG,103,0.5420901574813203,Dovish
15,36, 처리장/NNG,51,0.6050113364746877,Dovish
6,14, 토픽/NNG,20,0.622297374659679,Dovish
11,24, 아성/NNG,35,0.6655124701221565,Dovish
5,11,내실/NNG,16,0.6600123670632958,Dovish
45,99, 곤두박질치/VV,144,0.6600123670632957,Dovish
11,23, 금리/NNG;인상/NNG;기대/NNG;확산/NNG,34,0.6944477949100765,Dovish
5,11, 꺼질지/VV,16,0.6600123670632958,Dovish
20,52, 터뜨리/VV,72,0.5584720028997119,Dovish
8,18,인물/NNG,26,0.6453454255730003,Dovish
4,15, 후드/NNG,19,0.3872072553438002,Dovish
8,30, 주택시장/NNG;호황/NNG,38,0.3872072553438002,Dovish
7,14, 맞받/VV,21,0.7260136037696254,Dovish
11,30, 이자/NNG;부담/NNG;낮/VV,41,0.5324099760977252,Dovish
7,14, 정주/NNG,21,0.7260136037696254,Dovish
19,56, 주식워런트/NNG,75,0.4926520882722459,Dovish
5,12, 직접/MAG;부담/NNG,17,0.6050113364746877,Dovish
76,193, 대출/NNG;금리/NNG;내리/VV,269,0.5717827345750418,Dovish
4,17, 영업이익/NNG;순이익/NNG;감소/NNG,21,0.3416534605974707,Dovish
15,46,일반기업/NNG,61,0.4734871328932339,Dovish
4,19,악몽/NNG,23,0.30568993842931597,Dovish
13,26, 덜컥/MAG,39,0.7260136037696254,Dovish
6,22, 잰/VV,28,0.3960074202379775,Dovish
12,30, 시나이/NNG,42,0.5808108830157004,Dovish
23,45,슨/VV,68,0.7421472394089503,Dovish
17,36, 고용시장/NNG;불안/NNG,53,0.6856795146713129,Dovish
62,183,고용동향/NNG,245,0.4919436440843364,Dovish
107,230, 원달러/NNG;오르/VV,337,0.6755083095943472,Dovish
5,13, 공포/NNG;살/VV,18,0.5584720028997119,Dovish
6,13, 근원/NNG;생산자/NNG;물가/NNG;오르/VV,19,0.6701664034796543,Dovish
42,85,전역/NNG,127,0.7174722672546886,Dovish
7,16, 하이프리퀀시이코노믹스/NNG,23,0.6352619032984222,Dovish
5,19,제지/NNG,24,0.38211242303664494,Dovish
8,18, 세계/NNG;경제/NNG;견인차/NNG,26,0.6453454255730003,Dovish
4,15, 집값/NNG;넘/VV,19,0.3872072553438002,Dovish
65,135, 캠퍼스/NNG,200,0.699124211037417,Dovish
31,78,보스턴/NNG,109,0.5770877363297022,Dovish
4,13,외면/NNG,17,0.44677760231976943,Dovish
15,42, 시드/NNG,57,0.5185811455497324,Dovish
12,43, 확대책/NNG,55,0.4052168951272328,Dovish
4,18, 많/VA;효과/NNG,22,0.32267271278650017,Dovish
39,76, 경제/NNG;지표/NNG;회복/NNG,115,0.7451192249214577,Dovish
6,16, 실적/NNG;강세/NNG,22,0.5445102028272191,Dovish
8,21,밝/VA,29,0.5531532219197145,Dovish
19,40, 영예/NNG,59,0.6897129235811441,Dovish
5,13, 다닌다/VV,18,0.5584720028997119,Dovish
5,14, 안정/NNG;물가/NNG;안정/NNG,19,0.5185811455497324,Dovish
48,94, 최저/NNG;낮/VV,142,0.7414607017221707,Dovish
4,14,새내기/NNG,18,0.41486491643978596,Dovish
4,14,무한/NNG,18,0.41486491643978596,Dovish
5,32, 부재지주/NNG,37,0.22687925117800795,Dovish
5,16, 보상법/NNG,21,0.4537585023560159,Dovish
15,30,보상/NNG,45,0.7260136037696253,Dovish
7,25, 달러엔/NNG;상승/NNG;제한/NNG,32,0.40656761811099024,Dovish
4,14, 불황/NNG;늪/NNG;빠지/VV,18,0.41486491643978596,Dovish
16,32, 중소기업/NNG;자금난/NNG;덜/VV,48,0.7260136037696253,Dovish
0,17, 심슨/NNG,17,0.0,Dovish
8,19, 솜/NNG,27,0.6113798768586319,Dovish
4,12, 전망/NNG;주가/NNG;하락/NNG,16,0.4840090691797502,Dovish
5,16,인가/NNG,21,0.4537585023560159,Dovish
142,306,손보사/NNG,448,0.6738165472894563,Dovish
5,20,줄/NNG,25,0.3630068018848127,Dovish
24,52, 절망/NNG,76,0.6701664034796543,Dovish
54,147,배당금/NNG,201,0.5333977497082962,Dovish
6,16, 미라/NNG,22,0.5445102028272191,Dovish
6,12, 금리/NNG;인상/NNG;장기/NNG;금리/NNG;상승/NNG,18,0.7260136037696254,Dovish
34,67,대출심사/NNG,101,0.7368496277064855,Dovish
11,26, 부실/NNG;가능성/NNG;낮/VA,37,0.614319203189683,Dovish
18,50, 하락/NNG;내리/VV,68,0.5227297947141304,Dovish
15,77, 보좌/NNG,92,0.28286244302712676,Dovish
11,27,전담/NNG,38,0.5915666401085836,Dovish
6,13,균등/NNG,19,0.6701664034796543,Dovish
10,30,보/NNG,40,0.48400906917975023,Dovish
23,44, 성황/NNG,67,0.7590142221227901,Dovish
20,40, 엔원/NNG;환율/NNG;상승/NNG,60,0.7260136037696254,Dovish
42,120,월드컵/NNG,162,0.5082095226387378,Dovish
10,26, 용적률/NNG;완화/NNG,36,0.5584720028997119,Dovish
12,23,가구주/NNG,35,0.7575794126291744,Dovish
36,76, 환식/NNG,112,0.687802361465961,Dovish
24,53, 쥘/VV,77,0.6575217543573967,Dovish
17,51, 우후죽순/NNG,68,0.4840090691797503,Dovish
6,18,통화옵션/NNG,24,0.4840090691797503,Dovish
3,14, 비참/NNG,17,0.3111486873298395,Dovish
15,29,이자소득/NNG,44,0.7510485556237504,Dovish
141,294,방문/NNG,435,0.6963803954524979,Dovish
78,159, 지부/NNG,237,0.7123152338871797,Dovish
8,19, 갔었/VV,27,0.6113798768586319,Dovish
26,59, 지론/NNG,85,0.6398763965427208,Dovish
6,12, 광역화/NNG,18,0.7260136037696254,Dovish
23,46, 保/NNG,69,0.7260136037696253,Dovish
12,30,급등락/NNG,42,0.5808108830157004,Dovish
14,32, 하방/NNG;경직/NNG;강하/VA,46,0.6352619032984222,Dovish
13,29, 봉급생활자/NNG,42,0.6509087482072504,Dovish
7,21, 徐/NNG,28,0.4840090691797503,Dovish
9,18, 甲/NNG,27,0.7260136037696254,Dovish
43,83,데이비드/NNG,126,0.7522550593275636,Dovish
17,33, 판매가격/NNG;급감/NNG,50,0.7480140160050687,Dovish
6,14, 열거주의/NNG,20,0.622297374659679,Dovish
27,54, 연금소득/NNG,81,0.7260136037696253,Dovish
115,245,국무회의/NNG,360,0.6815637912939341,Dovish
5,12, 지자체/NNG;부담/NNG,17,0.6050113364746877,Dovish
2,14, 위축/NNG;부작용/NNG,16,0.20743245821989298,Dovish
49,94,한쪽/NNG,143,0.7569077996747159,Dovish
26,55, 들어야/VV,81,0.6864128617458277,Dovish
4,13, 찜/NNG,17,0.44677760231976943,Dovish
18,39, 허심탄회/NNG,57,0.6701664034796543,Dovish
6,12, 海南/NNG,18,0.7260136037696254,Dovish
10,21, 속개/NNG,31,0.6914415273996433,Dovish
5,13, 급락/NNG;딛/VV;상승/NNG,18,0.5584720028997119,Dovish
1,20, 실적/NNG;기대/NNG;크/VV,21,0.07260136037696253,Dovish
8,20, 전자어음/NNG,28,0.5808108830157003,Dovish
20,52, 내받/VV,72,0.5584720028997119,Dovish
15,33, 북돋우/VV,48,0.6600123670632958,Dovish
32,104, 평점/NNG,136,0.44677760231976943,Dovish
6,18,메일/NNG,24,0.4840090691797503,Dovish
11,26, 저렇/VA,37,0.614319203189683,Dovish
9,19, 直/NNG,28,0.687802361465961,Dovish
12,35, 여고/NNG,47,0.49783789972774317,Dovish
11,22, 초교/NNG,33,0.7260136037696254,Dovish
4,16, 매립/NNG,20,0.36300680188481266,Dovish
14,28, 솜방망이/NNG,42,0.7260136037696254,Dovish
5,12, 무등/NNG,17,0.6050113364746877,Dovish
7,14,분배/NNG,21,0.7260136037696254,Dovish
8,18, 쓴소리/NNG,26,0.6453454255730003,Dovish
10,22, 와전/NNG,32,0.6600123670632958,Dovish
15,35,해명/NNG,50,0.6222973746596789,Dovish
8,19, 판매/NNG;실적/NNG;호조/NNG,27,0.6113798768586319,Dovish
11,28,핸/XSV,39,0.5704392601047057,Dovish
45,90, 상습/NNG,135,0.7260136037696254,Dovish
7,14, 지방교육세/NNG,21,0.7260136037696254,Dovish
13,27, 코란/NNG,40,0.6991242110374171,Dovish
3,16, 수입/NNG;비용/NNG;증가/NNG,19,0.27225510141360953,Dovish
56,122, 택지지구/NNG,178,0.6665042919852299,Dovish
8,19, 책임진다/VV,27,0.6113798768586319,Dovish
4,19, 시공권/NNG,23,0.30568993842931597,Dovish
6,26,당첨/NNG,32,0.33508320173982714,Dovish
9,28,시행사/NNG,37,0.46672303099475926,Dovish
10,32, 특전/NNG,42,0.4537585023560159,Dovish
4,13, 경찰대/NNG,17,0.44677760231976943,Dovish
17,40,광역/NNG,57,0.6171115632041816,Dovish
46,92, 놔두/VV,138,0.7260136037696253,Dovish
9,26,다급/NNG,35,0.5026248026097407,Dovish
6,25, 펀드평가/NNG,31,0.34848652980942024,Dovish
7,24, 투자금액/NNG;늘/VV,31,0.42350793553228144,Dovish
10,30, 법무사/NNG,40,0.48400906917975023,Dovish
39,79,주택저당증권/NNG,118,0.7168235581522884,Dovish
10,21, 주택/NNG;수요/NNG;줄/VV,31,0.6914415273996433,Dovish
14,29,원금보장형/NNG,43,0.7009786519155004,Dovish
21,61,나가/VV,82,0.49987821898892243,Dovish
8,21, 깎인/VV,29,0.5531532219197145,Dovish
8,16,잠시/NNG,24,0.7260136037696253,Dovish
6,12, 가동/NNG;멈추/VV,18,0.7260136037696254,Dovish
5,14, 수요/NNG;꺾/VV,19,0.5185811455497324,Dovish
8,18,세관/NNG,26,0.6453454255730003,Dovish
7,25, 바닥났/VV,32,0.40656761811099024,Dovish
7,16, 경제/NNG;밝/VA,23,0.6352619032984222,Dovish
5,14,소득분배/NNG,19,0.5185811455497324,Dovish
5,15, 흉내/NNG,20,0.48400906917975023,Dovish
9,18, 조폭/NNG,27,0.7260136037696254,Dovish
4,15, 이자/NNG;하락/NNG,19,0.3872072553438002,Dovish
24,52, 가격/NNG;하락/NNG;막/VV,76,0.6701664034796543,Dovish
28,61, 드러낸다/VV,89,0.6665042919852299,Dovish
15,30, 불안/NNG;없/VA,45,0.7260136037696253,Dovish
3,14, 느껴야/VV,17,0.3111486873298395,Dovish
5,13,항소심/NNG,18,0.5584720028997119,Dovish
13,26,붐/NNG,39,0.7260136037696254,Dovish
6,14, 들린/VV,20,0.622297374659679,Dovish
49,99, 지수/NNG;빠지/VV,148,0.7186801330244776,Dovish
5,13, 비켜갈/VV,18,0.5584720028997119,Dovish
5,11, 번다는/VV,16,0.6600123670632958,Dovish
16,45,정치인/NNG,61,0.5162763404584002,Dovish
4,28, 지표/NNG;매우/MAG;좋/VA,32,0.20743245821989298,Dovish
22,75,여/NNG,97,0.42592798087818023,Dovish
7,16, 명사/NNG,23,0.6352619032984222,Dovish
31,70, 화상/NNG,101,0.6430406204816682,Dovish
18,37, 서울시교육감/NNG,55,0.7063916144785545,Dovish
54,112, 유해/NNG,166,0.7000845464921388,Dovish
10,29,투자자보호/NNG,39,0.5006990370825003,Dovish
17,53,대략/MAG,70,0.465744576003156,Dovish
34,78, 비대/NNG,112,0.6329349366196735,Dovish
12,24,직무/NNG,36,0.7260136037696254,Dovish
11,25, 물타기/NNG,36,0.6388919713172704,Dovish
36,77,서로/MAG,113,0.6788698632651042,Dovish
31,79, 따른다/VV,110,0.5697828282748959,Dovish
13,32, 갑절/NNG,45,0.5898860530628207,Dovish
7,18, 불확실성/NNG;낮/VV,25,0.5646772473763753,Dovish
43,83,혜택/NNG,126,0.7522550593275636,Dovish
11,27,위기관리/NNG,38,0.5915666401085836,Dovish
21,46,지도자/NNG,67,0.6628819860505275,Dovish
11,24,동료/NNG,35,0.6655124701221565,Dovish
81,158,보호무역주의/NNG,239,0.7443936950042995,Dovish
80,196,강연/NNG,276,0.5926641663425514,Dovish
3,15,전략비축유/NNG,18,0.2904054415078502,Dovish
8,18, 반품/NNG,26,0.6453454255730003,Dovish
6,20, 반도/NNG,26,0.43560816226177523,Dovish
6,12, 미리/MAG;금리/NNG;오르/VV,18,0.7260136037696254,Dovish
5,16, 소비자/NNG;신뢰지수/NNG;최저/NNG;떨어/VV,21,0.4537585023560159,Dovish
35,73, 합격자/NNG,108,0.6961774282722436,Dovish
18,45,멀티/NNG,63,0.5808108830157004,Dovish
19,37,고강/NNG,56,0.7456355930606964,Dovish
9,23, 생겨야/VV,32,0.5681845594718807,Dovish
22,58, 비칠/VV,80,0.5507689407907503,Dovish
51,131,유력/NNG,182,0.5652930349961969,Dovish
56,119,초대/NNG,175,0.6833069211949415,Dovish
7,23, 기업/NNG;실적/NNG;악영향/NNG,30,0.441921324033685,Dovish
17,46, 헤어/NNG,63,0.5366187506123319,Dovish
14,36, 어우러진/VV,50,0.5646772473763753,Dovish
13,32, 조모/NNG,45,0.5898860530628207,Dovish
12,39, 단해/NNG,51,0.4467776023197695,Dovish
6,22, 증과/NNG,28,0.3960074202379775,Dovish
26,57,분할상환/NNG,83,0.6623281999301845,Dovish
5,12, 경기/NNG;침체/NNG;최악/NNG,17,0.6050113364746877,Dovish
1,18, 투자자금/NNG;빠지/VV,19,0.08066817819662504,Dovish
8,22, 빗방울/NNG,30,0.5280098936506367,Dovish
11,48, 고용/NNG;지표/NNG;견조/NNG,59,0.33275623506107826,Dovish
7,15, 지표/NNG;저조/NNG,22,0.6776126968516504,Dovish
32,64, 차분히/MAG,96,0.7260136037696253,Dovish
5,13, 투자/NNG;저변/NNG;확대/NNG,18,0.5584720028997119,Dovish
4,12, 세계/NNG;경제/NNG;확장/NNG,16,0.4840090691797502,Dovish
5,14,지지력/NNG,19,0.5185811455497324,Dovish
2,14, 공포/NNG;아니/VCN,16,0.20743245821989298,Dovish
7,22, 제의했/VV,29,0.4620086569443071,Dovish
75,149,시대/NNG,224,0.7308861782915692,Dovish
11,31, 매매비중/NNG,42,0.5152354607397341,Dovish
6,15,타운/NNG,21,0.5808108830157004,Dovish
36,74,중진/NNG,110,0.7063916144785545,Dovish
20,45, 겸직/NNG,65,0.6453454255730003,Dovish
4,13, 연후/NNG,17,0.44677760231976943,Dovish
15,32, 뜬/VV,47,0.6806377535340238,Dovish
8,24, 산위/NNG,32,0.4840090691797502,Dovish
3,16, 잠긴/VV,19,0.27225510141360953,Dovish
7,14, 두꺼비/NNG,21,0.7260136037696254,Dovish
8,23, 띠/NNG,31,0.5050529417527828,Dovish
7,27, 국보/NNG,34,0.37645149825091684,Dovish
9,22, 지표/NNG;악재/NNG,31,0.5940111303569663,Dovish
8,22, 캔터/NNG,30,0.5280098936506367,Dovish
6,17, 연착/NNG,23,0.5124801908962061,Dovish
12,37,수출국/NNG,49,0.47092774298570295,Dovish
33,64,차주/NNG,97,0.7487015288874261,Dovish
5,17,미성년자/NNG,22,0.42706682574683846,Dovish
32,71,소수/NNG,103,0.6544347977641692,Dovish
19,48,복리/NNG,67,0.5747607696509535,Dovish
3,32, 원유/NNG;생산/NNG;줄/VV,35,0.13612755070680477,Dovish
6,23,타격/NNG,29,0.3787897063145872,Dovish
13,28, 들여야/VV,41,0.6741554892146522,Dovish
14,35, 쓰리/NNG,49,0.5808108830157003,Dovish
6,17, 소실/NNG,23,0.5124801908962061,Dovish
5,18, 설마/NNG,23,0.4033408909831252,Dovish
23,55, 강풍/NNG,78,0.6072113776982321,Dovish
2,18, 던질지/VV,20,0.16133635639325009,Dovish
7,14, 과수원/NNG,21,0.7260136037696254,Dovish
6,32, 금융위기/NNG;막/VV,38,0.27225510141360953,Dovish
3,14,처지/NNG,17,0.3111486873298395,Dovish
3,14, 하락/NNG;막지/NNG;못하/VX,17,0.3111486873298395,Dovish
5,14, 산업/NNG;생산/NNG;지표/NNG;호조/NNG,19,0.5185811455497324,Dovish
6,14,흐를수록/VV,20,0.622297374659679,Dovish
19,39,적발/NNG,58,0.707397870339635,Dovish
8,16,고삐/NNG,24,0.7260136037696253,Dovish
6,12, 불황/NNG;길/VA,18,0.7260136037696254,Dovish
15,51, 상업지/NNG,66,0.4270668257468384,Dovish
19,75, 기업/NNG;도산/NNG,94,0.3678468925766102,Dovish
17,40, 군부대/NNG,57,0.6171115632041816,Dovish
55,109, 육군/NNG,164,0.732674279033567,Dovish
10,21, 국공유지/NNG,31,0.6914415273996433,Dovish
6,25, 비사업용토지/NNG,31,0.34848652980942024,Dovish
5,20, 전세자금/NNG;대출/NNG;금리/NNG;인하/NNG,25,0.3630068018848127,Dovish
5,19, 피해/NNG;심각/NNG,24,0.38211242303664494,Dovish
15,38,고도/NNG,53,0.5731686345549674,Dovish
29,66, 치료비/NNG,95,0.6380119548278526,Dovish
21,45, 타개책/NNG,66,0.6776126968516504,Dovish
22,62,지급보증/NNG,84,0.5152354607397341,Dovish
5,11, 위험/NNG;없애/VV,16,0.6600123670632958,Dovish
1,20,외화증권/NNG,21,0.07260136037696253,Dovish
37,71,정상화/NNG,108,0.7566902349148208,Dovish
11,24, 촘촘히/MAG,35,0.6655124701221565,Dovish
15,36, 협소/NNG,51,0.6050113364746877,Dovish
7,22,납부/NNG,29,0.4620086569443071,Dovish
4,12, 토지거래허가/NNG,16,0.4840090691797502,Dovish
4,23, 부탁드립니다/VV,27,0.2525264708763914,Dovish
7,19,증가분/NNG,26,0.5349573922513029,Dovish
4,18, 재정/NNG;확보/NNG,22,0.32267271278650017,Dovish
39,123,취득세/NNG,162,0.4603988706831771,Dovish
6,14, 취득가액/NNG,20,0.622297374659679,Dovish
6,12, 일괄처리/NNG,18,0.7260136037696254,Dovish
7,22, 번거로운/VA,29,0.4620086569443071,Dovish
93,191, 수법/NNG,284,0.7070080120479074,Dovish
5,17,사회주의/NNG,22,0.42706682574683846,Dovish
11,24, 重慶/NNG,35,0.6655124701221565,Dovish
15,38, 蘇/NNG,53,0.5731686345549674,Dovish
6,15, 안후이/NNG,21,0.5808108830157004,Dovish
7,14, 후난/NNG,21,0.7260136037696254,Dovish
8,18, 湖/NNG,26,0.6453454255730003,Dovish
35,75,광역시/NNG,110,0.6776126968516504,Dovish
16,110,파격적/VAX,126,0.21120395746025464,Dovish
4,12,유휴/NNG,16,0.4840090691797502,Dovish
13,26, 뒤바뀔/VV,39,0.7260136037696254,Dovish
8,23, 흡족/NNG,31,0.5050529417527828,Dovish
23,50,덧붙이/VV,73,0.6679325154680553,Dovish
12,49, 택지비/NNG,61,0.3555984998055308,Dovish
7,14,서민주택/NNG,21,0.7260136037696254,Dovish
12,28, 건설비/NNG,40,0.622297374659679,Dovish
130,268, 强/NNG,398,0.7043415558959052,Dovish
5,13, 하단/NNG;저점/NNG,18,0.5584720028997119,Dovish
10,20, 대료/NNG,30,0.7260136037696254,Dovish
5,14,택지지구/NNG,19,0.5185811455497324,Dovish
15,30,왼쪽/NNG,45,0.7260136037696253,Dovish
14,28, 지수/NNG;밑돌/VV,42,0.7260136037696254,Dovish
5,11, 반감/VA,16,0.6600123670632958,Dovish
3,18, 송유/NNG,21,0.24200453458987514,Dovish
9,26, 펀드판매사/NNG,35,0.5026248026097407,Dovish
4,21, 뒤안길/NNG,25,0.27657661095985725,Dovish
9,20, 늑대/NNG,29,0.6534122433926629,Dovish
2,16,걸/VV,18,0.18150340094240633,Dovish
5,19, 라마단/NNG,24,0.38211242303664494,Dovish
28,56, 급제동/NNG,84,0.7260136037696254,Dovish
13,25, 자금사정/NNG;좋/VA;않/VX,38,0.7550541479204105,Dovish
5,20, 국채/NNG;내리/VV,25,0.3630068018848127,Dovish
4,13, 채권시장/NNG;넘/VV,17,0.44677760231976943,Dovish
34,71,비드/NNG,105,0.69533697262443,Dovish
40,81,오퍼/NNG,121,0.7170504728588893,Dovish
13,46,신화/NNG,59,0.4103555151741361,Dovish
6,13, 판도라/NNG,19,0.6701664034796543,Dovish
6,13,투/MAG,19,0.6701664034796543,Dovish
43,86, 발돋움/NNG,129,0.7260136037696253,Dovish
15,33,민감/NNG,48,0.6600123670632958,Dovish
7,21, 일드스프레드/NNG;확대/NNG,28,0.4840090691797503,Dovish
31,76, 토크/NNG,107,0.5922742557067997,Dovish
24,65,모/NNG,89,0.5361331227837235,Dovish
0,20, 금리/NNG;인상/NNG;잠시/MAG;중단/NNG,20,0.0,Dovish
144,279,상가/NNG,423,0.7494333974396133,Dovish
2,14, 지표/NNG;경기/NNG;부진/NNG,16,0.20743245821989298,Dovish
4,21, 가격/NNG;오름/NNG;제한/NNG,25,0.27657661095985725,Dovish
3,15, 불확실성/NNG;빠지/VV,18,0.2904054415078502,Dovish
6,22,구매자/NNG,28,0.3960074202379775,Dovish
4,18, 청정에너지/NNG,22,0.32267271278650017,Dovish
7,14, 둔화/NNG;우려/NNG;fed/NNG;금리/NNG;인상/NNG,21,0.7260136037696254,Dovish
6,12, 둔화/NNG;우려/NNG;금리/NNG;인상/NNG,18,0.7260136037696254,Dovish
5,13, 과연/MAG;금리/NNG;오르/VV,18,0.5584720028997119,Dovish
19,43,살펴보/VV,62,0.6415934172847853,Dovish
11,28,허가/NNG,39,0.5704392601047057,Dovish
11,46,농지/NNG,57,0.34722389745503823,Dovish
2,15,비사업용토지/NNG,17,0.1936036276719001,Dovish
4,22, 판다면/VV,26,0.26400494682531833,Dovish
10,29, 다운계약서/NNG,39,0.5006990370825003,Dovish
4,19, 겉잡/VV,23,0.30568993842931597,Dovish
18,35, 후지/NNG,53,0.7467568495916148,Dovish
2,21,후지/NNG,23,0.13828830547992862,Dovish
8,19, 석차/NNG,27,0.6113798768586319,Dovish
8,24, 쉽/VA;하락/NNG,32,0.4840090691797502,Dovish
9,22,맡겨/VV,31,0.5940111303569663,Dovish
37,71,입법/NNG,108,0.7566902349148208,Dovish
12,43, 지표/NNG;경기/NNG;회복/NNG,55,0.4052168951272328,Dovish
18,46, 휘발유/NNG;가격/NNG;급등/NNG,64,0.5681845594718807,Dovish
11,27,프로그램매도/NNG,38,0.5915666401085836,Dovish
24,46,되/XSV,70,0.7575794126291744,Dovish
8,17, 타박/NNG,25,0.6833069211949414,Dovish
6,12,이평/NNG,18,0.7260136037696254,Dovish
3,14, 우회로/NNG,17,0.3111486873298395,Dovish
5,11,구호/NNG,16,0.6600123670632958,Dovish
5,16, 호출/NNG,21,0.4537585023560159,Dovish
11,26, 제약기업/NNG,37,0.614319203189683,Dovish
24,56, 부딪혔/VV,80,0.622297374659679,Dovish
6,24, 휘청대/VV,30,0.3630068018848127,Dovish
11,31, 차입/NNG;비용/NNG;낮/VV,42,0.5152354607397341,Dovish
20,43, 끝남/VV,63,0.6753614918787213,Dovish
7,14, 둔한/VA,21,0.7260136037696254,Dovish
6,12, 인상/NNG;가능성/NNG;작/VA,18,0.7260136037696254,Dovish
33,65,지지율/NNG,98,0.7371830438276197,Dovish
14,50,훨씬/MAG,64,0.40656761811099024,Dovish
30,58,연료/NNG,88,0.7510485556237504,Dovish
7,17,승승장구/NNG,24,0.5978935560455738,Dovish
14,42, 만족감/NNG,56,0.4840090691797503,Dovish
15,41, 들여온/VV,56,0.5312294661728967,Dovish
22,62, 들여와/VV,84,0.5152354607397341,Dovish
48,105, 운영사/NNG,153,0.6637838663036575,Dovish
6,19, 소사/NNG,25,0.458534907643974,Dovish
21,52, 조정회의/NNG,73,0.5863956030446974,Dovish
8,17, 위칭데이/NNG,25,0.6833069211949414,Dovish
4,12,실상/NNG,16,0.4840090691797502,Dovish
55,142,함정/NNG,197,0.562404904328583,Dovish
22,48, 편제/NNG,70,0.6655124701221565,Dovish
8,18, 응변/NNG,26,0.6453454255730003,Dovish
3,15,근본/NNG,18,0.2904054415078502,Dovish
12,27, 주택/NNG;수요/NNG;늘/VV,39,0.6453454255730003,Dovish
8,24,학원/NNG,32,0.4840090691797502,Dovish
35,77, 경기장/NNG,112,0.6600123670632958,Dovish
26,55, 부대시설/NNG,81,0.6864128617458277,Dovish
13,25, 제과점/NNG,38,0.7550541479204105,Dovish
3,16, 배합/NNG,19,0.27225510141360953,Dovish
5,13, 호조/NNG;하락/NNG;압력/NNG,18,0.5584720028997119,Dovish
63,128, 지표/NNG;악화/NNG,191,0.7146696412107251,Dovish
296,619,공화당/NNG,915,0.694345805220708,Dovish
3,19, 하락/NNG;내수/NNG;부진/NNG,22,0.229267453821987,Dovish
157,317,예산안/NNG,474,0.7191428125667582,Dovish
2,28, 긴급복지지원/NNG,30,0.10371622910994649,Dovish
31,81,린/NNG,112,0.5557141164656392,Dovish
5,13, 북적이/VV,18,0.5584720028997119,Dovish
4,16, 최고가/NNG;넘/VV,20,0.36300680188481266,Dovish
5,14, 술집/NNG,19,0.5185811455497324,Dovish
7,15, 자축/NNG,22,0.6776126968516504,Dovish
16,44, 신학기/NNG,60,0.5280098936506367,Dovish
24,47,스스로/NNG,71,0.7414607017221707,Dovish
27,57, 성장/NNG;잠재력/NNG;높/VV,84,0.6878023614659609,Dovish
42,89, 지표/NNG;금리/NNG;오르/VV,131,0.6852263226589722,Dovish
2,17,환호/NNG,19,0.17082673029873535,Dovish
3,13, 이전가격/NNG,16,0.33508320173982714,Dovish
10,27,찬성/NNG,37,0.5377878546441669,Dovish
19,50, 키운다는/VV,69,0.5517703388649153,Dovish
8,16, 목표관리/NNG,24,0.7260136037696253,Dovish
35,72,연도/NNG,107,0.7058465592204692,Dovish
12,34, 샐러리맨/NNG,46,0.5124801908962061,Dovish
8,19, 수익/NNG;내/VV;쉽/VA;않/VX,27,0.6113798768586319,Dovish
10,24, 뜸해지/VA,34,0.6050113364746877,Dovish
40,84,이튿날/NNG,124,0.6914415273996433,Dovish
27,52, 천수답/NNG,79,0.7539372039146109,Dovish
9,26, 중대형주/NNG,35,0.5026248026097407,Dovish
50,100, 제로성장/NNG,150,0.7260136037696254,Dovish
5,28, 난방유/NNG;수요/NNG;증가/NNG,33,0.2592905727748662,Dovish
27,56,용석/NNG,83,0.7000845464921388,Dovish
10,36,고배당주/NNG,46,0.4033408909831252,Dovish
4,14, 카피/NNG,18,0.41486491643978596,Dovish
15,46,시정/NNG,61,0.4734871328932339,Dovish
139,275,저물가/NNG,414,0.7339337521743848,Dovish
4,13, 경제/NNG;성장률/NNG;전망/NNG;떨어/VV,17,0.44677760231976943,Dovish
5,11, 경제/NNG;펀더멘털/NNG;강하/VA,16,0.6600123670632958,Dovish
11,25, 위기감/NNG;확산/NNG,36,0.6388919713172704,Dovish
13,47,곳곳/NNG,60,0.40162454676617576,Dovish
6,22, 침체/NNG;경기/NNG;침체/NNG,28,0.3960074202379775,Dovish
28,60,약속/NNG,88,0.6776126968516504,Dovish
60,117,역할/NNG,177,0.7446293371996158,Dovish
6,17, 편다/VV,23,0.5124801908962061,Dovish
6,14, 허황/NNG,20,0.622297374659679,Dovish
9,26, 변동성/NNG;크/VV;위험/NNG,35,0.5026248026097407,Dovish
21,47, 뗀/VV,68,0.6487781140068993,Dovish
11,29, 날지/VV,40,0.5507689407907503,Dovish
31,70, 판매자/NNG,101,0.6430406204816682,Dovish
15,31, 멀쩡/NNG,46,0.7025938100996375,Dovish
40,78, 피해/NNG;없/VA,118,0.7446293371996158,Dovish
6,12, 인플레이션/NNG;위험/NNG;높/VV,18,0.7260136037696254,Dovish
3,14, 설지/VV,17,0.3111486873298395,Dovish
16,41, 피해/NNG;방지/NNG,57,0.5666447639177564,Dovish
5,14, 누누히/MAG,19,0.5185811455497324,Dovish
18,40, 밥그릇/NNG,58,0.6534122433926629,Dovish
12,26, 미트/NNG,38,0.6701664034796543,Dovish
11,38, 깊숙히/MAG,49,0.42032366534030946,Dovish
17,40,필요시/NNG,57,0.6171115632041816,Dovish
25,79, 마이너스gdp/NNG,104,0.4595022808668516,Dovish
9,18, 체감/NNG;경기/NNG;나쁘/VA,27,0.7260136037696254,Dovish
8,18, 금융자산/NNG;많/VA,26,0.6453454255730003,Dovish
13,27,보험기간/NNG,40,0.6991242110374171,Dovish
9,25, 경제/NNG;하락/NNG;압력/NNG,34,0.5227297947141304,Dovish
26,63, 경제/NNG;전망/NNG;불확실성/NNG,89,0.5992493237463574,Dovish
12,43, 지표/NNG;예상/NNG;부진/NNG,55,0.4052168951272328,Dovish
9,18, 소비/NNG;강하/VA,27,0.7260136037696254,Dovish
5,21, 다수/NNG;fed/NNG;금리/NNG;인상/NNG,26,0.34572076369982163,Dovish
18,88, 콜/NNG;금리/NNG;낮/VA,106,0.29700556517848314,Dovish
8,20,샌/VV,28,0.5808108830157003,Dovish
4,17, 정치/NNG;비판/NNG,21,0.3416534605974707,Dovish
41,105, 전인/NNG,146,0.5669820524677074,Dovish
9,22, 치아/NNG,31,0.5940111303569663,Dovish
10,21, 맹공/NNG,31,0.6914415273996433,Dovish
9,24, 알레르기/NNG,33,0.5445102028272191,Dovish
7,15,거부/NNG,22,0.6776126968516504,Dovish
175,374,원엔/NNG,549,0.679424495506334,Dovish
12,27, 걸림돌/NNG;제거/NNG,39,0.6453454255730003,Dovish
4,19,부스/NNG,23,0.30568993842931597,Dovish
8,23, 제격/NNG,31,0.5050529417527828,Dovish
44,96, 넉/NNG,140,0.6655124701221565,Dovish
8,24, 만약/NNG;fed/NNG;금리/NNG;오르/VV,32,0.4840090691797502,Dovish
6,16, 스포츠토토/NNG,22,0.5445102028272191,Dovish
5,22, 프라이빗에쿼티/NNG,27,0.3300061835316479,Dovish
18,48, 총책/NNG,66,0.5445102028272191,Dovish
7,16, 쌀/VV,23,0.6352619032984222,Dovish
6,13, 봉제/NNG,19,0.6701664034796543,Dovish
3,15, 출신자/NNG,18,0.2904054415078502,Dovish
16,31, 여학생/NNG,47,0.7494333974396133,Dovish
6,12, 기업/NNG;가계/NNG;부담/NNG,18,0.7260136037696254,Dovish
9,24, 일사천리/NNG,33,0.5445102028272191,Dovish
91,250, 모델하우스/NNG,341,0.5285379035442873,Dovish
10,34, 수신/NNG;금리/NNG;내리/VV,44,0.42706682574683846,Dovish
17,37, 지평/NNG,54,0.6671476358964126,Dovish
5,14, 은행/NNG;중소기업/NNG;대출/NNG;증가/NNG,19,0.5185811455497324,Dovish
4,17, 은행/NNG;기업/NNG;대출/NNG;증가/NNG,21,0.3416534605974707,Dovish
14,40,후보자/NNG,54,0.5082095226387378,Dovish
63,132, 경기/NNG;지표/NNG;호조/NNG,195,0.6930129854164606,Dovish
5,12, 사차익/NNG,17,0.6050113364746877,Dovish
2,14,촉각/NNG,16,0.20743245821989298,Dovish
7,22, fed/NNG;자산/NNG;거품/NNG,29,0.4620086569443071,Dovish
37,78, 지표/NNG;금리/NNG;인상/NNG,115,0.6887821369096446,Dovish
12,36, 유동성/NNG;강화/NNG,48,0.4840090691797503,Dovish
8,16, 대손충당금/NNG;줄/VV,24,0.7260136037696253,Dovish
4,13, 원화/NNG;강세/NNG;견인/NNG,17,0.44677760231976943,Dovish
25,56,사업비/NNG,81,0.6482264319371656,Dovish
7,21,발제/NNG,28,0.4840090691797503,Dovish
3,14, 부츠/NNG,17,0.3111486873298395,Dovish
6,12, 짧아져/VV,18,0.7260136037696254,Dovish
8,16, 추워/VA,24,0.7260136037696253,Dovish
12,44, 국제/NNG;유가/NNG;최저/NNG,56,0.3960074202379775,Dovish
11,28, 빼돌리/VV,39,0.5704392601047057,Dovish
15,32,바라보/VV,47,0.6806377535340238,Dovish
4,12, 두기/NNG,16,0.4840090691797502,Dovish
10,21, 물가/NNG;가격/NNG;하락/NNG,31,0.6914415273996433,Dovish
1,16, 예상/NNG;상승/NNG;하회/NNG,17,0.09075170047120316,Dovish
5,15,개별주식/NNG,20,0.48400906917975023,Dovish
11,41, 겸하/VV,52,0.38956827519345755,Dovish
5,12, 띠자/NNG,17,0.6050113364746877,Dovish
13,52, 전대미문/NNG,65,0.3630068018848127,Dovish
12,27, 감히/MAG,39,0.6453454255730003,Dovish
8,23, 볼지/VV,31,0.5050529417527828,Dovish
21,61, 판매가격/NNG;호조/NNG,82,0.49987821898892243,Dovish
4,12, 찔렀/VV,16,0.4840090691797502,Dovish
9,21, 가라/NNG,30,0.6222973746596789,Dovish
6,13,생산능력/NNG,19,0.6701664034796543,Dovish
6,16, gdp/NNG;낮/VA,22,0.5445102028272191,Dovish
5,18,경제개발협력기구/NNG,23,0.4033408909831252,Dovish
36,78,관료/NNG,114,0.6701664034796543,Dovish
6,16,베일/NNG,22,0.5445102028272191,Dovish
6,22, 담소/NNG,28,0.3960074202379775,Dovish
4,24, 다마/NNG,28,0.2420045345898751,Dovish
40,85, 물갈이/NNG,125,0.6833069211949416,Dovish
21,46,여자/NNG,67,0.6628819860505275,Dovish
7,14, 대손비용/NNG;안정/NNG,21,0.7260136037696254,Dovish
5,25, 중원/NNG,30,0.2904054415078502,Dovish
10,33, 공해/NNG,43,0.44000824470886385,Dovish
28,55, 합참/NNG,83,0.7392138511108913,Dovish
6,18, 준위/NNG,24,0.4840090691797503,Dovish
5,13, 환담/NNG,18,0.5584720028997119,Dovish
22,52, 개발자/NNG,74,0.614319203189683,Dovish
14,37, 참여연대/NNG,51,0.5494157001499868,Dovish
15,57, 제명/NNG,72,0.3821124230366449,Dovish
9,30, 치료법/NNG,39,0.43560816226177523,Dovish
21,45, 심근/NNG,66,0.6776126968516504,Dovish
3,13,거래기업/NNG,16,0.33508320173982714,Dovish
8,27,제1금융권/NNG,35,0.4302302837153335,Dovish
18,38,연구진/NNG,56,0.687802361465961,Dovish
93,271,소비세/NNG,364,0.4982971597828425,Dovish
15,36, 플러스/NNG;효과/NNG,51,0.6050113364746877,Dovish
5,17, 지표/NNG;최대/NNG,22,0.42706682574683846,Dovish
6,12, 본받/VV,18,0.7260136037696254,Dovish
52,115,여전사/NNG,167,0.6565688242786178,Dovish
11,25, 감회/NNG,36,0.6388919713172704,Dovish
11,29, 귀하/VA,40,0.5507689407907503,Dovish
2,16, 한새/NNG,18,0.18150340094240633,Dovish
9,34,분리과세/NNG,43,0.3843601431721546,Dovish
6,15, 물가/NNG;예상밖/NNG;하락/NNG,21,0.5808108830157004,Dovish
5,11, 개선/NNG;기대/NNG;급등/NNG,16,0.6600123670632958,Dovish
9,22,감시/NNG,31,0.5940111303569663,Dovish
22,51, 졸속/NNG,73,0.6263646777620296,Dovish
6,20,피/VV,26,0.43560816226177523,Dovish
6,18,라운드/NNG,24,0.4840090691797503,Dovish
7,25, 신학/NNG,32,0.40656761811099024,Dovish
13,33,가시/NNG,46,0.572010718121523,Dovish
5,11, 경제/NNG;위축/NNG;우려/NNG,16,0.6600123670632958,Dovish
6,20, 외국산/NNG,26,0.43560816226177523,Dovish
10,22, 뒤져/VV,32,0.6600123670632958,Dovish
16,47,앉/VV,63,0.4943071344814471,Dovish
4,14, 사직서/NNG,18,0.41486491643978596,Dovish
14,42, 벌어들였/VV,56,0.4840090691797503,Dovish
11,73,파산보호신청/NNG,84,0.2187986203141337,Dovish
6,23, 이자/NNG;수입/NNG;줄/VV,29,0.3787897063145872,Dovish
10,32, 기업/NNG;재고/NNG;늘/VV,42,0.4537585023560159,Dovish
7,14, 하락/NNG;여의치/VA;않/VX,21,0.7260136037696254,Dovish
17,35,불투명/NNG,52,0.7052703579476362,Dovish
9,24, 잡아온/VV,33,0.5445102028272191,Dovish
5,12, 채권/NNG;부정적/VAX,17,0.6050113364746877,Dovish
11,24, 주택시장/NNG;연착륙/NNG,35,0.6655124701221565,Dovish
64,143,dc/NNG,207,0.6498583306469374,Dovish
3,13, 차입/NNG;비용/NNG;낮/VA,16,0.33508320173982714,Dovish
5,15, 실업/NNG;우려/NNG,20,0.48400906917975023,Dovish
8,24, 격주/NNG,32,0.4840090691797502,Dovish
18,51, 기흥/NNG,69,0.5124801908962061,Dovish
6,14, 창고증권/NNG,20,0.622297374659679,Dovish
15,33, 콘도/NNG,48,0.6600123670632958,Dovish
5,11, 건드린/VV,16,0.6600123670632958,Dovish
3,14, 고소인/NNG,17,0.3111486873298395,Dovish
166,319,희망/NNG,485,0.7556003650517732,Dovish
7,17,사명/NNG,24,0.5978935560455738,Dovish
6,27, 지켜본다는/VV,33,0.32267271278650017,Dovish
8,21, 부채/NNG;상환/NNG;부담/NNG;줄/VV,29,0.5531532219197145,Dovish
271,688,미결제/NNG,959,0.571946763434792,Dovish
32,64, 칼날/NNG,96,0.7260136037696253,Dovish
5,16, 히스패닉/NNG,21,0.4537585023560159,Dovish
5,13,간헐/NNG,18,0.5584720028997119,Dovish
39,86, 니스/NNG,125,0.6584774545817532,Dovish
6,15, 이제서야/MAG,21,0.5808108830157004,Dovish
8,22, 떠올렸/VV,30,0.5280098936506367,Dovish
42,92,선진시장/NNG,134,0.6628819860505275,Dovish
9,21, 전망/NNG;나쁘/VA,30,0.6222973746596789,Dovish
6,14, 짓눌리/VV,20,0.622297374659679,Dovish
8,22, 스태그플레이션/NNG;위험/NNG,30,0.5280098936506367,Dovish
41,95, 진주/NNG,136,0.6266643737800976,Dovish
14,27,중소형사/NNG,41,0.7529029965018337,Dovish
9,19,앞날/NNG,28,0.687802361465961,Dovish
16,33,놀랍/VA,49,0.7040131915341822,Dovish
6,16,몫/NNG,22,0.5445102028272191,Dovish
12,31, 경제/NNG;지표/NNG;많/VA;않/VX,43,0.5620750480797101,Dovish
7,16, 미래/NNG;성장동력/NNG;확충/NNG,23,0.6352619032984222,Dovish
7,18, 헀/VV,25,0.5646772473763753,Dovish
21,59, 외환보유액/NNG;확충/NNG,80,0.5168232433614283,Dovish
16,37, 철퇴/NNG,53,0.6279036573142706,Dovish
14,27, 우성/NNG,41,0.7529029965018337,Dovish
9,22, 위층/NNG,31,0.5940111303569663,Dovish
26,61,승리/NNG,87,0.6188968425577135,Dovish
12,33, 눈속임/NNG,45,0.5280098936506367,Dovish
12,25, 온다는/VV,37,0.6969730596188405,Dovish
7,20,스트래티지/NNG,27,0.5082095226387378,Dovish
15,30, 미친다면/VV,45,0.7260136037696253,Dovish
44,97, 보험설계사/NNG,141,0.6586515168219282,Dovish
8,16, 세대교체/NNG,24,0.7260136037696253,Dovish
14,27,잦/VA,41,0.7529029965018337,Dovish
27,140,탈퇴/NNG,167,0.2800338185968555,Dovish
10,24, 강압/NNG,34,0.6050113364746877,Dovish
8,31, 불시/NNG,39,0.3747166987198067,Dovish
60,137, 수색/NNG,197,0.6359243244697449,Dovish
26,68, 유전자/NNG,94,0.55518687347089,Dovish
15,29, 洪/NNG,44,0.7510485556237504,Dovish
7,14, 피고발인/NNG,21,0.7260136037696254,Dovish
8,18, 폐수/NNG,26,0.6453454255730003,Dovish
5,13, 목수/NNG,18,0.5584720028997119,Dovish
27,52,주유소/NNG,79,0.7539372039146109,Dovish
7,15, 넓힌다/VV,22,0.6776126968516504,Dovish
20,47,졸업/NNG,67,0.6178839181018089,Dovish
9,19, 동대/NNG,28,0.687802361465961,Dovish
4,35, 양말/NNG,39,0.16594596657591437,Dovish
13,28, 목표지/NNG,41,0.6741554892146522,Dovish
36,83, 사형/NNG,119,0.6297949333905184,Dovish
28,55,어음/NNG,83,0.7392138511108913,Dovish
6,21,연착륙/NNG,27,0.41486491643978596,Dovish
13,27, 휘청거릴/VV,40,0.6991242110374171,Dovish
22,51, 차인/NNG,73,0.6263646777620296,Dovish
12,27,액면/NNG,39,0.6453454255730003,Dovish
9,22, 많/VA;인상/NNG,31,0.5940111303569663,Dovish
10,23,경기민감/NNG,33,0.6313161771909785,Dovish
9,19, 황폐/NNG,28,0.687802361465961,Dovish
4,13, 연수생/NNG,17,0.44677760231976943,Dovish
8,32,경영난/NNG,40,0.36300680188481266,Dovish
19,38,제도개선/NNG,57,0.7260136037696254,Dovish
4,12, 주택구입/NNG;미루/VV,16,0.4840090691797502,Dovish
5,14,철회/NNG,19,0.5185811455497324,Dovish
7,19,인센티브/NNG,26,0.5349573922513029,Dovish
29,67,부지/NNG,96,0.6284893883378847,Dovish
38,76, 면책/NNG,114,0.7260136037696254,Dovish
41,79,파/NNG,120,0.7535837406216365,Dovish
6,16, 쓰러진/VV,22,0.5445102028272191,Dovish
4,12, 부동산중개사/NNG,16,0.4840090691797502,Dovish
9,26, 막대/NNG;경상/NNG;수지/NNG;흑자/NNG,35,0.5026248026097407,Dovish
16,32, 낮/VA;금리/NNG;오르/VV,48,0.7260136037696253,Dovish
16,38,무조건/MAG,54,0.6113798768586319,Dovish
21,45, 지녔/VV,66,0.6776126968516504,Dovish
8,23, 주식지수/NNG,31,0.5050529417527828,Dovish
55,135, 유가/NNG;부정적/VAX,190,0.5915666401085836,Dovish
24,47, 경기/NNG;지표/NNG;둔화/NNG,71,0.7414607017221707,Dovish
15,37, 날개/NNG;없/VA;추락/NNG,52,0.5886596787321287,Dovish
13,28, 경제/NNG;서서히/MAG;회복/NNG,41,0.6741554892146522,Dovish
5,14, 모아도/VV,19,0.5185811455497324,Dovish
4,12, 공격수/NNG,16,0.4840090691797502,Dovish
54,107, 헐/VV,161,0.7327987776366313,Dovish
6,12, 외부금융/NNG,18,0.7260136037696254,Dovish
27,62,현재생활형편/NNG,89,0.6323344290896737,Dovish
55,112, 관리관/NNG,167,0.7130490751308821,Dovish
5,11, 저성장/NNG;낮/VA,16,0.6600123670632958,Dovish
18,41, 기준가격/NNG;떨어/VV,59,0.637475359407476,Dovish
11,25, 망신/NNG,36,0.6388919713172704,Dovish
43,99,대학교/NNG,142,0.6306784840827048,Dovish
11,23, 에피소드/NNG,34,0.6944477949100765,Dovish
5,24,우/VV,29,0.30250566823734387,Dovish
10,22,출산율/NNG,32,0.6600123670632958,Dovish
4,22, 상환기금채권/NNG,26,0.26400494682531833,Dovish
12,35, 높/VA;금리/NNG;부담/NNG,47,0.49783789972774317,Dovish
14,32, 원화/NNG;내리/VV,46,0.6352619032984222,Dovish
8,22, 강박/NNG,30,0.5280098936506367,Dovish
11,26,獨/NNG,37,0.614319203189683,Dovish
9,24,폭탄/NNG,33,0.5445102028272191,Dovish
5,19, 화단/NNG,24,0.38211242303664494,Dovish
16,63, 과거사/NNG,79,0.36876881461314304,Dovish
87,187, 교육감/NNG,274,0.6755420698177262,Dovish
7,14, 에이즈/NNG,21,0.7260136037696254,Dovish
49,108,직/NNG,157,0.6587901219391046,Dovish
61,187,국감/NNG,248,0.47365593401012995,Dovish
2,15, 흑백/NNG,17,0.1936036276719001,Dovish
8,19, 지표/NNG;그리/MAG;좋/VA;않/VX,27,0.6113798768586319,Dovish
14,35, 연설자/NNG,49,0.5808108830157003,Dovish
5,13, 감사장/NNG,18,0.5584720028997119,Dovish
53,139,대법원/NNG,192,0.5536506618674841,Dovish
10,38, 상고심/NNG,48,0.38211242303664494,Dovish
6,20, 덜미/NNG,26,0.43560816226177523,Dovish
5,12, 경기/NNG;전망/NNG;나쁘/VA,17,0.6050113364746877,Dovish
7,16, 바꾼다고/VV,23,0.6352619032984222,Dovish
5,14, 트로피/NNG,19,0.5185811455497324,Dovish
5,11, 유가/NNG;상승/NNG;제한적/VAX,16,0.6600123670632958,Dovish
5,12, 무너질지/VV,17,0.6050113364746877,Dovish
17,44, 해외지점/NNG,61,0.5610105120038015,Dovish
6,12, 우려/NNG;시장/NNG;부담/NNG,18,0.7260136037696254,Dovish
62,140, 철거/NNG,202,0.6430406204816682,Dovish
19,45, 수령자/NNG,64,0.6130781542943504,Dovish
15,39, 매년/NNG,54,0.5584720028997118,Dovish
14,34, 따라선/VV,48,0.5978935560455738,Dovish
4,20, 떡값/NNG,24,0.29040544150785014,Dovish
3,18,대답/NNG,21,0.24200453458987514,Dovish
13,28, 寶/NNG,41,0.6741554892146522,Dovish
11,32,육아/NNG,43,0.4991343525916174,Dovish
12,34, 돌보/VV,46,0.5124801908962061,Dovish
20,43, 방과/NNG,63,0.6753614918787213,Dovish
4,13,생활안정/NNG,17,0.44677760231976943,Dovish
22,44, 기초수급자/NNG,66,0.7260136037696254,Dovish
7,29,최저생계비/NNG,36,0.3504893259577502,Dovish
6,16, 입상/NNG,22,0.5445102028272191,Dovish
4,13, 역외/NNG;매수/NNG;강화/NNG,17,0.44677760231976943,Dovish
4,13,코리아디스카운트/NNG,17,0.44677760231976943,Dovish
6,23, 외국인/NNG;주식자금/NNG;이탈/NNG,29,0.3787897063145872,Dovish
5,16,걷/VV,21,0.4537585023560159,Dovish
7,18, 농어촌특별세/NNG,25,0.5646772473763753,Dovish
5,18, 기업/NNG;실적/NNG;기대/NNG;높/VA,23,0.4033408909831252,Dovish
4,15,중증/NNG,19,0.3872072553438002,Dovish
3,20, 병상/NNG,23,0.21780408113088762,Dovish
23,44, 소아/NNG,67,0.7590142221227901,Dovish
6,15,전철/NNG,21,0.5808108830157004,Dovish
21,57, 저감/NNG,78,0.5349573922513029,Dovish
19,43,소외/NNG,62,0.6415934172847853,Dovish
13,44, 상병/NNG,57,0.42900803859114234,Dovish
8,27, 새터민/NNG,35,0.4302302837153335,Dovish
12,45, 교도소/NNG,57,0.38720725534380024,Dovish
10,21, 교통안전/NNG,31,0.6914415273996433,Dovish
15,43,임금피크제/NNG,58,0.506521118909041,Dovish
37,73,취약계층/NNG,110,0.7359589956020861,Dovish
5,15, 변동직불금/NNG,20,0.48400906917975023,Dovish
7,18, 을기금/NNG,25,0.5646772473763753,Dovish
36,76,어떻/VA,112,0.687802361465961,Dovish
3,16,생활자금/NNG,19,0.27225510141360953,Dovish
19,50, 무상지원/NNG,69,0.5517703388649153,Dovish
13,39, 끌어올린다는/VV,52,0.4840090691797503,Dovish
27,69, 심문/NNG,96,0.5681845594718807,Dovish
43,87, 출동/NNG,130,0.7176686198182504,Dovish
27,87,증액/NNG,114,0.45062913337425026,Dovish
5,11,병역/NNG,16,0.6600123670632958,Dovish
5,11, 어겨/VV,16,0.6600123670632958,Dovish
3,13,국회법/NNG,16,0.33508320173982714,Dovish
55,113,유망/NNG,168,0.706738906324414,Dovish
16,41,따지/VV,57,0.5666447639177564,Dovish
5,11,악셀/NNG,16,0.6600123670632958,Dovish
12,24, 권할/VV,36,0.7260136037696254,Dovish
5,18,과반수/NNG,23,0.4033408909831252,Dovish
9,33, 주택담보대출/NNG;금리/NNG;떨어/VV,42,0.3960074202379775,Dovish
6,13, 경기/NNG;회복/NNG;강하/VA;않/VX,19,0.6701664034796543,Dovish
5,13, 구소련/NNG,18,0.5584720028997119,Dovish
12,31, 실망/NNG;급락/NNG,43,0.5620750480797101,Dovish
431,925,금값/NNG,1356,0.6765661907561266,Dovish
10,24, 인플레이션/NNG;위험/NNG;크/VV,34,0.6050113364746877,Dovish
39,90, 농약/NNG,129,0.6292117899336753,Dovish
8,19,통업/NNG,27,0.6113798768586319,Dovish
6,14, 미/NNG;지표/NNG;부진/NNG,20,0.622297374659679,Dovish
23,45, 대기매물/NNG,68,0.7421472394089503,Dovish
6,16,수용/NNG,22,0.5445102028272191,Dovish
6,17, 여신/NNG;위험/NNG,23,0.5124801908962061,Dovish
6,12, 최악/NNG;떨어/VV,18,0.7260136037696254,Dovish
6,12, 단기물/NNG;시장/NNG;안정/NNG,18,0.7260136037696254,Dovish
6,13, 이자/NNG;수입/NNG;늘/VV,19,0.6701664034796543,Dovish
7,27, 금리/NNG;인상/NNG;이어지/VV;않/VX,34,0.37645149825091684,Dovish
12,24, 달치/NNG,36,0.7260136037696254,Dovish
8,16,아리랑본드/NNG,24,0.7260136037696253,Dovish
9,20, 진출입/NNG,29,0.6534122433926629,Dovish
4,15, 주문취소/NNG,19,0.3872072553438002,Dovish
25,55, bbb+등급/NNG,80,0.6600123670632958,Dovish
4,17,체납/NNG,21,0.3416534605974707,Dovish
5,23, 소비/NNG;내수/NNG;회복/NNG,28,0.3156580885954893,Dovish
3,13, 고만고만/NNG,16,0.33508320173982714,Dovish
28,56,투입/NNG,84,0.7260136037696254,Dovish
25,48, 펼친다/VV,73,0.7562641705933597,Dovish
39,80, 떡/NNG,119,0.7078632636753848,Dovish
9,19, 잿빛/NNG,28,0.687802361465961,Dovish
10,21, 도통/NNG,31,0.6914415273996433,Dovish
8,16, 신용스프레드/NNG;상승/NNG,24,0.7260136037696253,Dovish
8,27, 고분/NNG,35,0.4302302837153335,Dovish
4,14,개천절/NNG,18,0.41486491643978596,Dovish
10,32,랜드마크/NNG,42,0.4537585023560159,Dovish
17,48, 소비/NNG;지출/NNG;pce/NNG;물가/NNG;상승/NNG,65,0.5142596360034847,Dovish
55,137, 원달러/NNG;내리/VV,192,0.5829306307639328,Dovish
5,13, 수익구조/NNG;악화/NNG,18,0.5584720028997119,Dovish
29,58, 밝힌다/VV,87,0.7260136037696254,Dovish
9,23, 먹잇감/NNG,32,0.5681845594718807,Dovish
16,35, 물려주/VV,51,0.6637838663036575,Dovish
9,21, 친근/NNG,30,0.6222973746596789,Dovish
8,17, 지침서/NNG,25,0.6833069211949414,Dovish
4,12, 주주식/NNG,16,0.4840090691797502,Dovish
22,70,뒤늦/VA,92,0.4563514080837645,Dovish
3,34, 감경/NNG,37,0.12812004772405153,Dovish
7,20, 사회기반시설투자/NNG,27,0.5082095226387378,Dovish
6,13, 기념비/NNG,19,0.6701664034796543,Dovish
47,94,순손실/NNG,141,0.7260136037696254,Dovish
14,30, 예상/NNG;낮/VV,44,0.6776126968516504,Dovish
19,40,지원책/NNG,59,0.6897129235811441,Dovish
5,24, 순채무/NNG,29,0.30250566823734387,Dovish
6,16,본업/NNG,22,0.5445102028272191,Dovish
42,98,사업부/NNG,140,0.6222973746596789,Dovish
20,40, 예탁자산/NNG,60,0.7260136037696254,Dovish
14,29, 퀴즈/NNG,43,0.7009786519155004,Dovish
3,18,형평/NNG,21,0.24200453458987514,Dovish
17,45, 책임질/VV,62,0.5485436117370504,Dovish
11,35, 안긴/VV,46,0.4563514080837645,Dovish
9,19, 국제/NNG;유가/NNG;넘/VV,28,0.687802361465961,Dovish
5,14, 환경/NNG;호전/NNG,19,0.5185811455497324,Dovish
8,17, 구내/NNG,25,0.6833069211949414,Dovish
7,17, 가격/NNG;작/VA,24,0.5978935560455738,Dovish
5,17, 자본이득세/NNG,22,0.42706682574683846,Dovish
4,13, 부채/NNG;증가/NNG;억제/NNG,17,0.44677760231976943,Dovish
10,22, 가계/NNG;지출/NNG;증가/NNG,32,0.6600123670632958,Dovish
22,45, 점차/MAG;상승/NNG;줄/VV,67,0.7098799681303004,Dovish
8,20,신성장/NNG,28,0.5808108830157003,Dovish
25,51, 비치/NNG,76,0.7117780429113975,Dovish
5,13, 지표/NNG;충격/NNG,18,0.5584720028997119,Dovish
22,51,국민소득/NNG,73,0.6263646777620296,Dovish
6,31, 부시장/NNG,37,0.28103752403985505,Dovish
6,13, 순순히/MAG,19,0.6701664034796543,Dovish
15,30, 적혀/VV,45,0.7260136037696253,Dovish
13,66, 권리금/NNG,79,0.2860053590607615,Dovish
31,107,건물/NNG,138,0.4206807797543624,Dovish
33,75, 비니/NNG,108,0.6388919713172703,Dovish
38,73,비금속/NNG,111,0.7558497792670074,Dovish
5,11, 경제/NNG;둔화/NNG;위험/NNG,16,0.6600123670632958,Dovish
16,40, 다가갔/VV,56,0.5808108830157003,Dovish
6,16,법사/NNG,22,0.5445102028272191,Dovish
8,22, 지킨다는/VV,30,0.5280098936506367,Dovish
6,14, 유통비용/NNG,20,0.622297374659679,Dovish
6,18,종업원/NNG,24,0.4840090691797503,Dovish
5,20,등/NNG,25,0.3630068018848127,Dovish
6,25, 우려/NNG;쏟/VV,31,0.34848652980942024,Dovish
8,26, 짊어져야/VV,34,0.44677760231976943,Dovish
44,152, gdp/NNG;갭/NNG;마이너스/NNG,196,0.42032366534030946,Dovish
6,15, 국고채/NNG;내리/VV;국고채/NNG;떨어/VV,21,0.5808108830157004,Dovish
214,522,지준/NNG,736,0.5952755218647503,Dovish
7,19,제2차세계대전/NNG,26,0.5349573922513029,Dovish
8,19,보급/NNG,27,0.6113798768586319,Dovish
5,16, 일거수일투족/NNG,21,0.4537585023560159,Dovish
9,21, 때론/MAG,30,0.6222973746596789,Dovish
14,33,해지/NNG,47,0.6160115425924094,Dovish
22,48,그해/NNG,70,0.6655124701221565,Dovish
7,25, 금리/NNG;ff/NNG;금리/NNG;오르/VV,32,0.40656761811099024,Dovish
4,13, 괴롭힌/VV,17,0.44677760231976943,Dovish
12,24, 탈락자/NNG,36,0.7260136037696254,Dovish
4,14, 경제/NNG;무리/NNG,18,0.41486491643978596,Dovish
10,33,계층/NNG,43,0.44000824470886385,Dovish
20,51, 개보/NNG,71,0.5694224343291179,Dovish
6,14, 방패막이/NNG,20,0.622297374659679,Dovish
35,78, 수의계약/NNG,113,0.6515506700496638,Dovish
8,26, 추기경/NNG,34,0.44677760231976943,Dovish
7,15, 사우/NNG,22,0.6776126968516504,Dovish
9,38, 대체투자상품/NNG,47,0.3439011807329805,Dovish
4,12, 펼쳤으나/VV,16,0.4840090691797502,Dovish
8,17, 혈맥/NNG,25,0.6833069211949414,Dovish
6,15, 심혈관/NNG,21,0.5808108830157004,Dovish
5,12, 국자/NNG,17,0.6050113364746877,Dovish
9,20,여러모로/MAG,29,0.6534122433926629,Dovish
3,13, 인플레이션/NNG;목표/NNG;낮/VA,16,0.33508320173982714,Dovish
6,15, 원달러/NNG;내림/NNG,21,0.5808108830157004,Dovish
7,15, 살린다는/VV,22,0.6776126968516504,Dovish
7,18, 고용자수/NNG;상향/NNG,25,0.5646772473763753,Dovish
9,24,다스/NNG,33,0.5445102028272191,Dovish
117,340, 공천/NNG,457,0.49966818612380104,Dovish
6,19,재보/NNG,25,0.458534907643974,Dovish
18,36, 실물/NNG;지표/NNG;개선/NNG,54,0.7260136037696254,Dovish
5,16, 수용성/NNG,21,0.4537585023560159,Dovish
15,37,발급/NNG,52,0.5886596787321287,Dovish
39,93, 패밀리/NNG,132,0.6089146354196858,Dovish
5,16, 데이/VV,21,0.4537585023560159,Dovish
16,37, 거시/NNG;회복/NNG,53,0.6279036573142706,Dovish
11,23, 고용자수/NNG;줄/VV,34,0.6944477949100765,Dovish
7,15, 위기/NNG;최대/NNG,22,0.6776126968516504,Dovish
38,76,원론/NNG,114,0.7260136037696254,Dovish
16,37, 바랐/VV,53,0.6279036573142706,Dovish
7,16,감자/NNG,23,0.6352619032984222,Dovish
97,279, 가계/NNG;부채/NNG;늘/VV,376,0.5048266635530729,Dovish
1,26, 수류탄/NNG,27,0.05584720028997118,Dovish
17,50,비리/NNG,67,0.49368925056334534,Dovish
11,28,짜리/NNG,39,0.5704392601047057,Dovish
5,13, 은연중/NNG,18,0.5584720028997119,Dovish
5,11, 금리/NNG;자신/NNG,16,0.6600123670632958,Dovish
12,26,시뮬레이션/NNG,38,0.6701664034796543,Dovish
5,19,책정/NNG,24,0.38211242303664494,Dovish
12,23,불참/NNG,35,0.7575794126291744,Dovish
17,33, 두말/NNG,50,0.7480140160050687,Dovish
5,13, 그르/VV,18,0.5584720028997119,Dovish
9,18, 가한다/VV,27,0.7260136037696254,Dovish
7,26, 짜여진/VV,33,0.3909304020297983,Dovish
6,15, 인상파/NNG,21,0.5808108830157004,Dovish
7,17, 가동률/NNG;높/VA,24,0.5978935560455738,Dovish
19,37, 그달/NNG,56,0.7456355930606964,Dovish
7,16,외상/NNG,23,0.6352619032984222,Dovish
5,13, 재시/NNG,18,0.5584720028997119,Dovish
24,47, 수매/NNG,71,0.7414607017221707,Dovish
5,16, 위자료/NNG,21,0.4537585023560159,Dovish
12,49, 연습장/NNG,61,0.3555984998055308,Dovish
29,72, 꼼꼼/MAG,101,0.5848442919255316,Dovish
4,13, 중소기업/NNG;대출/NNG;촉진/NNG,17,0.44677760231976943,Dovish
11,28,움직임/VV,39,0.5704392601047057,Dovish
4,12, 창안/NNG,16,0.4840090691797502,Dovish
10,22, 어렵/VA;금리/NNG;오르/VV,32,0.6600123670632958,Dovish
8,22,총량/NNG,30,0.5280098936506367,Dovish
14,32,하치/NNG,46,0.6352619032984222,Dovish
11,38, 어온/NNG,49,0.42032366534030946,Dovish
65,138,분양시장/NNG,203,0.68392585862356,Dovish
34,83, 죄송/NNG,117,0.5948063259799341,Dovish
11,48,주류/NNG,59,0.33275623506107826,Dovish
2,24, 구호물자/NNG,26,0.12100226729493754,Dovish
11,23, 택해야/VV,34,0.6944477949100765,Dovish
3,17, 기업/NNG;실적/NNG;시장/NNG;예상/NNG;웃돌/VV,20,0.25624009544810306,Dovish
7,21, 상환수수료/NNG,28,0.4840090691797503,Dovish
8,22, 물어본/VV,30,0.5280098936506367,Dovish
7,17, 총금융자산/NNG,24,0.5978935560455738,Dovish
4,16, 부채/NNG;안정/NNG,20,0.36300680188481266,Dovish
21,43,추이/NNG,64,0.7091295664726573,Dovish
13,30, 실적/NNG;예상/NNG;좋/VA,43,0.6292117899336753,Dovish
23,58, 예상/NNG;좋/VA;않/VX,81,0.5758038926448753,Dovish
15,33,사후/NNG,48,0.6600123670632958,Dovish
20,42, 첩보/NNG,62,0.6914415273996433,Dovish
23,45, 민간/NNG;소비/NNG;늘/VV,68,0.7421472394089503,Dovish
17,44, 하락/NNG;벗어나/VV;못하/VX,61,0.5610105120038015,Dovish
8,22, 경제/NNG;작/VA;않/VX,30,0.5280098936506367,Dovish
26,69, 변액연금보험/NNG,95,0.5471406868988481,Dovish
1289,2983,양적완화/NNG,4272,0.6274432016487075,Dovish
19,38,용품/NNG,57,0.7260136037696254,Dovish
70,258, 객실/NNG,328,0.39396087026258747,Dovish
6,14,따져/VV,20,0.622297374659679,Dovish
5,12, 정책/NNG;대응/NNG;늦/VA,17,0.6050113364746877,Dovish
8,16, 채권/NNG;가격/NNG;하락/NNG;압력/NNG,24,0.7260136037696253,Dovish
18,35, 신청금액/NNG,53,0.7467568495916148,Dovish
18,37, 터무니없이/MAG,55,0.7063916144785545,Dovish
6,13, 치뤘/VV,19,0.6701664034796543,Dovish
11,24,대표팀/NNG,35,0.6655124701221565,Dovish
3,15,데뷔/NNG,18,0.2904054415078502,Dovish
6,12, 안중/NNG,18,0.7260136037696254,Dovish
5,16, 가계/NNG;부채/NNG;부담/NNG;줄/VV,21,0.4537585023560159,Dovish
17,34, 전망/NNG;최저/NNG,51,0.7260136037696254,Dovish
7,59, 관세화/NNG,66,0.17227441445380942,Dovish
11,30, 고용/NNG;지표/NNG;둔화/NNG,41,0.5324099760977252,Dovish
12,29, 기업/NNG;심리/NNG;개선/NNG,41,0.6008388444990004,Dovish
9,18, 위기감/NNG;증폭/NNG,27,0.7260136037696254,Dovish
6,20, 우려/NNG;국제/NNG;유가/NNG;하락/NNG,26,0.43560816226177523,Dovish
15,35, 좋/VA;상승/NNG,50,0.6222973746596789,Dovish
12,31, 채권시장/NNG;영향/NNG;줄/VV,43,0.5620750480797101,Dovish
7,18, 내로라/NNG,25,0.5646772473763753,Dovish
7,19,순매도금액/NNG,26,0.5349573922513029,Dovish
39,79,시공/NNG,118,0.7168235581522884,Dovish
6,13, 불안/NNG;없애/VV,19,0.6701664034796543,Dovish
5,11, 떠난다는/VV,16,0.6600123670632958,Dovish
3,15, 금리/NNG;인상/NNG;유가/NNG;상승/NNG,18,0.2904054415078502,Dovish
23,50,여간/MAG,73,0.6679325154680553,Dovish
6,15, 금리/NNG;상승/NNG;가속/NNG,21,0.5808108830157004,Dovish
13,34, 외환보유액/NNG;많/VA,47,0.55518687347089,Dovish
31,69, 높/VA;수익률/NNG;떨어/VV,100,0.6523600497640113,Dovish
15,30,개발사업/NNG,45,0.7260136037696253,Dovish
24,69, 내몰렸/VV,93,0.5050529417527829,Dovish
20,44,잃어버린/VV,64,0.6600123670632958,Dovish
10,23, 저점/NNG;내리/VV,33,0.6313161771909785,Dovish
14,30,패턴/NNG,44,0.6776126968516504,Dovish
39,113, 수니파/NNG,152,0.5011421335754936,Dovish
20,42,英/NNG,62,0.6914415273996433,Dovish
30,61, 원로/NNG,91,0.7141117414127462,Dovish
105,224,이용/NNG,329,0.6806377535340239,Dovish
22,53, 인파/NNG,75,0.6027282748276136,Dovish
15,38, 건넨/VV,53,0.5731686345549674,Dovish
4,12,재무담당자/NNG,16,0.4840090691797502,Dovish
8,31, 프리랜서/NNG,39,0.3747166987198067,Dovish
12,24, 차림/NNG,36,0.7260136037696254,Dovish
9,18, 神/NNG,27,0.7260136037696254,Dovish
167,356,철/NNG,523,0.681147594547907,Dovish
13,28,노근/NNG,41,0.6741554892146522,Dovish
6,14, 신흥시장/NNG;이탈/NNG,20,0.622297374659679,Dovish
10,27, 수익/NNG;상승/NNG,37,0.5377878546441669,Dovish
3,17,동북부/NNG,20,0.25624009544810306,Dovish
8,18, 흠결/NNG,26,0.6453454255730003,Dovish
37,91, 통화/NNG;떨어/VV,128,0.5903846887796954,Dovish
12,31, 세계/NNG;성장/NNG;둔화/NNG,43,0.5620750480797101,Dovish
20,44, 경제/NNG;성장률/NNG;밑돌/VV,64,0.6600123670632958,Dovish
16,42,불리/VV,58,0.5531532219197145,Dovish
14,27, 금요/NNG,41,0.7529029965018337,Dovish
14,42, 밀렸으며/VV,56,0.4840090691797503,Dovish
16,37, 증하/VA,53,0.6279036573142706,Dovish
8,20, 털기/NNG,28,0.5808108830157003,Dovish
36,69, 글로벌/NNG;경제/NNG;둔화/NNG,105,0.7575794126291744,Dovish
7,16, 나쁘/VA;금리/NNG;인상/NNG,23,0.6352619032984222,Dovish
31,72, 연이율/NNG,103,0.6251783810238442,Dovish
5,14, 고친/VV,19,0.5185811455497324,Dovish
5,11, 노인회/NNG,16,0.6600123670632958,Dovish
5,14, 강화군/NNG,19,0.5185811455497324,Dovish
3,13, 하이드로/NNG,16,0.33508320173982714,Dovish
17,37,선착순/NNG,54,0.6671476358964126,Dovish
9,24, 성장/NNG;잠재력/NNG;크/VV,33,0.5445102028272191,Dovish
15,51,민자/NNG,66,0.4270668257468384,Dovish
6,20, 거둬야/VV,26,0.43560816226177523,Dovish
6,15, 지쳤/VV,21,0.5808108830157004,Dovish
9,19, 돌아온다는/VV,28,0.687802361465961,Dovish
9,20, 글로벌/NNG;금리/NNG;인상/NNG;우려/NNG,29,0.6534122433926629,Dovish
11,32,근로시간/NNG,43,0.4991343525916174,Dovish
10,22, 빙/NNG,32,0.6600123670632958,Dovish
4,14, 매우/MAG;건전/NNG,18,0.41486491643978596,Dovish
7,33, 순이익/NNG;예상/NNG;상회/NNG,40,0.3080057712962047,Dovish
7,19, 통안채/NNG;수익률/NNG;오르/VV,26,0.5349573922513029,Dovish
9,19, 허구/NNG,28,0.687802361465961,Dovish
37,78,만난/VV,115,0.6887821369096446,Dovish
33,68,아트/NNG,101,0.7046602624822833,Dovish
20,68,톰/NNG,88,0.42706682574683846,Dovish
25,48, 중위소득/NNG,73,0.7562641705933597,Dovish
11,27,즈/NNG,38,0.5915666401085836,Dovish
8,27, 홍보물/NNG,35,0.4302302837153335,Dovish
19,50, 채권/NNG;가격/NNG;내리/VV,69,0.5517703388649153,Dovish
16,31, 실적/NNG;견조/NNG,47,0.7494333974396133,Dovish
12,30,구정/NNG,42,0.5808108830157004,Dovish
5,11, 가계/NNG;대출/NNG;금리/NNG;인상/NNG,16,0.6600123670632958,Dovish
17,34,면담/NNG,51,0.7260136037696254,Dovish
4,16, 마사회/NNG,20,0.36300680188481266,Dovish
16,34, 국제/NNG;유가/NNG;소폭/MAG;하락/NNG,50,0.6833069211949414,Dovish
6,15,손쉽/VA,21,0.5808108830157004,Dovish
5,12,에너지산업/NNG,17,0.6050113364746877,Dovish
8,17, 탕진/NNG,25,0.6833069211949414,Dovish
8,16, 니트/NNG,24,0.7260136037696253,Dovish
8,22, 물가/NNG;지표/NNG;금리/NNG;인상/NNG,30,0.5280098936506367,Dovish
7,23, 움직였으며/VV,30,0.441921324033685,Dovish
5,14, 디플레이션/NNG;빠지/VV;위험/NNG,19,0.5185811455497324,Dovish
7,16, 얼룩진/VV,23,0.6352619032984222,Dovish
14,42, 자신/NNG;강화/NNG,56,0.4840090691797503,Dovish
14,32, 제자/NNG,46,0.6352619032984222,Dovish
3,13,깐깐/NNG,16,0.33508320173982714,Dovish
20,42, 물음표/NNG,62,0.6914415273996433,Dovish
228,475,차기/NNG,703,0.6969730596188404,Dovish
25,79,리더/NNG,104,0.4595022808668516,Dovish
36,80,발권력/NNG,116,0.6534122433926629,Dovish
4,22,파티/NNG,26,0.26400494682531833,Dovish
15,29,덜/MAG,44,0.7510485556237504,Dovish
27,65, 혹평/NNG,92,0.6031497631316889,Dovish
25,76, 낙점/NNG,101,0.4776405287958062,Dovish
17,49, 레인지장/NNG,66,0.5037645413911687,Dovish
16,32, 이토/NNG,48,0.7260136037696253,Dovish
7,22, fed/NNG;금리/NNG;인상/NNG;강하/VA,29,0.4620086569443071,Dovish
8,21,쓴/VV,29,0.5531532219197145,Dovish
18,38,리턴/NNG,56,0.687802361465961,Dovish
1280,3004,구간/NNG,4284,0.6187066663283093,Dovish
6,13,광산주/NNG,19,0.6701664034796543,Dovish
37,71,심의/NNG,108,0.7566902349148208,Dovish
32,74, 제보/NNG,106,0.6279036573142706,Dovish
6,14, 숨죽여/VV,20,0.622297374659679,Dovish
12,26, 출입문/NNG,38,0.6701664034796543,Dovish
15,41,출자전환/NNG,56,0.5312294661728967,Dovish
7,15,대법관/NNG,22,0.6776126968516504,Dovish
13,31, 법관/NNG,44,0.6089146354196858,Dovish
52,103,경찰청/NNG,155,0.7330622795343791,Dovish
7,14, 가격/NNG;하락/NNG;상쇄/NNG,21,0.7260136037696254,Dovish
67,135, 유족/NNG,202,0.7206357252231836,Dovish
4,13,구도/NNG,17,0.44677760231976943,Dovish
6,21,엄밀히/MAG,27,0.41486491643978596,Dovish
211,507, 외환선물/NNG,718,0.6042953467273805,Dovish
45,102, 신용스프레드/NNG;확대/NNG,147,0.6406002386202576,Dovish
17,34,장단기물/NNG,51,0.7260136037696254,Dovish
11,30, 지표/NNG;바닥/NNG,41,0.5324099760977252,Dovish
23,56,최선호주/NNG,79,0.5963683173821923,Dovish
7,14,양방향/NNG,21,0.7260136037696254,Dovish
7,18, 매출원가/NNG,25,0.5646772473763753,Dovish
14,33,농민/NNG,47,0.6160115425924094,Dovish
15,33, 넘겨진/VV,48,0.6600123670632958,Dovish
61,136, 격리/NNG,197,0.6512769092639287,Dovish
9,23, 매달려/VV,32,0.5681845594718807,Dovish
6,15, 질려/VV,21,0.5808108830157004,Dovish
133,379,파리/NNG,512,0.509550444862059,Dovish
6,15, 실망/NNG;줄/VV,21,0.5808108830157004,Dovish
22,45, 암살/NNG,67,0.7098799681303004,Dovish
9,20,경영전략/NNG,29,0.6534122433926629,Dovish
69,173, 카페/NNG,242,0.5791322388451348,Dovish
8,21, 신용스프레드/NNG;줄/VV,29,0.5531532219197145,Dovish
12,24,규칙/NNG,36,0.7260136037696254,Dovish
15,32, 야채/NNG,47,0.6806377535340238,Dovish
12,23, 칭송/NNG,35,0.7575794126291744,Dovish
23,59,쏟/VV,82,0.5660445046339452,Dovish
5,13, 투자/NNG;내리/VV,18,0.5584720028997119,Dovish
72,203,g7/NNG,275,0.515004723856286,Dovish
26,52,구제/NNG,78,0.7260136037696254,Dovish
5,27,탐욕/NNG,32,0.26889392732208345,Dovish
8,16, 로비스트/NNG,24,0.7260136037696253,Dovish
7,27, 양가/NNG,34,0.37645149825091684,Dovish
8,18, 닥쳐올/VV,26,0.6453454255730003,Dovish
6,18, 흰색/NNG,24,0.4840090691797503,Dovish
20,40, 복판/NNG,60,0.7260136037696254,Dovish
8,27, 도표/NNG,35,0.4302302837153335,Dovish
5,12,배당지수/NNG,17,0.6050113364746877,Dovish
16,38,알파/NNG,54,0.6113798768586319,Dovish
6,13, 주거비/NNG;부담/NNG;덜/VV,19,0.6701664034796543,Dovish
3,22, 농업정책자금/NNG;금리/NNG;인하/NNG,25,0.19800371011898876,Dovish
10,33, 대지면적/NNG,43,0.44000824470886385,Dovish
6,14, 기생충/NNG,20,0.622297374659679,Dovish
6,14, 캐물/VV,20,0.622297374659679,Dovish
16,32,필수소비재/NNG,48,0.7260136037696253,Dovish
26,56,증세/NNG,82,0.6741554892146522,Dovish
9,18, 찍힐/VV,27,0.7260136037696254,Dovish
6,25, 당자/NNG,31,0.34848652980942024,Dovish
4,12, 일으킨다는/VV,16,0.4840090691797502,Dovish
7,14, 적자/NNG;면하/VV;못하/VX,21,0.7260136037696254,Dovish
21,44, 판매보수/NNG,65,0.6930129854164606,Dovish
21,58,고령자/NNG,79,0.5257339889366253,Dovish
9,29,이용자/NNG,38,0.45062913337425026,Dovish
26,70, 들여다볼/VV,96,0.5393243913717217,Dovish
22,51, 리퍼/NNG,73,0.6263646777620296,Dovish
82,163,지하철/NNG,245,0.730467674958396,Dovish
9,21, 상업지구/NNG,30,0.6222973746596789,Dovish
121,322,신조/NNG,443,0.5456375531436315,Dovish
52,118, 관방/NNG,170,0.6398763965427208,Dovish
7,17, 단기/NNG;외채/NNG;늘/VV,24,0.5978935560455738,Dovish
139,289,aa-등급/NNG,428,0.6983798679860065,Dovish
22,56, 금리/NNG;마이너스/NNG;떨어/VV,78,0.5704392601047057,Dovish
12,30, 유조/NNG,42,0.5808108830157004,Dovish
30,72, 대출/NNG;금리/NNG;떨어/VV,102,0.6050113364746877,Dovish
25,77, 디플레이션/NNG;물가/NNG;하락/NNG,102,0.4714374050452113,Dovish
7,15, 내추럴/NNG,22,0.6776126968516504,Dovish
5,13,차등/NNG,18,0.5584720028997119,Dovish
7,15, 네임/NNG,22,0.6776126968516504,Dovish
8,19, 속타/VV,27,0.6113798768586319,Dovish
6,17,품질/NNG,23,0.5124801908962061,Dovish
12,24, 사라진다는/VV,36,0.7260136037696254,Dovish
18,36, 신축성/NNG,54,0.7260136037696254,Dovish
6,19,세목/NNG,25,0.458534907643974,Dovish
12,33,배추/NNG,45,0.5280098936506367,Dovish
13,34, 하수/NNG,47,0.55518687347089,Dovish
6,12, 달성군/NNG,18,0.7260136037696254,Dovish
21,69,담합/NNG,90,0.441921324033685,Dovish
26,63,이코노믹/NNG,89,0.5992493237463574,Dovish
15,31, ecb/NNG;경기/NNG;회복/NNG,46,0.7025938100996375,Dovish
20,46, 금리정책회의/NNG,66,0.6313161771909785,Dovish
18,40, 우려/NNG;강하/VA,58,0.6534122433926629,Dovish
11,23,사들이/VV,34,0.6944477949100765,Dovish
25,53,국적/NNG,78,0.6849184941222882,Dovish
8,18,원수/NNG,26,0.6453454255730003,Dovish
7,20, 예상/NNG;웃돌/VV;오르/VV,27,0.5082095226387378,Dovish
8,17, 애타/VV,25,0.6833069211949414,Dovish
56,115,전하/VV,171,0.7070741184538961,Dovish
8,17, 채권/NNG;금리/NNG;내림/NNG,25,0.6833069211949414,Dovish
4,15, 고마움/NNG,19,0.3872072553438002,Dovish
37,77, 고용/NNG;지표/NNG;예상/NNG;부진/NNG,114,0.6977273594669127,Dovish
9,19, 차입거래/NNG,28,0.687802361465961,Dovish
5,15, 자산유동화법/NNG,20,0.48400906917975023,Dovish
6,14, 대출/NNG;건전성/NNG;악화/NNG,20,0.622297374659679,Dovish
5,13, 프로덕트/NNG,18,0.5584720028997119,Dovish
9,23, 약방문/NNG,32,0.5681845594718807,Dovish
71,154,안전/NNG,225,0.6694411151642,Dovish
13,38,청문/NNG,51,0.49674614994763844,Dovish
11,26, 단박/NNG,37,0.614319203189683,Dovish
5,12,시스템스/NNG,17,0.6050113364746877,Dovish
5,13, 금리/NNG;인상/NNG;피하/VV,18,0.5584720028997119,Dovish
10,49, 발품/NNG,59,0.2963320831712757,Dovish
4,17, 샅샅이/MAG,21,0.3416534605974707,Dovish
14,28,시장조사/NNG,42,0.7260136037696254,Dovish
5,11, 고정/NNG;금리/NNG;높/VA,16,0.6600123670632958,Dovish
31,70, 사본/NNG,101,0.6430406204816682,Dovish
13,36, 소유권이전등기/NNG,49,0.5243431582780628,Dovish
5,13, 물가/NNG;상승률/NNG;우려/NNG,18,0.5584720028997119,Dovish
24,59,자격/NNG,83,0.5906551352702037,Dovish
6,12, 돌아갈지/VV,18,0.7260136037696254,Dovish
73,186, 고용/NNG;지표/NNG;실망/NNG,259,0.5698816459697059,Dovish
5,12,대형기업/NNG,17,0.6050113364746877,Dovish
15,31, 달러원/NNG;하방/NNG;경직/NNG,46,0.7025938100996375,Dovish
5,16, 포섭/NNG,21,0.4537585023560159,Dovish
15,41,금리자유화/NNG,56,0.5312294661728967,Dovish
8,24, 선납금/NNG,32,0.4840090691797502,Dovish
40,84,연봉/NNG,124,0.6914415273996433,Dovish
38,211,유로그룹/NNG,249,0.2615025302677324,Dovish
1,15, 주거전용면적/NNG,16,0.09680181383595005,Dovish
27,53, 끼쳐/VV,80,0.7397119736520712,Dovish
17,36, 물가/NNG;상승률/NNG;낮/VV,53,0.6856795146713129,Dovish
13,25,보험개발원/NNG,38,0.7550541479204105,Dovish
11,22, 보험개발원/NNG,33,0.7260136037696254,Dovish
15,38, 국고채/NNG;금리/NNG;넘/VV,53,0.5731686345549674,Dovish
5,14, 가계/NNG;대출/NNG;둔화/NNG,19,0.5185811455497324,Dovish
6,13, 중소기업/NNG;도산/NNG,19,0.6701664034796543,Dovish
15,30, 재일/NNG,45,0.7260136037696253,Dovish
5,12, 경제/NNG;활황/NNG,17,0.6050113364746877,Dovish
6,14,투자사/NNG,20,0.622297374659679,Dovish
6,15, 금리/NNG;인상/NNG;시장/NNG;충격/NNG,21,0.5808108830157004,Dovish
9,18, 환차/NNG,27,0.7260136037696254,Dovish
23,46, 수출/NNG;좋/VA,69,0.7260136037696253,Dovish
5,13, 자잘/NNG,18,0.5584720028997119,Dovish
10,23, 도둑/NNG,33,0.6313161771909785,Dovish
11,27, 국채선물/NNG;상승/NNG;확대/NNG,38,0.5915666401085836,Dovish
25,51,일어나/VV,76,0.7117780429113975,Dovish
10,24, 연례행사/NNG,34,0.6050113364746877,Dovish
15,55,사망자/NNG,70,0.39600742023797747,Dovish
14,33, 촌/NNG,47,0.6160115425924094,Dovish
169,347, 베이시스포인트/NNG,516,0.7071832797525458,Dovish
15,30, 유배/NNG,45,0.7260136037696253,Dovish
9,19, 색상/NNG,28,0.687802361465961,Dovish
4,13,보석/NNG,17,0.44677760231976943,Dovish
8,16,지상파/NNG,24,0.7260136037696253,Dovish
29,82, 나온다며/VV,111,0.5135218173004668,Dovish
6,12, 재정/NNG;건전성/NNG;위협/NNG,18,0.7260136037696254,Dovish
16,37,직면/NNG,53,0.6279036573142706,Dovish
2,14, 수납장/NNG,16,0.20743245821989298,Dovish
10,23, 베이시스/NNG;강세/NNG,33,0.6313161771909785,Dovish
140,277, 달러엔/NNG;환율/NNG;하락/NNG,417,0.733876566987347,Dovish
3,15, 금리/NNG;인상/NNG;그리/MAG;멀/VA;않/VX,18,0.2904054415078502,Dovish
8,18, 내수/NNG;좋/VA,26,0.6453454255730003,Dovish
15,29,베팅/NNG,44,0.7510485556237504,Dovish
20,64, 비뉴/NNG,84,0.4537585023560159,Dovish
102,251,마르/NNG,353,0.5900668333426438,Dovish
31,61, 몰이/NNG,92,0.7379154661265046,Dovish
5,11, 차월물/NNG,16,0.6600123670632958,Dovish
4,23,리브/NNG,27,0.2525264708763914,Dovish
64,131, 농어/NNG,195,0.7093873380344431,Dovish
6,14, 기여금/NNG,20,0.622297374659679,Dovish
2,14, 품인/NNG,16,0.20743245821989298,Dovish
11,35, 재도/NNG,46,0.4563514080837645,Dovish
19,53, 실생활/NNG,72,0.520538055532939,Dovish
12,34, 예비타당성조사/NNG,46,0.5124801908962061,Dovish
5,15, 추풍낙엽/NNG,20,0.48400906917975023,Dovish
5,11, 판매보수/NNG;인하/NNG,16,0.6600123670632958,Dovish
26,70, 신조어/NNG,96,0.5393243913717217,Dovish
18,64,연말정산/NNG,82,0.4083826521204143,Dovish
37,79,중도상환수수료/NNG,116,0.6800633756829403,Dovish
7,20,재무설계/NNG,27,0.5082095226387378,Dovish
23,58, 대전환/NNG,81,0.5758038926448753,Dovish
6,12,만기구조/NNG,18,0.7260136037696254,Dovish
2,15, 기대/NNG;가라앉/VV,17,0.1936036276719001,Dovish
3,19,개회사/NNG,22,0.229267453821987,Dovish
46,124, 이자/NNG;부담/NNG;줄/VV,170,0.5386552544097221,Dovish
6,13, 적자/NNG;증가/NNG,19,0.6701664034796543,Dovish
8,17,기축통화국/NNG,25,0.6833069211949414,Dovish
4,26, 결산일/NNG,30,0.22338880115988471,Dovish
24,77, 강동/MAG,101,0.4525799088434029,Dovish
3,13, 물가/NNG;국제/NNG;유가/NNG;하락/NNG,16,0.33508320173982714,Dovish
33,67, 거둬들인/VV,100,0.7151775798327653,Dovish
7,16, 가격/NNG;하락/NNG;안정/NNG,23,0.6352619032984222,Dovish
69,142,인사청문회/NNG,211,0.7055625163394951,Dovish
8,19, 실속형/NNG,27,0.6113798768586319,Dovish
14,31, 전문사/NNG,45,0.6557542227596617,Dovish
4,12,노무/NNG,16,0.4840090691797502,Dovish
29,71, 발제/NNG,100,0.5930815354737784,Dovish
6,14,베타/NNG,20,0.622297374659679,Dovish
7,15, gdp/NNG;성장률/NNG;오르/VV,22,0.6776126968516504,Dovish
25,79,db/NNG,104,0.4595022808668516,Dovish
5,14,연금제도/NNG,19,0.5185811455497324,Dovish
7,15, 기업/NNG;부담/NNG;줄/VV,22,0.6776126968516504,Dovish
29,66, 은퇴설계/NNG,95,0.6380119548278526,Dovish
3,17, 금리/NNG;자제/NNG,20,0.25624009544810306,Dovish
6,22, 인수인계/NNG,28,0.3960074202379775,Dovish
11,47, 물가/NNG;지표/NNG;상승/NNG,58,0.3398361549559949,Dovish
9,23,빈곤/NNG,32,0.5681845594718807,Dovish
5,13, 회사채/NNG;신용등급/NNG;상향/NNG,18,0.5584720028997119,Dovish
29,96,질의응답/NNG,125,0.43863321894414864,Dovish
10,20, 자산/NNG;안정/NNG,30,0.7260136037696254,Dovish
14,28,다국적기업/NNG,42,0.7260136037696254,Dovish
6,12, 개인자산가/NNG,18,0.7260136037696254,Dovish
8,17, 터트리/VV,25,0.6833069211949414,Dovish
4,17, 인플레이션/NNG;목표/NNG;웃돌/VV,21,0.3416534605974707,Dovish
7,19, 금리/NNG;인상/NNG;전망/NNG;하락/NNG,26,0.5349573922513029,Dovish
2,14,아시아태평양경제협력체/NNG,16,0.20743245821989298,Dovish
9,24, 부채/NNG;갚/VV;어렵/VA,33,0.5445102028272191,Dovish
7,18, 매시/MAG,25,0.5646772473763753,Dovish
14,32,일관/NNG,46,0.6352619032984222,Dovish
6,40,자본주의/NNG,46,0.21780408113088762,Dovish
65,128,공무원연금/NNG,193,0.7373575663285258,Dovish
26,50,예탁금/NNG,76,0.7550541479204105,Dovish
4,17, 세계/NNG;경기/NNG;악화/NNG,21,0.3416534605974707,Dovish
8,25, 회복/NNG;방해/NNG,33,0.46464870641256023,Dovish
11,22,정계/NNG,33,0.7260136037696254,Dovish
257,654,금융투자/NNG,911,0.5705978476109901,Dovish
3,15, 마이너스/NNG;그치/VV,18,0.2904054415078502,Dovish
13,26,공제/NNG,39,0.7260136037696254,Dovish
12,31, 이만저만/NNG,43,0.5620750480797101,Dovish
4,15, 가격/NNG;매력/NNG;크/VV,19,0.3872072553438002,Dovish
12,24,오크/NNG,36,0.7260136037696254,Dovish
20,54, 수입/NNG;오르/VV,74,0.5377878546441669,Dovish
6,17,불공정/NNG,23,0.5124801908962061,Dovish
12,28, 조찬회/NNG,40,0.622297374659679,Dovish
6,12, 국고채/NNG;스프레드/NNG;축소/NNG,18,0.7260136037696254,Dovish
7,15, 자그마/NNG,22,0.6776126968516504,Dovish
38,87, 공로/NNG,125,0.6342187803045004,Dovish
6,17, 장기근속/NNG,23,0.5124801908962061,Dovish
12,27, 노후소득보장/NNG,39,0.6453454255730003,Dovish
13,35,적격/NNG,48,0.5393243913717217,Dovish
12,36, 떼이/VV,48,0.4840090691797503,Dovish
12,45,공적연금/NNG,57,0.38720725534380024,Dovish
1,17,후생/NNG,18,0.08541336514936768,Dovish
20,42,여론/NNG,62,0.6914415273996433,Dovish
84,212, 기업형/NNG,296,0.575331535062722,Dovish
6,46,기업형/NNG,52,0.1893948531572936,Dovish
27,69, 표준편차/NNG,96,0.5681845594718807,Dovish
18,39,다보스포럼/NNG,57,0.6701664034796543,Dovish
15,36,흥행/NNG,51,0.6050113364746877,Dovish
5,17, 소폭/MAG;증가/NNG;그치/VV,22,0.42706682574683846,Dovish
3,15, 애칭/NNG,18,0.2904054415078502,Dovish
19,40, 몰랐다/VV,59,0.6897129235811441,Dovish
20,39, 집들이/NNG,59,0.7446293371996158,Dovish
9,21, 黃/NNG,30,0.6222973746596789,Dovish
34,67, 獨/NNG,101,0.7368496277064855,Dovish
7,15, 인터넷카페/NNG,22,0.6776126968516504,Dovish
6,13, 둔화/NNG;가속/NNG,19,0.6701664034796543,Dovish
28,58, 돈세탁/NNG,86,0.7009786519155004,Dovish
5,15, 참고서/NNG,20,0.48400906917975023,Dovish
6,13, 빼앗겼/VV,19,0.6701664034796543,Dovish
8,17, 기질/NNG,25,0.6833069211949414,Dovish
9,22, 일갈/NNG,31,0.5940111303569663,Dovish
164,344,etf/NNG,508,0.6922455291756893,Dovish
48,98,한파/NNG,146,0.7111969996110616,Dovish
13,33,선물지수/NNG,46,0.572010718121523,Dovish
6,18, 급여금/NNG,24,0.4840090691797503,Dovish
72,154, 검거/NNG,226,0.6788698632651042,Dovish
71,136,변액/NNG,207,0.7580436157006383,Dovish
8,27,보험설계사/NNG,35,0.4302302837153335,Dovish
4,14, 전자장비/NNG,18,0.41486491643978596,Dovish
10,23, 신용위험/NNG;줄/VV,33,0.6313161771909785,Dovish
8,18, 점쳐져/VV,26,0.6453454255730003,Dovish
40,81,역내외/NNG,121,0.7170504728588893,Dovish
21,52,일중/NNG,73,0.5863956030446974,Dovish
4,15, 바젤2/NNG,19,0.3872072553438002,Dovish
2,19, 자본비율/NNG;떨어/VV,21,0.15284496921465798,Dovish
9,23,공유/NNG,32,0.5681845594718807,Dovish
4,12,상법/NNG,16,0.4840090691797502,Dovish
5,14, 가계/NNG;지출/NNG;감소/NNG,19,0.5185811455497324,Dovish
3,14, 현금/NNG;넘/VV,17,0.3111486873298395,Dovish
8,16,플래시/NNG,24,0.7260136037696253,Dovish
14,32,제치/VV,46,0.6352619032984222,Dovish
6,16, 항법/NNG,22,0.5445102028272191,Dovish
6,31, 활주로/NNG,37,0.28103752403985505,Dovish
5,11, 약하/VA;추세/NNG,16,0.6600123670632958,Dovish
9,20, 경제/NNG;지표/NNG;악재/NNG,29,0.6534122433926629,Dovish
20,51, 소매/NNG;판매가격/NNG;호조/NNG,71,0.5694224343291179,Dovish
7,23,심하/VA,30,0.441921324033685,Dovish
7,16, 수출/NNG;수입/NNG;늘/VV,23,0.6352619032984222,Dovish
17,33, 소회의실/NNG,50,0.7480140160050687,Dovish
5,11, 가계/NNG;가처분/NNG;소득/NNG;감소/NNG,16,0.6600123670632958,Dovish
13,39, 금리/NNG;인상/NNG;가능성/NNG;작/VA,52,0.4840090691797503,Dovish
6,17,전망대/NNG,23,0.5124801908962061,Dovish
6,18, 저항감/NNG,24,0.4840090691797503,Dovish
22,46, 가트/NNG,68,0.6944477949100765,Dovish
6,12, 멀/VA;가트/NNG;멀/VA,18,0.7260136037696254,Dovish
22,47,정태/NNG,69,0.6796723099119898,Dovish
154,405,실업보험/NNG,559,0.5521288641013448,Dovish
17,67, 통화/NNG;공급/NNG;늘/VV,84,0.36842481385324277,Dovish
7,15, 쇼핑객/NNG,22,0.6776126968516504,Dovish
5,11,매장/MAG,16,0.6600123670632958,Dovish
5,15, 점찍/VV,20,0.48400906917975023,Dovish
6,25, 쓰러져/VV,31,0.34848652980942024,Dovish
16,33, 출고가/NNG,49,0.7040131915341822,Dovish
7,21,꽤/MAG,28,0.4840090691797503,Dovish
23,45, 부속/NNG,68,0.7421472394089503,Dovish
18,75, 정보보호/NNG,93,0.3484865298094202,Dovish
9,36, 시흥/NNG,45,0.3630068018848127,Dovish
9,18, 바뀐다고/VV,27,0.7260136037696254,Dovish
6,24, 신용/NNG;대출/NNG;금리/NNG;오르/VV,30,0.3630068018848127,Dovish
8,21, 경기/NNG;침체/NNG;끝/NNG,29,0.5531532219197145,Dovish
5,12, 정책/NNG;자신/NNG,17,0.6050113364746877,Dovish
4,18,발맞춰/VV,22,0.32267271278650017,Dovish
3,13, 투자/NNG;관심/NNG;크/VV,16,0.33508320173982714,Dovish
14,44,각자/NNG,58,0.4620086569443071,Dovish
23,49, 변할지/VV,72,0.681563791293934,Dovish
13,30, 출입구/NNG,43,0.6292117899336753,Dovish
21,57, 영화관/NNG,78,0.5349573922513029,Dovish
6,23, 바가지/NNG,29,0.3787897063145872,Dovish
6,13, 대출비중/NNG;상승/NNG,19,0.6701664034796543,Dovish
4,15,환산/NNG,19,0.3872072553438002,Dovish
16,44, cd/NNG;금리/NNG;낮/VA,60,0.5280098936506367,Dovish
15,29,합성/NNG,44,0.7510485556237504,Dovish
7,33,팔/NNG,40,0.3080057712962047,Dovish
5,14, 기회/NNG;위험/NNG,19,0.5185811455497324,Dovish
8,21, 구조개혁/NNG;가속/NNG,29,0.5531532219197145,Dovish
168,396, ndf시장/NNG,564,0.6160115425924094,Dovish
11,26, 직선제/NNG,37,0.614319203189683,Dovish
11,27, 정책/NNG;자금/NNG;지원/NNG;확대/NNG,38,0.5915666401085836,Dovish
6,23, 신용보증/NNG;확대/NNG,29,0.3787897063145872,Dovish
39,90, 수출환어음/NNG,129,0.6292117899336753,Dovish
5,20, 금리/NNG;오르/VV;금리/NNG;내리/VV,25,0.3630068018848127,Dovish
10,29, 리프/NNG,39,0.5006990370825003,Dovish
5,21,단지내상가/NNG,26,0.34572076369982163,Dovish
4,17, 세탁소/NNG,21,0.3416534605974707,Dovish
7,27, 시바/NNG,34,0.37645149825091684,Dovish
0,16,삭/VV,16,0.0,Dovish
5,17, 낮춰라/VV,22,0.42706682574683846,Dovish
10,20, 진/XSV,30,0.7260136037696254,Dovish
69,186,환율조작국/NNG,255,0.5386552544097221,Dovish
13,28, 질식/NNG,41,0.6741554892146522,Dovish
6,16, 버클/NNG,22,0.5445102028272191,Dovish
19,38, 팔릴/VV,57,0.7260136037696254,Dovish
1,17,사적연금/NNG,18,0.08541336514936768,Dovish
32,104,전면/NNG,136,0.44677760231976943,Dovish
5,27, 계리/NNG,32,0.26889392732208345,Dovish
30,64, 금리/NNG;내리/VV;어렵/VA,94,0.6806377535340238,Dovish
17,36, 악수/NNG,53,0.6856795146713129,Dovish
5,12, 성장/NNG;속도/NNG;높/VV,17,0.6050113364746877,Dovish
4,26, pmi/NNG;소폭/MAG;하락/NNG,30,0.22338880115988471,Dovish
6,21, 중량/NNG,27,0.41486491643978596,Dovish
11,27, 금리/NNG;내리/VV;부담/NNG,38,0.5915666401085836,Dovish
5,12, 국채선물/NNG;낙폭/NNG;크/VV,17,0.6050113364746877,Dovish
15,39, 매출/NNG;전망/NNG;하향/NNG,54,0.5584720028997118,Dovish
16,51, 제조업/NNG;활동/NNG;확장/NNG,67,0.4555379474632943,Dovish
17,58,순유출/NNG,75,0.4255941815201253,Dovish
12,27,게재/NNG,39,0.6453454255730003,Dovish
7,19, 하루속히/MAG,26,0.5349573922513029,Dovish
8,25, 매코/NNG,33,0.46464870641256023,Dovish
5,24, 근소세/NNG,29,0.30250566823734387,Dovish
37,87, 보료/NNG,124,0.6175288124017504,Dovish
5,21, 원엔/NNG;환율/NNG;급락/NNG,26,0.34572076369982163,Dovish
6,19, 온의/NNG,25,0.458534907643974,Dovish
5,11, 국채선물/NNG;떨어/VV,16,0.6600123670632958,Dovish
16,45, 비보/NNG,61,0.5162763404584002,Dovish
7,24,인턴/NNG,31,0.42350793553228144,Dovish
7,24, 불러일으켜/VV,31,0.42350793553228144,Dovish
7,22, 역서/NNG,29,0.4620086569443071,Dovish
49,95, 해역/NNG,144,0.7489403491518242,Dovish
6,12, 위폐/NNG,18,0.7260136037696254,Dovish
4,17, 외교단/NNG,21,0.3416534605974707,Dovish
9,21,집회/NNG,30,0.6222973746596789,Dovish
8,22, 시스템/NNG;안정/NNG,30,0.5280098936506367,Dovish
4,13, 대출/NNG;그치/VV,17,0.44677760231976943,Dovish
58,119, 곳간/NNG,177,0.7077107398090466,Dovish
7,14, 경기/NNG;부양/NNG;물가/NNG;상승/NNG,21,0.7260136037696254,Dovish
12,33,자구계획/NNG,45,0.5280098936506367,Dovish
25,51,상환능력/NNG,76,0.7117780429113975,Dovish
5,13,중저가/NNG,18,0.5584720028997119,Dovish
3,15, 지행/NNG,18,0.2904054415078502,Dovish
5,14, 깨알/NNG,19,0.5185811455497324,Dovish
20,45, 밝혀야/VV,65,0.6453454255730003,Dovish
10,28,중장/NNG,38,0.5185811455497324,Dovish
9,19, 기업/NNG;순이익/NNG;감소/NNG,28,0.687802361465961,Dovish
2,14,전원회의/NNG,16,0.20743245821989298,Dovish
17,34, 빼든/VV,51,0.7260136037696254,Dovish
12,64, 초임/NNG,76,0.27225510141360953,Dovish
13,35, 종합상사/NNG,48,0.5393243913717217,Dovish
21,50, 누/VV,71,0.6098514271664853,Dovish
7,29,대일/NNG,36,0.3504893259577502,Dovish
4,25, 대일/NNG;무역/NNG;적자/NNG,29,0.23232435320628012,Dovish
21,59, 단층/NNG,80,0.5168232433614283,Dovish
14,34, 군복/NNG,48,0.5978935560455738,Dovish
10,20,혼자/MAG,30,0.7260136037696254,Dovish
6,13,이성/NNG,19,0.6701664034796543,Dovish
12,28,튼/VV,40,0.622297374659679,Dovish
4,13, 금융부채/NNG;금융자산/NNG;많/VA,17,0.44677760231976943,Dovish
6,15, 기대/NNG;힘입/VV;강세/NNG,21,0.5808108830157004,Dovish
12,25, 행각/NNG,37,0.6969730596188405,Dovish
35,92, 감정평가/NNG,127,0.5524016550421064,Dovish
30,59,랜드/NNG,89,0.7383189190877547,Dovish
14,32, 자금팀/NNG,46,0.6352619032984222,Dovish
4,13, gni/NNG;증가/NNG,17,0.44677760231976943,Dovish
3,13, 경상/NNG;수지/NNG;적자/NNG;우려/NNG,16,0.33508320173982714,Dovish
5,15, 개선/NNG;주가/NNG;상승/NNG,20,0.48400906917975023,Dovish
5,14, 노보/NNG,19,0.5185811455497324,Dovish
4,18, 맹렬/NNG,22,0.32267271278650017,Dovish
7,21, 세계/NNG;원유/NNG;수요/NNG;증가/NNG,28,0.4840090691797503,Dovish
18,53,숙박/NNG,71,0.4931413157680475,Dovish
4,19, 거시/NNG;지표/NNG;호조/NNG,23,0.30568993842931597,Dovish
9,25,재판/NNG,34,0.5227297947141304,Dovish
63,128, 푼/VV,191,0.7146696412107251,Dovish
8,19, 부딪쳐/VV,27,0.6113798768586319,Dovish
4,19, 흥청/NNG,23,0.30568993842931597,Dovish
3,17, 대출심사/NNG;완화/NNG,20,0.25624009544810306,Dovish
26,50, 첫선/NNG,76,0.7550541479204105,Dovish
22,62, 피보험자/NNG,84,0.5152354607397341,Dovish
10,35,외국기업/NNG,45,0.41486491643978596,Dovish
3,15, 담보인정비율/NNG;높/VA,18,0.2904054415078502,Dovish
9,35, 금/NNG;수요/NNG;늘/VV,44,0.3733784247958074,Dovish
6,16, 경제/NNG;내리/VV,22,0.5445102028272191,Dovish
4,14,요새/NNG,18,0.41486491643978596,Dovish
6,18, 이징/NNG,24,0.4840090691797503,Dovish
9,33, 부친/NNG,42,0.3960074202379775,Dovish
12,24, 신도/NNG,36,0.7260136037696254,Dovish
6,14, 장직/NNG,20,0.622297374659679,Dovish
68,149,재단/NNG,217,0.6626701349843561,Dovish
10,26,공익/NNG,36,0.5584720028997119,Dovish
7,17, 외환보유액/NNG;확대/NNG,24,0.5978935560455738,Dovish
10,44,인권/NNG,54,0.3300061835316479,Dovish
63,181, 진상/NNG,244,0.5054017352208442,Dovish
40,77, 숨졌/VV,117,0.7542998480723381,Dovish
21,78, 직권상정/NNG,99,0.3909304020297983,Dovish
5,25, 결의문/NNG,30,0.2904054415078502,Dovish
13,27, 돌려보냈/VV,40,0.6991242110374171,Dovish
17,36, 경기/NNG;회복/NNG;강하/VA,53,0.6856795146713129,Dovish
30,69, 할부금/NNG,99,0.6313161771909785,Dovish
6,17, 외국인/NNG;투자심리/NNG;위축/NNG,23,0.5124801908962061,Dovish
17,43, 금리/NNG;인상/NNG;가능성/NNG;없/VA,60,0.5740572680969132,Dovish
10,30, 뒤처질/VV,40,0.48400906917975023,Dovish
12,23,신약/NNG,35,0.7575794126291744,Dovish
25,51, 분통/NNG,76,0.7117780429113975,Dovish
4,12, 곤두박질친/VV,16,0.4840090691797502,Dovish
7,16, 건전성/NNG;우려/NNG;크/VV,23,0.6352619032984222,Dovish
14,29,고지/NNG,43,0.7009786519155004,Dovish
26,70,경제구조/NNG,96,0.5393243913717217,Dovish
6,14, 합해서/VV,20,0.622297374659679,Dovish
3,13, 비토/NNG,16,0.33508320173982714,Dovish
7,15, 대내외/NNG;금리갭/NNG;확대/NNG,22,0.6776126968516504,Dovish
9,20, 옥천/NNG,29,0.6534122433926629,Dovish
31,61,변경/NNG,92,0.7379154661265046,Dovish
14,34, 선로/NNG,48,0.5978935560455738,Dovish
11,26, 이어주/VV,37,0.614319203189683,Dovish
9,18, 마셨/VV,27,0.7260136037696254,Dovish
17,33,쿠/MAG,50,0.7480140160050687,Dovish
9,22, 금리/NNG;제로/NNG;낮/VV,31,0.5940111303569663,Dovish
9,29, 데리/VV,38,0.45062913337425026,Dovish
27,68,댄/NNG,95,0.5765402147582319,Dovish
7,25,기조연설/NNG,32,0.40656761811099024,Dovish
4,13,이어서/VV,17,0.44677760231976943,Dovish
6,14, 소외업종/NNG,20,0.622297374659679,Dovish
6,15, 내미/VV,21,0.5808108830157004,Dovish
4,12,여전업계/NNG,16,0.4840090691797502,Dovish
45,114,할부금융/NNG,159,0.5731686345549674,Dovish
22,75,기술금융/NNG,97,0.42592798087818023,Dovish
4,14, 심인/NNG,18,0.41486491643978596,Dovish
27,79, 공동선언문/NNG,106,0.49626246333619967,Dovish
13,36, 사기범/NNG,49,0.5243431582780628,Dovish
12,23, 스님/NNG,35,0.7575794126291744,Dovish
9,26, 퇴원/NNG,35,0.5026248026097407,Dovish
15,33, 대졸자/NNG,48,0.6600123670632958,Dovish
13,34, 숍/NNG,47,0.55518687347089,Dovish
361,799,고시금리/NNG,1160,0.656047336572803,Dovish
9,34, 재정/NNG;부담/NNG;줄/VV,43,0.3843601431721546,Dovish
7,18, 공공/NNG;지출/NNG;늘/VV,25,0.5646772473763753,Dovish
10,21,후순위/NNG,31,0.6914415273996433,Dovish
6,19, 상환능력/NNG;악화/NNG,25,0.458534907643974,Dovish
6,28,계금/NNG,34,0.3111486873298395,Dovish
10,27, 대출/NNG;지원/NNG;확대/NNG,37,0.5377878546441669,Dovish
15,37, 무관세/NNG,52,0.5886596787321287,Dovish
6,20, 배심원/NNG,26,0.43560816226177523,Dovish
5,12, 글로벌/NNG;경제/NNG;위협/NNG,17,0.6050113364746877,Dovish
8,29, 강력범/NNG,37,0.4005592296660002,Dovish
14,29, 식중독/NNG,43,0.7009786519155004,Dovish
841,1701,환시/NNG,2542,0.7179041043741975,Dovish
23,66,국면/NNG,89,0.5060094814151934,Dovish
7,16, 가격/NNG;경쟁력/NNG;악화/NNG,23,0.6352619032984222,Dovish
7,15, 사업분할/NNG,22,0.6776126968516504,Dovish
4,17, 이자/NNG;내리/VV,21,0.3416534605974707,Dovish
5,14, 논제/NNG,19,0.5185811455497324,Dovish
13,25, 꾸며/VV,38,0.7550541479204105,Dovish
28,59, 인력난/NNG,87,0.6890976578152377,Dovish
24,50, 위촉/NNG,74,0.6969730596188405,Dovish
9,20, 감옥/NNG,29,0.6534122433926629,Dovish
24,57, 이송/NNG,81,0.6113798768586319,Dovish
5,14, 전농/NNG,19,0.5185811455497324,Dovish
51,146, 원심/NNG,197,0.5072149834554918,Dovish
15,36, 써도/VV,51,0.6050113364746877,Dovish
9,20, 서던/NNG,29,0.6534122433926629,Dovish
49,134,하단/NNG,183,0.530965172906144,Dovish
5,14, 적립방식/NNG,19,0.5185811455497324,Dovish
5,14, 퇴직급여충당금/NNG,19,0.5185811455497324,Dovish
6,12, 단말/NNG,18,0.7260136037696254,Dovish
23,47, 男/NNG,70,0.7105665058170801,Dovish
5,12, 공급/NNG;쏟/VV,17,0.6050113364746877,Dovish
20,43, 지청/NNG,63,0.6753614918787213,Dovish
6,12, 불안전/NNG,18,0.7260136037696254,Dovish
7,16, 온실/NNG,23,0.6352619032984222,Dovish
17,36, 일거양득/NNG,53,0.6856795146713129,Dovish
5,13,아름다운/VA,18,0.5584720028997119,Dovish
9,21, 후원회/NNG,30,0.6222973746596789,Dovish
13,29, 내다본다/VV,42,0.6509087482072504,Dovish
6,18,백서/NNG,24,0.4840090691797503,Dovish
6,23, 주택비율/NNG,29,0.3787897063145872,Dovish
30,65, 프라이스/NNG,95,0.6701664034796543,Dovish
6,15, 얼마나/MAG;위험/NNG,21,0.5808108830157004,Dovish
7,15, 투자/NNG;fed/NNG;금리/NNG;인상/NNG,22,0.6776126968516504,Dovish
7,14, 상명/NNG,21,0.7260136037696254,Dovish
29,56, 가격/NNG;fed/NNG;금리/NNG;인상/NNG,85,0.751942661047112,Dovish
25,48, 싱글/MAG,73,0.7562641705933597,Dovish
7,16, 예기/NNG;못하/VX;충격/NNG,23,0.6352619032984222,Dovish
17,35, 몰아쳤/VV,52,0.7052703579476362,Dovish
11,25, 경기/NNG;회복/NNG;어렵/VA,36,0.6388919713172704,Dovish
35,81,폭설/NNG,116,0.6274191637515282,Dovish
7,16, 채권펀드/NNG;양호/NNG,23,0.6352619032984222,Dovish
13,27, 열도/NNG,40,0.6991242110374171,Dovish
15,31, 거둬들여/VV,46,0.7025938100996375,Dovish
7,17, 포춘/NNG,24,0.5978935560455738,Dovish
41,112, 교포/NNG,153,0.5315456741884758,Dovish
4,12, 뽑혀/VV,16,0.4840090691797502,Dovish
15,29, 장년/NNG,44,0.7510485556237504,Dovish
6,20,강성/NNG,26,0.43560816226177523,Dovish
8,20, 실적/NNG;전망/NNG;좋/VA,28,0.5808108830157003,Dovish
4,15, 통안채/NNG;내리/VV;하락/NNG,19,0.3872072553438002,Dovish
5,12, 인플레이션/NNG;물가/NNG;안정/NNG,17,0.6050113364746877,Dovish
12,26, 정반/NNG,38,0.6701664034796543,Dovish
6,13, 바닥/NNG;찍/VV;아니/VCN,19,0.6701664034796543,Dovish
10,27, 기대/NNG;크/VV;상승/NNG,37,0.5377878546441669,Dovish
7,17,용/NNG,24,0.5978935560455738,Dovish
15,64,순방/NNG,79,0.3403188767670119,Dovish
30,84, 외려/MAG,114,0.5185811455497324,Dovish
7,15, 이자/NNG;납부/NNG;유예/NNG,22,0.6776126968516504,Dovish
5,12, 신용/NNG;공급/NNG;확대/NNG,17,0.6050113364746877,Dovish
8,20, 소비/NNG;투자/NNG;살/VV,28,0.5808108830157003,Dovish
23,56, 금리/NNG;내리/VV;없/VA,79,0.5963683173821923,Dovish
6,20,중후반/NNG,26,0.43560816226177523,Dovish
11,30, 무허가/NNG,41,0.5324099760977252,Dovish
9,20,투자성향/NNG,29,0.6534122433926629,Dovish
27,74, 내줄/VV,101,0.5297937108589158,Dovish
5,26, 워즈/NNG,31,0.27923600144985594,Dovish
7,15,특별지원/NNG,22,0.6776126968516504,Dovish
11,26, 전보/NNG,37,0.614319203189683,Dovish
14,41,캐피털그룹/NNG,55,0.4958141684280369,Dovish
6,14, 나돈/VV,20,0.622297374659679,Dovish
15,30,농어업/NNG,45,0.7260136037696253,Dovish
154,300, 귀농/NNG,454,0.7453739665368154,Dovish
19,49,대상자/NNG,68,0.5630309580254238,Dovish
3,21,업무계획/NNG,24,0.20743245821989298,Dovish
5,11, 코퍼레이트/NNG,16,0.6600123670632958,Dovish
49,101, 제1금융권/NNG,150,0.7044488432616167,Dovish
6,30, 선불카드/NNG,36,0.2904054415078502,Dovish
5,13, 금리/NNG;오르/VV;인하/NNG,18,0.5584720028997119,Dovish
3,14,피닉스/NNG,17,0.3111486873298395,Dovish
4,26, 주택가격/NNG;낮/VA,30,0.22338880115988471,Dovish
23,46, 온종일/NNG,69,0.7260136037696253,Dovish
4,22, 산역/NNG,26,0.26400494682531833,Dovish
11,25, 창문/NNG,36,0.6388919713172704,Dovish
16,35, 인플레이션/NNG;목표/NNG;밑돌/VV,51,0.6637838663036575,Dovish
5,18, 제설/NNG,23,0.4033408909831252,Dovish
12,46, 연체료/NNG,58,0.3787897063145872,Dovish
9,20, 붙여진/VV,29,0.6534122433926629,Dovish
5,14, 금리/NNG;인하/NNG;내리/VV,19,0.5185811455497324,Dovish
4,14, 불안요인/NNG;작/VA;않/VX,18,0.41486491643978596,Dovish
7,19,우편/NNG,26,0.5349573922513029,Dovish
52,104, 줄도산/NNG,156,0.7260136037696254,Dovish
36,80,대회/NNG,116,0.6534122433926629,Dovish
11,40,재선/NNG,51,0.3993074820732939,Dovish
15,38,기념사/NNG,53,0.5731686345549674,Dovish
12,43, 오페라/NNG,55,0.4052168951272328,Dovish
22,44,자치/NNG,66,0.7260136037696254,Dovish
17,37, 울주군/NNG,54,0.6671476358964126,Dovish
16,33,승진/NNG,49,0.7040131915341822,Dovish
3,15, 해복/NNG,18,0.2904054415078502,Dovish
7,16,주유/NNG,23,0.6352619032984222,Dovish
9,20,소방/NNG,29,0.6534122433926629,Dovish
5,11, 구장/NNG,16,0.6600123670632958,Dovish
4,13, 재정/NNG;부담/NNG;덜/VV,17,0.44677760231976943,Dovish
10,25, 안면/NNG,35,0.5808108830157004,Dovish
41,97, 환승/NNG,138,0.6137434588567967,Dovish
6,12,진흥기금/NNG,18,0.7260136037696254,Dovish
23,49,시청/NNG,72,0.681563791293934,Dovish
12,26, 개발지/NNG,38,0.6701664034796543,Dovish
6,14,제주특별자치도/NNG,20,0.622297374659679,Dovish
10,30, 도지사/NNG,40,0.48400906917975023,Dovish
10,26, 사라져야/VV,36,0.5584720028997119,Dovish
4,17, 벳/NNG,21,0.3416534605974707,Dovish
12,28,위탁매매/NNG,40,0.622297374659679,Dovish
29,78,착공/NNG,107,0.5398562694697214,Dovish
2,16, 개항/NNG,18,0.18150340094240633,Dovish
6,15, 측량/NNG,21,0.5808108830157004,Dovish
12,60, 공제기금/NNG,72,0.2904054415078502,Dovish
8,18, 속임수/NNG,26,0.6453454255730003,Dovish
9,19, 판매업자/NNG,28,0.687802361465961,Dovish
14,35,상시/NNG,49,0.5808108830157003,Dovish
10,25, 목표비율/NNG,35,0.5808108830157004,Dovish
4,13, 상도/NNG,17,0.44677760231976943,Dovish
18,39, 가계/NNG;원리금/NNG;상환/NNG;부담/NNG,57,0.6701664034796543,Dovish
5,12,오버/NNG,17,0.6050113364746877,Dovish
12,25,상권/NNG,37,0.6969730596188405,Dovish
6,12, 둔화/NNG;경제/NNG;회복/NNG,18,0.7260136037696254,Dovish
8,16, 건전성/NNG;떨어/VV,24,0.7260136037696253,Dovish
29,76,물가안정목표제/NNG,105,0.5540630134031351,Dovish
8,21, 공증/NNG,29,0.5531532219197145,Dovish
21,45, 로펌/NNG,66,0.6776126968516504,Dovish
9,21,정액/NNG,30,0.6222973746596789,Dovish
10,21,사회적기업/NNG,31,0.6914415273996433,Dovish
14,42, 명세서/NNG,56,0.4840090691797503,Dovish
8,17, 많/VA;수익/NNG;오르/VV,25,0.6833069211949414,Dovish
19,48, 설마/MAG,67,0.5747607696509535,Dovish
8,16, 뿔/NNG,24,0.7260136037696253,Dovish
6,14,메자닌/NNG,20,0.622297374659679,Dovish
14,29, 기탁/NNG,43,0.7009786519155004,Dovish
9,25, 가계/NNG;부채비율/NNG;높/VA,34,0.5227297947141304,Dovish
8,22,없이/MAG,30,0.5280098936506367,Dovish
11,60,다중채무자/NNG,71,0.2662049880488626,Dovish
6,12, 뜻깊/VA,18,0.7260136037696254,Dovish
34,74,기준치/NNG,108,0.6671476358964126,Dovish
18,43,자본비율/NNG,61,0.6078253426908492,Dovish
13,31,시초가/NNG,44,0.6089146354196858,Dovish
72,138,감산/NNG,210,0.7575794126291744,Dovish
6,16, 텍스트/NNG,22,0.5445102028272191,Dovish
9,30, 휴게/NNG,39,0.43560816226177523,Dovish
19,41,레이/NNG,60,0.6728906571523358,Dovish
27,60, gdp/NNG;성장률/NNG;그치/VV,87,0.6534122433926628,Dovish
4,17,윤리/NNG,21,0.3416534605974707,Dovish
143,459,내정자/NNG,602,0.45237448949479925,Dovish
5,13,돌풍/NNG,18,0.5584720028997119,Dovish
12,25, 따낸/VV,37,0.6969730596188405,Dovish
3,15,국제화/NNG,18,0.2904054415078502,Dovish
8,22, 결제망/NNG,30,0.5280098936506367,Dovish
12,29, 탄다/VV,41,0.6008388444990004,Dovish
39,117, 시간표/NNG,156,0.48400906917975023,Dovish
17,40, 혼신/NNG,57,0.6171115632041816,Dovish
7,16, 경제/NNG;부진/NNG;벗어나/VV,23,0.6352619032984222,Dovish
16,43, 觀/NNG,59,0.540289193502977,Dovish
11,44,극우/NNG,55,0.3630068018848127,Dovish
22,44, 개교/NNG,66,0.7260136037696254,Dovish
20,39, 최적기/NNG,59,0.7446293371996158,Dovish
58,132, 금연/NNG,190,0.6380119548278526,Dovish
6,14, 몰아붙였/VV,20,0.622297374659679,Dovish
8,17, 성장/NNG;견인차/NNG,25,0.6833069211949414,Dovish
9,20,그림자/NNG,29,0.6534122433926629,Dovish
24,52, 구랍/NNG,76,0.6701664034796543,Dovish
4,13, 강하/VA;경제/NNG;회복/NNG,17,0.44677760231976943,Dovish
28,57, 홍보관/NNG,85,0.7132765230017372,Dovish
16,38, 폴리시믹스/NNG,54,0.6113798768586319,Dovish
5,27, 특산물/NNG,32,0.26889392732208345,Dovish
34,90, 집값/NNG;내리/VV,124,0.5485436117370504,Dovish
22,76,중간선거/NNG,98,0.42032366534030946,Dovish
6,17, 다가온다는/VV,23,0.5124801908962061,Dovish
16,55, 운동장/NNG,71,0.4224079149205093,Dovish
19,37, 내세울/VV,56,0.7456355930606964,Dovish
7,19,레버리지론/NNG,26,0.5349573922513029,Dovish
13,31, 부진/NNG;늪/NNG;빠지/VV,44,0.6089146354196858,Dovish
6,12, 현금흐름/NNG;확보/NNG,18,0.7260136037696254,Dovish
21,48, 내홍/NNG,69,0.6352619032984221,Dovish
49,107, 깡통/NNG,156,0.6649470389665728,Dovish
6,13, 수질오염/NNG,19,0.6701664034796543,Dovish
8,19, 맛본/VV,27,0.6113798768586319,Dovish
19,60, 설자금/NNG,79,0.45980861572076276,Dovish
20,43, 부위/NNG,63,0.6753614918787213,Dovish
7,18, 춘추/NNG,25,0.5646772473763753,Dovish
4,13,물품/NNG,17,0.44677760231976943,Dovish
10,34, 판매/NNG;넘/VV,44,0.42706682574683846,Dovish
16,41, 책상/NNG,57,0.5666447639177564,Dovish
14,32, 설특별자금/NNG,46,0.6352619032984222,Dovish
4,13,전력거래소/NNG,17,0.44677760231976943,Dovish
16,36, 점식/NNG,52,0.6453454255730003,Dovish
7,14, 천편일률/NNG,21,0.7260136037696254,Dovish
13,29,특화/NNG,42,0.6509087482072504,Dovish
76,150,우선주/NNG,226,0.7356937851532204,Dovish
13,30, 주택/NNG;착공/NNG;감소/NNG,43,0.6292117899336753,Dovish
4,29, 경제/NNG;성장/NNG;강하/VA,33,0.2002796148330001,Dovish
10,23, 정면충돌/NNG,33,0.6313161771909785,Dovish
4,13, 성경/NNG,17,0.44677760231976943,Dovish
8,17, 하사/NNG,25,0.6833069211949414,Dovish
7,16, 수입/NNG;가격/NNG;떨어/VV,23,0.6352619032984222,Dovish
26,55, 중소수출기업/NNG,81,0.6864128617458277,Dovish
16,32, 현판식/NNG,48,0.7260136037696253,Dovish
13,33, 수출/NNG;경쟁력/NNG;저하/NNG,46,0.572010718121523,Dovish
23,49, 달러엔/NNG;환율/NNG;급락/NNG,72,0.681563791293934,Dovish
4,15, 내수/NNG;회복/NNG;모멘텀/NNG,19,0.3872072553438002,Dovish
9,21, 피폐/NNG,30,0.6222973746596789,Dovish
6,12, 맞장구/NNG,18,0.7260136037696254,Dovish
17,36, 호원/NNG,53,0.6856795146713129,Dovish
24,46, 열띤/VA,70,0.7575794126291744,Dovish
5,12, 채권/NNG;가격/NNG;낮/VA,17,0.6050113364746877,Dovish
10,28, 수출기업/NNG;타격/NNG,38,0.5185811455497324,Dovish
6,16, 급락/NNG;부담/NNG,22,0.5445102028272191,Dovish
7,22, 띄우기/NNG,29,0.4620086569443071,Dovish
5,20, 유로존/NNG;소비자/NNG;물가/NNG;상승/NNG,25,0.3630068018848127,Dovish
26,58, 고용/NNG;지표/NNG;fed/NNG;금리/NNG;인상/NNG,84,0.6509087482072504,Dovish
15,34, 매출/NNG;넘/VV,49,0.6406002386202576,Dovish
3,20, 외화부채/NNG;많/VA,23,0.21780408113088762,Dovish
6,12, 외화환산이익/NNG,18,0.7260136037696254,Dovish
6,13, 원화/NNG;경상/NNG;수지/NNG;흑자/NNG,19,0.6701664034796543,Dovish
4,15, 물량/NNG;부담/NNG;크/VV,19,0.3872072553438002,Dovish
6,14, 내려져/VV,20,0.622297374659679,Dovish
6,19, 금융안정/NNG;해치/VV,25,0.458534907643974,Dovish
22,48, 세계/NNG;경제/NNG;우려/NNG,70,0.6655124701221565,Dovish
27,69, 실적/NNG;시장/NNG;예상/NNG;웃돌/VV,96,0.5681845594718807,Dovish
20,44, 엄중히/MAG,64,0.6600123670632958,Dovish
34,70, 꺼낸/VV,104,0.7052703579476362,Dovish
6,19, 걸려왔/VV,25,0.458534907643974,Dovish
25,59, 종잣돈/NNG,84,0.6152657659064623,Dovish
17,48, 가격/NNG;오르/VV;상승/NNG,65,0.5142596360034847,Dovish
7,14, 숙련공/NNG,21,0.7260136037696254,Dovish
24,48,ndf시장/NNG,72,0.7260136037696254,Dovish
4,25, 양적/VAX;통화/NNG;완화정책/NNG;종료/NNG,29,0.23232435320628012,Dovish
10,21,글로벌인베스터스/NNG,31,0.6914415273996433,Dovish
12,35, 빠질지/VV,47,0.49783789972774317,Dovish
13,28, 몰아친/VV,41,0.6741554892146522,Dovish
46,96,구/NNG,142,0.6957630369458909,Dovish
36,76,열린다/VV,112,0.687802361465961,Dovish
13,26, 발대식/NNG,39,0.7260136037696254,Dovish
4,14, 순자산/NNG;넘/VV,18,0.41486491643978596,Dovish
4,12,단서/NNG,16,0.4840090691797502,Dovish
7,18, 전망/NNG;잡/VV,25,0.5646772473763753,Dovish
13,27, 판매장/NNG,40,0.6991242110374171,Dovish
13,27, 전표/NNG,40,0.6991242110374171,Dovish
3,25, 지방청/NNG,28,0.17424326490471012,Dovish
5,13, 심리/NNG;과도/NNG,18,0.5584720028997119,Dovish
13,29, 바꾼다는/VV,42,0.6509087482072504,Dovish
15,31,지침/NNG,46,0.7025938100996375,Dovish
8,16, 위생법/NNG,24,0.7260136037696253,Dovish
9,18,내국/NNG,27,0.7260136037696254,Dovish
5,26, 은행/NNG;실적/NNG;부진/NNG,31,0.27923600144985594,Dovish
12,24,머지않/VA,36,0.7260136037696254,Dovish
15,35, 중소기업/NNG;대출/NNG;금리/NNG;인하/NNG,50,0.6222973746596789,Dovish
7,14, 시제품/NNG,21,0.7260136037696254,Dovish
9,20, 수출/NNG;가격/NNG;인상/NNG,29,0.6534122433926629,Dovish
5,13, 면회/NNG,18,0.5584720028997119,Dovish
13,29, 임금/NNG;성장/NNG,42,0.6509087482072504,Dovish
9,23, 카마/NNG,32,0.5681845594718807,Dovish
16,52, 파생결합상품/NNG,68,0.44677760231976943,Dovish
17,41, 제2차세계대전/NNG,58,0.6020600616626163,Dovish
8,16,특별대출/NNG,24,0.7260136037696253,Dovish
18,43, 거실/NNG,61,0.6078253426908492,Dovish
7,25, 선정기업/NNG,32,0.40656761811099024,Dovish
0,19,브이/NNG,19,0.0,Dovish
17,37,대출태도/NNG,54,0.6671476358964126,Dovish
3,13, 금리/NNG;예상/NNG;낮/VA,16,0.33508320173982714,Dovish
12,26, 쓴맛/NNG,38,0.6701664034796543,Dovish
7,15, 캥거루/NNG,22,0.6776126968516504,Dovish
5,11,도약/NNG,16,0.6600123670632958,Dovish
6,14, 단식/NNG,20,0.622297374659679,Dovish
130,267,수은/NNG,397,0.7069795392513205,Dovish
7,21, 중형주지수/NNG,28,0.4840090691797503,Dovish
13,25, 감출/VV,38,0.7550541479204105,Dovish
7,20,지구촌/NNG,27,0.5082095226387378,Dovish
21,43,도전/NNG,64,0.7091295664726573,Dovish
8,21, 창간/NNG,29,0.5531532219197145,Dovish
12,32, 금리/NNG;내리/VV;못하/VX,44,0.5445102028272191,Dovish
5,13,주보/NNG,18,0.5584720028997119,Dovish
53,114,가처분/NNG,167,0.6750652806980727,Dovish
8,17, 들어온다는/VV,25,0.6833069211949414,Dovish
5,19,증거/NNG,24,0.38211242303664494,Dovish
6,15, 개청/NNG,21,0.5808108830157004,Dovish
16,34,의혹/NNG,50,0.6833069211949414,Dovish
49,119, 자택/NNG,168,0.5978935560455739,Dovish
6,25,가담/NNG,31,0.34848652980942024,Dovish
11,26, 밝혀내/VV,37,0.614319203189683,Dovish
3,13, 술렁였/VV,16,0.33508320173982714,Dovish
4,17,탈당/NNG,21,0.3416534605974707,Dovish
11,25, 표차/NNG,36,0.6388919713172704,Dovish
11,32, 따돌리/VV,43,0.4991343525916174,Dovish
6,21, 디플레이션/NNG;압박/NNG,27,0.41486491643978596,Dovish
8,22, 제수/NNG,30,0.5280098936506367,Dovish
23,81,단타/NNG,104,0.41230402189386134,Dovish
7,28, 좌표/NNG,35,0.3630068018848127,Dovish
3,16, 퍼뜨리/VV,19,0.27225510141360953,Dovish
8,20,죽/VV,28,0.5808108830157003,Dovish
14,30,달라지/VA,44,0.6776126968516504,Dovish
8,19, 視界/NNG,27,0.6113798768586319,Dovish
5,15, 금리/NNG;인상/NNG;신호/NNG;없/VA,20,0.48400906917975023,Dovish
4,14, 매한가지/NNG,18,0.41486491643978596,Dovish
5,11, 총판/NNG,16,0.6600123670632958,Dovish
12,40, 금리/NNG;인상/NNG;예상/NNG;늦/VV,52,0.43560816226177523,Dovish
10,34, 삐걱거리/VV,44,0.42706682574683846,Dovish
15,31,얼어붙/VV,46,0.7025938100996375,Dovish
9,23, 악화/NNG;악재/NNG,32,0.5681845594718807,Dovish
5,11,내세우/VV,16,0.6600123670632958,Dovish
18,42, 진땀/NNG,60,0.6222973746596789,Dovish
15,37, 받아들일지/VV,52,0.5886596787321287,Dovish
12,109,핵협상/NNG,121,0.15985620633459643,Dovish
8,17,얻/VV,25,0.6833069211949414,Dovish
6,12, 원자재/NNG;가격/NNG;불안/NNG,18,0.7260136037696254,Dovish
4,14, 며느리/NNG,18,0.41486491643978596,Dovish
25,80, 전원회의/NNG,105,0.4537585023560159,Dovish
29,82, 금리/NNG;많이/MAG;내리/VV,111,0.5135218173004668,Dovish
7,21, 마음고생/NNG,28,0.4840090691797503,Dovish
4,12, 어울릴/VV,16,0.4840090691797502,Dovish
21,46, 금리/NNG;많이/MAG;떨어/VV,67,0.6628819860505275,Dovish
8,16, 다녀갔/VV,24,0.7260136037696253,Dovish
49,109, 사령탑/NNG,158,0.6527461758662688,Dovish
7,16, 변한다는/VV,23,0.6352619032984222,Dovish
13,28,근처/NNG,41,0.6741554892146522,Dovish
3,13, 주택/NNG;제한/NNG,16,0.33508320173982714,Dovish
5,19, 성심/NNG,24,0.38211242303664494,Dovish
55,124, 쾌적/NNG,179,0.6440443259246678,Dovish
8,17, 공덕/NNG,25,0.6833069211949414,Dovish
15,61, 제조업/NNG;지표/NNG;개선/NNG,76,0.3570558707063731,Dovish
4,17, 예상밖/NNG;저조/NNG,21,0.3416534605974707,Dovish
6,12, 대안펀드/NNG,18,0.7260136037696254,Dovish
6,14, 신인/NNG,20,0.622297374659679,Dovish
10,26, 관절염/NNG,36,0.5584720028997119,Dovish
7,23,외식/NNG,30,0.441921324033685,Dovish
8,20, 금리/NNG;내리/VV;쉽/VA;않/VX,28,0.5808108830157003,Dovish
26,55, 실적/NNG;줄/VV,81,0.6864128617458277,Dovish
4,14,최상/NNG,18,0.41486491643978596,Dovish
10,27, 불어닥치/VV,37,0.5377878546441669,Dovish
12,25, 이미/MAG;위험/NNG,37,0.6969730596188405,Dovish
7,16, 투자/NNG;소비/NNG;늘/VV,23,0.6352619032984222,Dovish
6,16, 휘발유/NNG;가격/NNG;떨어/VV,22,0.5445102028272191,Dovish
3,16, 음식/NNG;가격/NNG;상승/NNG,19,0.27225510141360953,Dovish
22,51,중점/NNG,73,0.6263646777620296,Dovish
8,23, 산맥/NNG,31,0.5050529417527828,Dovish
5,39, 벤처펀드/NNG,44,0.18615733429990394,Dovish
10,25,인허가/NNG,35,0.5808108830157004,Dovish
5,12, 세계/NNG;경기/NNG;불황/NNG,17,0.6050113364746877,Dovish
14,30,투매/NNG,44,0.6776126968516504,Dovish
11,30, 우물/NNG,41,0.5324099760977252,Dovish
9,22,일임/NNG,31,0.5940111303569663,Dovish
5,13, 급락/NNG;벗어나/VV;상승/NNG,18,0.5584720028997119,Dovish
3,17,요즈음/NNG,20,0.25624009544810306,Dovish
7,18, 제품/NNG;재고/NNG;증가/NNG,25,0.5646772473763753,Dovish
54,119, 사이드카/NNG,173,0.6589031025808365,Dovish
6,14, 부동산/NNG;경기/NNG;좋/VA,20,0.622297374659679,Dovish
4,16, 대출/NNG;받/VV;많/VA,20,0.36300680188481266,Dovish
6,13, 태워/VV,19,0.6701664034796543,Dovish
6,18, 결탁/NNG,24,0.4840090691797503,Dovish
8,16, 금/NNG;가격/NNG;급락/NNG,24,0.7260136037696253,Dovish
7,17, 환매/NNG;부담/NNG,24,0.5978935560455738,Dovish
15,30, 첩첩산중/NNG,45,0.7260136037696253,Dovish
6,15, 쟁쟁/NNG,21,0.5808108830157004,Dovish
5,11, 기업/NNG;예상/NNG;웃돌/VV,16,0.6600123670632958,Dovish
7,16, 배증/NNG,23,0.6352619032984222,Dovish
29,80, 경기동향보고서/NNG,109,0.5263598627329784,Dovish
13,26, fed/NNG;금리/NNG;인상/NNG;가능성/NNG;낮/VA,39,0.7260136037696254,Dovish
5,19, 자본/NNG;빠지/VV,24,0.38211242303664494,Dovish
39,91, 이자율/NNG;낮/VV,130,0.6222973746596789,Dovish
26,51, 대학가/NNG,77,0.7402491646278533,Dovish
10,28, 지방대/NNG,38,0.5185811455497324,Dovish
4,12, 채권펀드/NNG;높/VA,16,0.4840090691797502,Dovish
15,31,출장/NNG,46,0.7025938100996375,Dovish
13,50, 선수단/NNG,63,0.37752707396020524,Dovish
7,22, 수익/NNG;많/VA,29,0.4620086569443071,Dovish
3,13,벤처캐피털/NNG,16,0.33508320173982714,Dovish
6,41, 상환/NNG;부담/NNG;완화/NNG,47,0.21249178646915867,Dovish
10,21,강서/NNG,31,0.6914415273996433,Dovish
25,59,요청/NNG,84,0.6152657659064623,Dovish
19,62, 약탈/NNG,81,0.44497607972977044,Dovish
15,80,선매출/NNG,95,0.2722551014136095,Dovish
27,69, 곧장/MAG,96,0.5681845594718807,Dovish
22,48, 통안채/NNG;높/VA,70,0.6655124701221565,Dovish
3,15, 이로운/VA,18,0.2904054415078502,Dovish
6,14,틈/NNG,20,0.622297374659679,Dovish
12,40, 점주/NNG,52,0.43560816226177523,Dovish
8,16, 성과보상체계/NNG,24,0.7260136037696253,Dovish
8,16,신산업/NNG,24,0.7260136037696253,Dovish
288,595, 田/NNG,883,0.7028299760862255,Dovish
12,39, 빙자/NNG,51,0.4467776023197695,Dovish
5,12, 조하/NNG,17,0.6050113364746877,Dovish
10,32,금연/NNG,42,0.4537585023560159,Dovish
8,24, 마실/VV,32,0.4840090691797502,Dovish
15,63, 보건소/NNG,78,0.3457207636998216,Dovish
17,41, 클리닉/NNG,58,0.6020600616626163,Dovish
5,12, 채산성/NNG;부정적/VAX,17,0.6050113364746877,Dovish
6,13,외부인사/NNG,19,0.6701664034796543,Dovish
25,65, 실거주/NNG,90,0.5584720028997119,Dovish
5,13, 철거민/NNG,18,0.5584720028997119,Dovish
13,26,가산/NNG,39,0.7260136037696254,Dovish
39,81,모델하우스/NNG,120,0.6991242110374171,Dovish
8,21, 침실/NNG,29,0.5531532219197145,Dovish
6,16, 물가/NNG;상승/NNG;미약/NNG,22,0.5445102028272191,Dovish
14,40, 임금/NNG;정체/NNG,54,0.5082095226387378,Dovish
35,82, 환변동보험/NNG,117,0.6197677105350462,Dovish
4,12, 소비/NNG;지출/NNG;약하/VA,16,0.4840090691797502,Dovish
33,69, 무장단체/NNG,102,0.6944477949100764,Dovish
7,15, 금리/NNG;인상/NNG;전망/NNG;강하/VA,22,0.6776126968516504,Dovish
13,26,확신/NNG,39,0.7260136037696254,Dovish
19,40, 다년간/NNG,59,0.6897129235811441,Dovish
6,15, 응법/NNG,21,0.5808108830157004,Dovish
10,52,신복/NNG,62,0.27923600144985594,Dovish
16,37, 고의로/MAG,53,0.6279036573142706,Dovish
10,29, 경제/NNG;성장률/NNG;추락/NNG,39,0.5006990370825003,Dovish
7,34, 지수/NNG;마이너스/NNG;하락/NNG,41,0.2989467780227869,Dovish
10,20, 외국인/NNG;투자/NNG;증가/NNG,30,0.7260136037696254,Dovish
12,40, 영합주의/NNG,52,0.43560816226177523,Dovish
15,34, 대법/NNG,49,0.6406002386202576,Dovish
8,17, 가계/NNG;대출/NNG;금리/NNG;떨어/VV,25,0.6833069211949414,Dovish
7,14, 데이트레이딩/NNG,21,0.7260136037696254,Dovish
17,35,초점/NNG,52,0.7052703579476362,Dovish
6,12, 한다지만/XSV,18,0.7260136037696254,Dovish
11,25, 자청/NNG,36,0.6388919713172704,Dovish
7,23, 신흥시장/NNG;금리/NNG;인상/NNG,30,0.441921324033685,Dovish
6,12, 새롭/VA;상승/NNG;모멘텀/NNG,18,0.7260136037696254,Dovish
7,18, 저점/NNG;찍/VV;오르/VV,25,0.5646772473763753,Dovish
4,15, 이력서/NNG,19,0.3872072553438002,Dovish
9,26,코리아/NNG,35,0.5026248026097407,Dovish
4,16, 고별/NNG,20,0.36300680188481266,Dovish
6,16, 예상/NNG;못하/VX;악재/NNG,22,0.5445102028272191,Dovish
6,25, 의정서/NNG,31,0.34848652980942024,Dovish
18,36, 문화부/NNG,54,0.7260136037696254,Dovish
3,29,조작/NNG,32,0.1502097111247501,Dovish
10,27,교육비/NNG,37,0.5377878546441669,Dovish
46,88, 성폭행/NNG,134,0.7590142221227901,Dovish
10,22, 대서/NNG,32,0.6600123670632958,Dovish
6,13,떠난/VV,19,0.6701664034796543,Dovish
5,12, 강하/VA;가능성/NNG;높/VA,17,0.6050113364746877,Dovish
3,19, 은행/NNG;유동성/NNG;확보/NNG,22,0.229267453821987,Dovish
9,21, 오아시스/NNG,30,0.6222973746596789,Dovish
1,22, 금융위기/NNG;세계/NNG;확산/NNG,23,0.06600123670632958,Dovish
7,16, 세계/NNG;경제/NNG;살/VV,23,0.6352619032984222,Dovish
10,20, 잠재운/VV,30,0.7260136037696254,Dovish
12,25, 부도/NNG;막/VV,37,0.6969730596188405,Dovish
10,22, 복역/NNG,32,0.6600123670632958,Dovish
6,16, 던진다/VV,22,0.5445102028272191,Dovish
5,13, 소류/NNG,18,0.5584720028997119,Dovish
6,15, 자란/VV,21,0.5808108830157004,Dovish
8,20, 사망보험/NNG,28,0.5808108830157003,Dovish
41,83,a등급/NNG,124,0.7172664519169792,Dovish
5,20,액수/NNG,25,0.3630068018848127,Dovish
2,25,터치/NNG,27,0.11616217660314006,Dovish
13,34,옆/NNG,47,0.55518687347089,Dovish
4,15, 액자/NNG,19,0.3872072553438002,Dovish
8,17,출근/NNG,25,0.6833069211949414,Dovish
5,14, 신규/NNG;주문/NNG;지수/NNG;하락/NNG,19,0.5185811455497324,Dovish
6,16, 급했/VA,22,0.5445102028272191,Dovish
4,14, 암담/NNG,18,0.41486491643978596,Dovish
26,50,찍/VV,76,0.7550541479204105,Dovish
390,999,스왑베이시스/NNG,1389,0.5668574684087165,Dovish
13,43,수강/NNG,56,0.43898496972116885,Dovish
15,62, 실업률/NNG;최저/NNG;떨어/VV,77,0.35129690504981875,Dovish
12,25,순이자이익/NNG,37,0.6969730596188405,Dovish
19,37, 국채/NNG;가격/NNG;떨어/VV,56,0.7456355930606964,Dovish
8,17,피인수/NNG,25,0.6833069211949414,Dovish
12,23, 심각/NNG;침체/NNG,35,0.7575794126291744,Dovish
6,31, 우스갯소리/NNG,37,0.28103752403985505,Dovish
7,14, 회복/NNG;가능성/NNG;크/VV,21,0.7260136037696254,Dovish
9,20, 스왑협정/NNG,29,0.6534122433926629,Dovish
10,24,귀국/NNG,34,0.6050113364746877,Dovish
25,68, 수출/NNG;악영향/NNG,93,0.5338335321835481,Dovish
46,107, 고용/NNG;지표/NNG;금리/NNG;인상/NNG,153,0.6242359957645377,Dovish
2,19, 담보대출/NNG;금리/NNG;인하/NNG,21,0.15284496921465798,Dovish
10,31, 환가료/NNG,41,0.46839587339975836,Dovish
5,15,증거금/NNG,20,0.48400906917975023,Dovish
5,18, 부지기수/NNG,23,0.4033408909831252,Dovish
4,16, 실현수익률/NNG,20,0.36300680188481266,Dovish
5,14, 國際/NNG,19,0.5185811455497324,Dovish
6,23, 눈감/VV,29,0.3787897063145872,Dovish
10,27, 경제/NNG;줄/VV,37,0.5377878546441669,Dovish
10,28,장외거래/NNG,38,0.5185811455497324,Dovish
6,12, 각계각층/NNG,18,0.7260136037696254,Dovish
6,13, 내수/NNG;약화/NNG,19,0.6701664034796543,Dovish
6,13, 투자/NNG;늘/VV;않/VX,19,0.6701664034796543,Dovish
6,13, 은행/NNG;기업/NNG;대출/NNG;늘/VV,19,0.6701664034796543,Dovish
8,28, 설비자금/NNG,36,0.41486491643978596,Dovish
6,13, 신흥시장/NNG;높/VA,19,0.6701664034796543,Dovish
6,14, 좋/VA;인상/NNG,20,0.622297374659679,Dovish
4,14,전이/NNG,18,0.41486491643978596,Dovish
0,29, 주택/NNG;착공/NNG;실적/NNG;감소/NNG,29,0.0,Dovish
9,19, 랭/NNG,28,0.687802361465961,Dovish
6,12, 싸잡/VV,18,0.7260136037696254,Dovish
2,18, 소비/NNG;심리/NNG;좋/VA,20,0.16133635639325009,Dovish
6,22, 보상제/NNG,28,0.3960074202379775,Dovish
4,13, 증거금제도/NNG,17,0.44677760231976943,Dovish
10,23, 의사당/NNG,33,0.6313161771909785,Dovish
5,15,건강보험심사평가원/NNG,20,0.48400906917975023,Dovish
8,19, 급성/NNG,27,0.6113798768586319,Dovish
5,20, 디플레이션/NNG;빠지/VV;않/VX,25,0.3630068018848127,Dovish
15,40, 산재보험/NNG,55,0.544510202827219,Dovish
9,19, 문화유산/NNG,28,0.687802361465961,Dovish
7,16, 서산/NNG,23,0.6352619032984222,Dovish
4,18, 아직/MAG;경기/NNG;침체/NNG,22,0.32267271278650017,Dovish
6,16, 부동산/NNG;떨어/VV,22,0.5445102028272191,Dovish
6,17, 북풍/NNG,23,0.5124801908962061,Dovish
16,40, 섞이/VV,56,0.5808108830157003,Dovish
6,14,소액주주/NNG,20,0.622297374659679,Dovish
20,48,포트/NNG,68,0.6050113364746877,Dovish
27,64,취임사/NNG,91,0.6125739781806214,Dovish
6,14, 가계/NNG;부채/NNG;증대/NNG,20,0.622297374659679,Dovish
6,15,환변동보험/NNG,21,0.5808108830157004,Dovish
7,25, 은행/NNG;예금/NNG;금리/NNG;인하/NNG,32,0.40656761811099024,Dovish
8,27, 재택근무/NNG,35,0.4302302837153335,Dovish
4,14, 자금/NNG;시장/NNG;풀/VV,18,0.41486491643978596,Dovish
15,35,월중/NNG,50,0.6222973746596789,Dovish
10,45, 일찍/MAG;금리/NNG;인상/NNG,55,0.32267271278650017,Dovish
17,34, 우려/NNG;떨어/VV,51,0.7260136037696254,Dovish
15,68, 관계형금융/NNG,83,0.3203001193101288,Dovish
4,17, 푸시/NNG,21,0.3416534605974707,Dovish
26,66, 버튼/NNG,92,0.572010718121523,Dovish
5,29, 국제/NNG;국가/NNG;신용등급/NNG;상향/NNG,34,0.25034951854125015,Dovish
7,17, 원화/NNG;절상/NNG;막/VV,24,0.5978935560455738,Dovish
14,33,젊은층/NNG,47,0.6160115425924094,Dovish
38,77, 가리킨다/VV,115,0.7165848556687212,Dovish
7,16, 세수입/NNG,23,0.6352619032984222,Dovish
2,16, 줬으며/VV,18,0.18150340094240633,Dovish
12,24, 끌어올린다/VV,36,0.7260136037696254,Dovish
8,20,낙폭과대주/NNG,28,0.5808108830157003,Dovish
13,33, 금리/NNG;전망/NNG;낮/VV,46,0.572010718121523,Dovish
2,15, 생상/NNG,17,0.1936036276719001,Dovish
13,31, 가격/NNG;강하/VA,44,0.6089146354196858,Dovish
20,58, 마니/NNG,78,0.5006990370825003,Dovish
56,124, 상담사/NNG,180,0.6557542227596617,Dovish
15,34,국민주택채권/NNG,49,0.6406002386202576,Dovish
5,13,최대한/MAG,18,0.5584720028997119,Dovish
13,27, 헬리콥터벤/NNG,40,0.6991242110374171,Dovish
4,12, 시종/NNG,16,0.4840090691797502,Dovish
37,76, 중장년층/NNG,113,0.7069079826177932,Dovish
19,56, 위탁운용사/NNG,75,0.4926520882722459,Dovish
16,38, 現/NNG,54,0.6113798768586319,Dovish
7,26, 발신/NNG,33,0.3909304020297983,Dovish
12,23,쿠폰/NNG,35,0.7575794126291744,Dovish
52,133,공사채/NNG,185,0.5677098856544439,Dovish
7,14,셰퍼드/NNG,21,0.7260136037696254,Dovish
8,35, 건설업/NNG;오르/VV,43,0.33189193315182874,Dovish
8,23, 수선/NNG,31,0.5050529417527828,Dovish
7,20, 오랫동안/NNG;금리/NNG;인상/NNG,27,0.5082095226387378,Dovish
79,152, 미/NNG;경제/NNG;지표/NNG;호조/NNG,231,0.7546720354973738,Dovish
26,54, 미/NNG;경제/NNG;지표/NNG;혼조/NNG,80,0.6991242110374171,Dovish
4,13, 만기상환/NNG;부담/NNG,17,0.44677760231976943,Dovish
7,14, 가격/NNG;매우/MAG;높/VA,21,0.7260136037696254,Dovish
8,18,노령화/NNG,26,0.6453454255730003,Dovish
10,20,구상/NNG,30,0.7260136037696254,Dovish
6,17, 호조/NNG;낮/VA,23,0.5124801908962061,Dovish
8,23, 나눠야/VV,31,0.5050529417527828,Dovish
6,17,어둡/VA,23,0.5124801908962061,Dovish
4,20, 금리/NNG;인상/NNG;시장/NNG;불안/NNG,24,0.29040544150785014,Dovish
10,24, 금융시장/NNG;활성화/NNG,34,0.6050113364746877,Dovish
14,33,할부금융사/NNG,47,0.6160115425924094,Dovish
36,78, 농축협/NNG,114,0.6701664034796543,Dovish
8,17, 하향/NNG;악재/NNG,25,0.6833069211949414,Dovish
8,20,씽크/NNG,28,0.5808108830157003,Dovish
1,20, 파프리카/NNG,21,0.07260136037696253,Dovish
18,43, 백혈병/NNG,61,0.6078253426908492,Dovish
5,17, 자충수/NNG,22,0.42706682574683846,Dovish
6,19,바이러스/NNG,25,0.458534907643974,Dovish
11,31, 전망/NNG;흔들/VV,42,0.5152354607397341,Dovish
4,13, 소비자/NNG;물가/NNG;오르/VV;그치/VV,17,0.44677760231976943,Dovish
5,13, 해와/XSV,18,0.5584720028997119,Dovish
17,38, 총통/NNG,55,0.6495911191622965,Dovish
4,17,평판/NNG,21,0.3416534605974707,Dovish
5,16, 벌집/NNG,21,0.4537585023560159,Dovish
14,33, 찾아와/VV,47,0.6160115425924094,Dovish
5,16, 해운회사/NNG,21,0.4537585023560159,Dovish
15,35, 은행/NNG;금리/NNG;낮/VA,50,0.6222973746596789,Dovish
20,58, 메달/NNG,78,0.5006990370825003,Dovish
10,23, 노골화/NNG,33,0.6313161771909785,Dovish
6,14, 될라/VV,20,0.622297374659679,Dovish
7,18, 생색/NNG,25,0.5646772473763753,Dovish
6,22, 신용등급/NNG;악영향/NNG,28,0.3960074202379775,Dovish
3,13, 매출/NNG;떨어/VV,16,0.33508320173982714,Dovish
9,26, 고객비중/NNG,35,0.5026248026097407,Dovish
5,13, 발행/NNG;금리/NNG;내리/VV,18,0.5584720028997119,Dovish
5,12, pmi/NNG;소폭/MAG;상승/NNG,17,0.6050113364746877,Dovish
161,439, 倍/NNG,600,0.5325202287330737,Dovish
23,45,거론/NNG,68,0.7421472394089503,Dovish
6,12, 경제/NNG;충격/NNG;없/VA,18,0.7260136037696254,Dovish
9,54,해임/NNG,63,0.24200453458987514,Dovish
5,18, 꾀한다/VV,23,0.4033408909831252,Dovish
31,76, 사칭/NNG,107,0.5922742557067997,Dovish
12,24,계좌수/NNG,36,0.7260136037696254,Dovish
29,59,몰리/VV,88,0.7137082884514961,Dovish
6,20, 굳힐/VV,26,0.43560816226177523,Dovish
12,26, 머지않/VA;금리/NNG;인상/NNG,38,0.6701664034796543,Dovish
12,30, 원엔/NNG;환율/NNG;급등/NNG,42,0.5808108830157004,Dovish
18,42, 저점/NNG;지지/NNG,60,0.6222973746596789,Dovish
11,46,대차/NNG,57,0.34722389745503823,Dovish
3,14,신용조합/NNG,17,0.3111486873298395,Dovish
5,11, 휩쓸릴/VV,16,0.6600123670632958,Dovish
5,16, 국가자산/NNG,21,0.4537585023560159,Dovish
20,41,경기민감주/NNG,61,0.7083059548971955,Dovish
7,18, 켤/VV,25,0.5646772473763753,Dovish
9,19,나눔/VV,28,0.687802361465961,Dovish
2,14, 비친다/VV,16,0.20743245821989298,Dovish
2,15, 투자/NNG;관심/NNG;많/VA,17,0.1936036276719001,Dovish
2,15, 입후보자/NNG,17,0.1936036276719001,Dovish
14,29,만기일시상환/NNG,43,0.7009786519155004,Dovish
6,15, 등분/NNG,21,0.5808108830157004,Dovish
11,41, 실적/NNG;많/VA,52,0.38956827519345755,Dovish
10,24, 대출/NNG;한도/NNG;제한/NNG,34,0.6050113364746877,Dovish
12,23, 신용협동기구/NNG,35,0.7575794126291744,Dovish
6,12, 판매/NNG;신용/NNG;증가/NNG,18,0.7260136037696254,Dovish
8,28,스티프닝/NNG,36,0.41486491643978596,Dovish
5,14, 과도/NNG;절상/NNG,19,0.5185811455497324,Dovish
13,28,은퇴자/NNG,41,0.6741554892146522,Dovish
4,13, 남매/NNG,17,0.44677760231976943,Dovish
5,14, 교통대란/NNG,19,0.5185811455497324,Dovish
18,36, 둔화/NNG;우려/NNG;증폭/NNG,54,0.7260136037696254,Dovish
12,30, 캐리/NNG;금리/NNG;낮/VA,42,0.5808108830157004,Dovish
4,14, 중과실/NNG,18,0.41486491643978596,Dovish
15,41,노트/NNG,56,0.5312294661728967,Dovish
5,13,레몬/NNG,18,0.5584720028997119,Dovish
6,15,제목/NNG,21,0.5808108830157004,Dovish
6,13, 실적/NNG;전망/NNG;하향/NNG;하락/NNG,19,0.6701664034796543,Dovish
5,12, 직위해제/NNG,17,0.6050113364746877,Dovish
4,15, 성장/NNG;목표/NNG;낮/VV,19,0.3872072553438002,Dovish
7,15, 위반자/NNG,22,0.6776126968516504,Dovish
10,22, 품절/NNG,32,0.6600123670632958,Dovish
8,36,당좌예금/NNG,44,0.32267271278650017,Dovish
9,43, 일목균형표/NNG,52,0.3039126713454246,Dovish
5,12, 미국발/NNG;인플레이션/NNG;우려/NNG,17,0.6050113364746877,Dovish
9,25, 투자/NNG;피하/VV,34,0.5227297947141304,Dovish
12,33, 대외/NNG;모멘텀/NNG,45,0.5280098936506367,Dovish
10,23, 새롭/VA;성장동력/NNG;확보/NNG,33,0.6313161771909785,Dovish
5,14, 원달러/NNG;높/VA,19,0.5185811455497324,Dovish
4,14, 영업이익/NNG;성장/NNG,18,0.41486491643978596,Dovish
5,12, 높/VA;수요/NNG;증가/NNG,17,0.6050113364746877,Dovish
12,24,융/NNG,36,0.7260136037696254,Dovish
4,12, 위협/NNG;줄/VV,16,0.4840090691797502,Dovish
3,15, 채권시장/NNG;국고채/NNG;금리/NNG;오르/VV,18,0.2904054415078502,Dovish
12,42, 短/NNG,54,0.41486491643978596,Dovish
9,32, 경제관측조사/NNG,41,0.4083826521204143,Dovish
12,32, 근저당권/NNG,44,0.5445102028272191,Dovish
10,23, 번호이동/NNG,33,0.6313161771909785,Dovish
8,21, 펑펑/MAG,29,0.5531532219197145,Dovish
12,28, 염증/NNG,40,0.622297374659679,Dovish
3,13, 예상/NNG;작/VA;않/VX,16,0.33508320173982714,Dovish
9,18, 판매/NNG;그치/VV,27,0.7260136037696254,Dovish
11,25,천문학/NNG,36,0.6388919713172704,Dovish
23,46, 미즈/NNG,69,0.7260136037696253,Dovish
23,48, 누그러뜨렸/VV,71,0.6957630369458909,Dovish
7,29, msci/NNG;지수/NNG;하락/NNG,36,0.3504893259577502,Dovish
7,22, 채권/NNG;최대/NNG,29,0.4620086569443071,Dovish
14,49, 수요/NNG;넘/VV,63,0.4148649164397859,Dovish
6,12, 기초자산/NNG;하락/NNG,18,0.7260136037696254,Dovish
16,49, 런던증권거래소/NNG,65,0.47413133307404104,Dovish
6,12, 백전백승/NNG,18,0.7260136037696254,Dovish
15,68, 이자/NNG;줄/VV,83,0.3203001193101288,Dovish
8,20, 환경/NNG;우려/NNG,28,0.5808108830157003,Dovish
7,39, 원유/NNG;재고/NNG;급증/NNG,46,0.26062026801986554,Dovish
22,70,중부/NNG,92,0.4563514080837645,Dovish
11,33, 공포/NNG;벗어나/VV,44,0.48400906917975023,Dovish
7,19, 유통센터/NNG,26,0.5349573922513029,Dovish
7,20,산지/NNG,27,0.5082095226387378,Dovish
14,31,무겁/VA,45,0.6557542227596617,Dovish
6,16, 차익매물/NNG;부담/NNG,22,0.5445102028272191,Dovish
11,40, 작/VA;증가/NNG,51,0.3993074820732939,Dovish
25,59,중구/NNG,84,0.6152657659064623,Dovish
7,20, 뿌듯/NNG,27,0.5082095226387378,Dovish
11,31, 돈/NNG;풀/VV;경기/NNG;부양/NNG,42,0.5152354607397341,Dovish
5,14, 막대/NNG;돈/NNG;풀/VV,19,0.5185811455497324,Dovish
6,23, 삐걱대/VV,29,0.3787897063145872,Dovish
12,34,처장/NNG,46,0.5124801908962061,Dovish
6,18, 해봐야/XSV,24,0.4840090691797503,Dovish
7,15, 전권/NNG,22,0.6776126968516504,Dovish
5,13,찬반/NNG,18,0.5584720028997119,Dovish
6,15, 묵묵부답/NNG,21,0.5808108830157004,Dovish
9,22,저서/NNG,31,0.5940111303569663,Dovish
7,24, 손사래/NNG,31,0.42350793553228144,Dovish
6,15,호세/NNG,21,0.5808108830157004,Dovish
11,29, 원리금/NNG;상환/NNG;부담/NNG;크/VV,40,0.5507689407907503,Dovish
4,15, 금리/NNG;장기/NNG;상승/NNG,19,0.3872072553438002,Dovish
3,14, 금리/NNG;오르/VV;가능성/NNG;없/VA,17,0.3111486873298395,Dovish
3,18, 우려/NNG;공포/NNG,21,0.24200453458987514,Dovish
12,23,환차손/NNG,35,0.7575794126291744,Dovish
22,48,수급주체/NNG,70,0.6655124701221565,Dovish
6,21,주간지/NNG,27,0.41486491643978596,Dovish
15,33, 기업/NNG;임금/NNG;인상/NNG,48,0.6600123670632958,Dovish
5,18, 고용시장/NNG;좋/VA,23,0.4033408909831252,Dovish
5,19, 국제/NNG;유가/NNG;하락/NNG;금리/NNG;인상/NNG,24,0.38211242303664494,Dovish
50,136, 대표자/NNG,186,0.5338335321835481,Dovish
7,23, 만료일/NNG,30,0.441921324033685,Dovish
6,17, 실적발표/NNG;우려/NNG,23,0.5124801908962061,Dovish
11,32, 봄기운/NNG,43,0.4991343525916174,Dovish
7,14, 기간시설/NNG,21,0.7260136037696254,Dovish
5,11, 매각조건/NNG,16,0.6600123670632958,Dovish
5,15,인수자/NNG,20,0.48400906917975023,Dovish
20,42, 축협/NNG,62,0.6914415273996433,Dovish
6,43,중간배당/NNG,49,0.2026084475636164,Dovish
5,16, 금리/NNG;인상/NNG;전망/NNG;상향/NNG,21,0.4537585023560159,Dovish
7,20, 합병증/NNG,27,0.5082095226387378,Dovish
24,63, 경차/NNG,87,0.5531532219197146,Dovish
27,57, 휴게소/NNG,84,0.6878023614659609,Dovish
15,39, 단백질/NNG,54,0.5584720028997118,Dovish
4,18,적대적/VAX,22,0.32267271278650017,Dovish
3,15, 경제/NNG;지표/NNG;많/VA,18,0.2904054415078502,Dovish
7,16, 부러워/VA,23,0.6352619032984222,Dovish
8,37, fed/NNG;언제/MAG;금리/NNG;인상/NNG,45,0.3139518286571353,Dovish
9,24, 불안/NNG;우려/NNG;크/VV,33,0.5445102028272191,Dovish
1,15, 금리/NNG;인상/NNG;전망/NNG;증가/NNG,16,0.09680181383595005,Dovish
5,14,구청/NNG,19,0.5185811455497324,Dovish
3,21, 금리/NNG;인상/NNG;전망/NNG;낮/VV,24,0.20743245821989298,Dovish
4,16, 수출/NNG;주가/NNG;상승/NNG,20,0.36300680188481266,Dovish
5,19, 포스터/NNG,24,0.38211242303664494,Dovish
3,20, 액세스/NNG,23,0.21780408113088762,Dovish
6,18,후행/NNG,24,0.4840090691797503,Dovish
7,15, 제조업/NNG;고용/NNG;감소/NNG,22,0.6776126968516504,Dovish
9,28, 태극/NNG,37,0.46672303099475926,Dovish
1,18, 수입/NNG;물가/NNG;내리/VV,19,0.08066817819662504,Dovish
4,12, 부동산/NNG;대출/NNG;억제/NNG,16,0.4840090691797502,Dovish
4,23, 회사채/NNG;수익률/NNG;높/VA,27,0.2525264708763914,Dovish
10,30, 티보/NNG,40,0.48400906917975023,Dovish
18,35,막/NNG,53,0.7467568495916148,Dovish
22,43, 지표물/NNG;오르/VV,65,0.7428976410665934,Dovish
5,12, 봉상/NNG,17,0.6050113364746877,Dovish
10,40, fed/NNG;금리/NNG;오르/VV;금리/NNG;인상/NNG,50,0.3630068018848127,Dovish
17,52, 환산액/NNG,69,0.4747012024647551,Dovish
16,50,입수/NNG,66,0.46464870641256023,Dovish
8,19, 무수익자산/NNG,27,0.6113798768586319,Dovish
7,15,실체/NNG,22,0.6776126968516504,Dovish
18,47,쿼드러플위칭데이/NNG,65,0.5560955262916281,Dovish
13,27, gdp/NNG;성장률/NNG;전망/NNG;상향/NNG,40,0.6991242110374171,Dovish
10,24,항만/NNG,34,0.6050113364746877,Dovish
7,18, 미/NNG;성장률/NNG;둔화/NNG,25,0.5646772473763753,Dovish
8,23,은행가/NNG,31,0.5050529417527828,Dovish
7,23, 투자/NNG;보류/NNG,30,0.441921324033685,Dovish
10,24, 주증/NNG,34,0.6050113364746877,Dovish
9,25,동남/NNG,34,0.5227297947141304,Dovish
5,17, 일어난다고/VV,22,0.42706682574683846,Dovish
48,132,얼/NNG,180,0.5280098936506367,Dovish
4,26, 진시/NNG,30,0.22338880115988471,Dovish
16,32,바라/VV,48,0.7260136037696253,Dovish
5,16,생계/NNG,21,0.4537585023560159,Dovish
12,23,상징/NNG,35,0.7575794126291744,Dovish
17,38, 키워왔/VV,55,0.6495911191622965,Dovish
6,23, 분양면적/NNG,29,0.3787897063145872,Dovish
11,29, 롱포지션/NNG;잡/VV,40,0.5507689407907503,Dovish
7,17, 손실/NNG;축소/NNG,24,0.5978935560455738,Dovish
7,16,입/VV,23,0.6352619032984222,Dovish
14,27,아내/NNG,41,0.7529029965018337,Dovish
5,16,매일/NNG,21,0.4537585023560159,Dovish
12,25,설계/NNG,37,0.6969730596188405,Dovish
23,70, 소회/NNG,93,0.47709465390575384,Dovish
9,28,당연직/NNG,37,0.46672303099475926,Dovish
8,20, 힘썼/VV,28,0.5808108830157003,Dovish
4,13, 낙제/NNG,17,0.44677760231976943,Dovish
5,14,태어난/VV,19,0.5185811455497324,Dovish
4,20,묻/VV,24,0.29040544150785014,Dovish
21,41, 못하/VA,62,0.7437212526420554,Dovish
12,23,세무/NNG,35,0.7575794126291744,Dovish
7,14, 부으면/VV,21,0.7260136037696254,Dovish
3,18, 진다/VV,21,0.24200453458987514,Dovish
8,33, 국채선물/NNG;혼조/NNG,41,0.3520065957670911,Dovish
597,1232, 은실/NNG,1829,0.7036203270299778,Dovish
15,56,금산분리/NNG,71,0.38893585916229934,Dovish
14,27, 하락/NNG;막/VV;못하/VX,41,0.7529029965018337,Dovish
7,21, 모기지자산/NNG,28,0.4840090691797503,Dovish
3,13,출현/NNG,16,0.33508320173982714,Dovish
5,13, 자산/NNG;건전성/NNG;안정/NNG,18,0.5584720028997119,Dovish
17,37, 자금부/NNG,54,0.6671476358964126,Dovish
4,12,재건축초과이익환수/NNG,16,0.4840090691797502,Dovish
6,12, 太/NNG,18,0.7260136037696254,Dovish
13,27,공직자/NNG,40,0.6991242110374171,Dovish
10,20, 금지령/NNG,30,0.7260136037696254,Dovish
13,46,부패/NNG,59,0.4103555151741361,Dovish
3,20,수강료/NNG,23,0.21780408113088762,Dovish
3,18,도비/NNG,21,0.24200453458987514,Dovish
13,66,투기과열지구/NNG,79,0.2860053590607615,Dovish
4,13, 직계존속/NNG,17,0.44677760231976943,Dovish
54,104, 연습/NNG,158,0.7539372039146109,Dovish
24,59,계약금/NNG,83,0.5906551352702037,Dovish
7,15, 자금출처조사/NNG,22,0.6776126968516504,Dovish
4,15,결합/NNG,19,0.3872072553438002,Dovish
6,14,독과점/NNG,20,0.622297374659679,Dovish
75,210,지방은행/NNG,285,0.5185811455497324,Dovish
5,15, 옮겨져/VV,20,0.48400906917975023,Dovish
11,26,크로나/NNG,37,0.614319203189683,Dovish
6,13, 댄스/NNG,19,0.6701664034796543,Dovish
9,22, 물가/NNG;안정/NNG;목표/NNG;하단/NNG,31,0.5940111303569663,Dovish
7,25, 분여/NNG,32,0.40656761811099024,Dovish
7,15, 트여/VV,22,0.6776126968516504,Dovish
9,25, 지표/NNG;하향/NNG,34,0.5227297947141304,Dovish
7,26,사스/NNG,33,0.3909304020297983,Dovish
4,13,외국인지분율/NNG,17,0.44677760231976943,Dovish
9,18, 중복규제/NNG,27,0.7260136037696254,Dovish
11,32, 버텨낼/VV,43,0.4991343525916174,Dovish
20,45, 가격/NNG;내림/NNG,65,0.6453454255730003,Dovish
8,27, 경제/NNG;지표/NNG;강하/VA,35,0.4302302837153335,Dovish
3,18,암보험/NNG,21,0.24200453458987514,Dovish
29,69, 지급률/NNG,98,0.6102723046179459,Dovish
13,29,상관계수/NNG,42,0.6509087482072504,Dovish
6,14, 건설/NNG;오르/VV,20,0.622297374659679,Dovish
4,14, 내수/NNG;안정/NNG,18,0.41486491643978596,Dovish
5,19,dps/NNG,24,0.38211242303664494,Dovish
24,87, 주택담보대출/NNG;금리/NNG;하락/NNG,111,0.40055922966600027,Dovish
3,15, 초인/NNG,18,0.2904054415078502,Dovish
41,117, 목표물/NNG,158,0.5088300470864041,Dovish
9,28, 서부텍사스산원유/NNG;가격/NNG;낮/VA,37,0.46672303099475926,Dovish
6,17, 해외/NNG;경기/NNG;둔화/NNG,23,0.5124801908962061,Dovish
4,16,배우/NNG,20,0.36300680188481266,Dovish
8,17, 하락/NNG;압력/NNG;제한/NNG,25,0.6833069211949414,Dovish
10,20, 푼돈/NNG,30,0.7260136037696254,Dovish
6,12, 넓이/NNG,18,0.7260136037696254,Dovish
5,25, 축구장/NNG,30,0.2904054415078502,Dovish
58,118,정책금융/NNG,176,0.7137082884514961,Dovish
5,12, 하락/NNG;가격/NNG;하락/NNG,17,0.6050113364746877,Dovish
4,14, 하락/NNG;최악/NNG,18,0.41486491643978596,Dovish
23,51, 세테크/NNG,74,0.6548357994784856,Dovish
5,12,사노피/NNG,17,0.6050113364746877,Dovish
6,14, 커넥션/NNG,20,0.622297374659679,Dovish
3,14, 씽씽/MAG,17,0.3111486873298395,Dovish
24,49, 국가산업단지/NNG,73,0.7111969996110616,Dovish
9,23, 특가/NNG,32,0.5681845594718807,Dovish
5,16, 불확실성/NNG;혼조/NNG,21,0.4537585023560159,Dovish
10,27, 가로막혀/VV,37,0.5377878546441669,Dovish
11,41, 밀어붙일/VV,52,0.38956827519345755,Dovish
10,24, 순이자이익/NNG;증가/NNG,34,0.6050113364746877,Dovish
3,16, 발파/NNG,19,0.27225510141360953,Dovish
5,14, 지역상/NNG,19,0.5185811455497324,Dovish
52,145, 최저/NNG;인하/NNG,197,0.5207269985658003,Dovish
38,106, 맞바꿀/VV,144,0.520538055532939,Dovish
14,54, 소득금액증명원/NNG,68,0.37645149825091684,Dovish
21,49, 단원/NNG,70,0.6222973746596789,Dovish
4,40,액면분할/NNG,44,0.14520272075392507,Dovish
7,25, 달리/MAG;fed/NNG;금리/NNG;인상/NNG,32,0.40656761811099024,Dovish
32,62, 성범죄/NNG,94,0.7494333974396133,Dovish
21,67, 사면초가/NNG,88,0.4551130053481234,Dovish
82,178,엘/NNG,260,0.668911410214711,Dovish
24,57,통화신용정책보고서/NNG,81,0.6113798768586319,Dovish
0,17, gdp/NNG;갭/NNG;당분간/MAG;마이너스/NNG,17,0.0,Dovish
13,34, 수익/NNG;급감/NNG,47,0.55518687347089,Dovish
4,14, 임의적립금/NNG,18,0.41486491643978596,Dovish
7,25, 법정적립금/NNG,32,0.40656761811099024,Dovish
1,19, 스팸메일/NNG,20,0.07642248460732899,Dovish
10,33, 관리사/NNG,43,0.44000824470886385,Dovish
10,49, 피싱/NNG,59,0.2963320831712757,Dovish
5,26, 퇴짜/NNG,31,0.27923600144985594,Dovish
30,59,역마진/NNG,89,0.7383189190877547,Dovish
14,29, 금리/NNG;오르/VV;채권/NNG;가격/NNG;하락/NNG,43,0.7009786519155004,Dovish
5,12, 경제/NNG;실패/NNG,17,0.6050113364746877,Dovish
5,11, 많/VA;변동성/NNG;확대/NNG,16,0.6600123670632958,Dovish
52,115,강달러/NNG,167,0.6565688242786178,Dovish
54,127, 미국발/NNG;금리/NNG;인상/NNG,181,0.61739739533165,Dovish
4,16, 옮겨온/VV,20,0.36300680188481266,Dovish
2,20, 미/NNG;국채/NNG;수익률/NNG;높/VA,22,0.14520272075392507,Dovish
4,19, 물가/NNG;상승률/NNG;플러스/NNG,23,0.30568993842931597,Dovish
5,14, 건설/NNG;회복/NNG,19,0.5185811455497324,Dovish
5,13,달/VV,18,0.5584720028997119,Dovish
8,17, 시중/NNG;돈/NNG;넘/VV,25,0.6833069211949414,Dovish
12,35, 이익비중/NNG,47,0.49783789972774317,Dovish
3,14, 가격/NNG;유가/NNG;급등/NNG,17,0.3111486873298395,Dovish
4,16, 신흥시장/NNG;회복/NNG,20,0.36300680188481266,Dovish
15,39,인선/NNG,54,0.5584720028997118,Dovish
2,17, 숙여/VV,19,0.17082673029873535,Dovish
8,19, 내림/NNG;확대/NNG,27,0.6113798768586319,Dovish
5,17, 부으/VV,22,0.42706682574683846,Dovish
87,203,곡물/NNG,290,0.6222973746596789,Dovish
8,26,회원사/NNG,34,0.44677760231976943,Dovish
9,23, 통화/NNG;하락/NNG;막/VV,32,0.5681845594718807,Dovish
9,19, 뺏길/VV,28,0.687802361465961,Dovish
10,30, 금반지/NNG,40,0.48400906917975023,Dovish
5,38, 강성/NNG;매파/NNG,43,0.19105621151832247,Dovish
7,26, 금리/NNG;인상/NNG;기대/NNG;줄/VV,33,0.3909304020297983,Dovish
14,30, 하자/NNG,44,0.6776126968516504,Dovish
5,12, 상실감/NNG,17,0.6050113364746877,Dovish
12,23, 거품/NNG;우려/NNG;크/VV,35,0.7575794126291744,Dovish
7,19, 제조업/NNG;지표/NNG;악화/NNG,26,0.5349573922513029,Dovish
7,14, 원화/NNG;통화/NNG;강세/NNG,21,0.7260136037696254,Dovish
4,22, 부조화/NNG,26,0.26400494682531833,Dovish
15,31, 연구자/NNG,46,0.7025938100996375,Dovish
14,39, 생긴다며/VV,53,0.5212405360397311,Dovish
26,58, 금리/NNG;부담/NNG;완화/NNG,84,0.6509087482072504,Dovish
7,14, 좋/VA;금리/NNG;오르/VV,21,0.7260136037696254,Dovish
6,20, 수련/NNG,26,0.43560816226177523,Dovish
9,19, 임사/NNG,28,0.687802361465961,Dovish
4,15,추구/NNG,19,0.3872072553438002,Dovish
12,26, 화색/NNG,38,0.6701664034796543,Dovish
3,16, 순이익/NNG;성장/NNG,19,0.27225510141360953,Dovish
6,17, 지는/XSV,23,0.5124801908962061,Dovish
6,17, 농업법인/NNG,23,0.5124801908962061,Dovish
5,17, 굴착기/NNG,22,0.42706682574683846,Dovish
43,114,전국은행연합회/NNG,157,0.547694473019191,Dovish
3,14, 수출/NNG;경쟁력/NNG;우려/NNG,17,0.3111486873298395,Dovish
16,42, 주택/NNG;거래/NNG;감소/NNG,58,0.5531532219197145,Dovish
11,25, 재건축조합/NNG,36,0.6388919713172704,Dovish
3,20,부담금/NNG,23,0.21780408113088762,Dovish
5,12, 하락/NNG;웃돌/VV,17,0.6050113364746877,Dovish
8,27, 뷔/NNG,35,0.4302302837153335,Dovish
43,83, 일당/NNG,126,0.7522550593275636,Dovish
7,18,고단위/NNG,25,0.5646772473763753,Dovish
13,37, 향해서/VV,50,0.5101717215678448,Dovish
5,14, 중간치/VV,19,0.5185811455497324,Dovish
5,17, 맞잡/VV,22,0.42706682574683846,Dovish
14,37,폐막/NNG,51,0.5494157001499868,Dovish
6,15,포퓰리즘/NNG,21,0.5808108830157004,Dovish
3,13, 락관/NNG,16,0.33508320173982714,Dovish
18,47, 평가서/NNG,65,0.5560955262916281,Dovish
31,61,미군/NNG,92,0.7379154661265046,Dovish
8,24, 농수/NNG,32,0.4840090691797502,Dovish
14,27,세계경제포럼/NNG,41,0.7529029965018337,Dovish
10,32,성균관/NNG,42,0.4537585023560159,Dovish
5,22, 방어책/NNG,27,0.3300061835316479,Dovish
2,15, 채산성/NNG;나쁘/VA,17,0.1936036276719001,Dovish
7,33, 카나리아/NNG,40,0.3080057712962047,Dovish
2,19, fed/NNG;이미/MAG;금리/NNG;인상/NNG,21,0.15284496921465798,Dovish
6,14,굴지/NNG,20,0.622297374659679,Dovish
11,31, 펀드붐/NNG,42,0.5152354607397341,Dovish
2,19, 소득/NNG;부진/NNG,21,0.15284496921465798,Dovish
10,23, 독수리/NNG,33,0.6313161771909785,Dovish
34,93, 부활절/NNG,127,0.5308486565197261,Dovish
6,15, 서포터/NNG,21,0.5808108830157004,Dovish
20,49, 무역기금/NNG,69,0.5926641663425514,Dovish
6,16, 신랑/NNG,22,0.5445102028272191,Dovish
7,45, 빨리/MAG;금리/NNG;인상/NNG,52,0.22587089895055013,Dovish
11,22, 정책/NNG;변화/NNG;줄/VV,33,0.7260136037696254,Dovish
2,15, 기압/NNG,17,0.1936036276719001,Dovish
11,28, 가계/NNG;부담/NNG;줄/VV,39,0.5704392601047057,Dovish
10,26,취하/VV,36,0.5584720028997119,Dovish
9,18,쥔/NNG,27,0.7260136037696254,Dovish
6,19, 개악/NNG,25,0.458534907643974,Dovish
6,13, 불안/NNG;이어지/VV;않/VX,19,0.6701664034796543,Dovish
2,14, 고용/NNG;지표/NNG;예상/NNG;호조/NNG,16,0.20743245821989298,Dovish
14,31,문서/NNG,45,0.6557542227596617,Dovish
5,14,마이너스성장률/NNG,19,0.5185811455497324,Dovish
14,29, 따라올/VV,43,0.7009786519155004,Dovish
4,15, 노동시장/NNG;강세/NNG,19,0.3872072553438002,Dovish
10,25, 가져온다는/VV,35,0.5808108830157004,Dovish
9,27, 띈다고/VV,36,0.4840090691797503,Dovish
126,256,브렌트유/NNG,382,0.7146696412107251,Dovish
8,19, 감소분/NNG;상쇄/NNG,27,0.6113798768586319,Dovish
6,19, 투자/NNG;최대/NNG,25,0.458534907643974,Dovish
9,20, 득점/NNG,29,0.6534122433926629,Dovish
112,238,상호금융/NNG,350,0.6833069211949415,Dovish
3,14, 교역/NNG;성장/NNG,17,0.3111486873298395,Dovish
4,28, 평결/NNG,32,0.20743245821989298,Dovish
2,17, 배심/NNG,19,0.17082673029873535,Dovish
5,20,곳간/NNG,25,0.3630068018848127,Dovish
24,83, 재대출/NNG,107,0.4198632889270123,Dovish
5,18,변곡점/NNG,23,0.4033408909831252,Dovish
5,39, 소매/NNG;판매/NNG;지표/NNG;호조/NNG,44,0.18615733429990394,Dovish
9,52, 집사/NNG,61,0.25131240130487037,Dovish
9,27, 판매원/NNG,36,0.4840090691797503,Dovish
20,40, 분양보증/NNG,60,0.7260136037696254,Dovish
1,15, 휴직자/NNG,16,0.09680181383595005,Dovish
4,15, 믈/NNG,19,0.3872072553438002,Dovish
13,27, 고용/NNG;지표/NNG;좋/VA;않/VX,40,0.6991242110374171,Dovish
5,22, 리크/NNG,27,0.3300061835316479,Dovish
15,33, 부동산/NNG;넘/VV,48,0.6600123670632958,Dovish
22,63,콜옵션/NNG,85,0.5070571200930717,Dovish
7,38, 주주자본/NNG,45,0.26747869612565145,Dovish
5,11, fed/NNG;금리/NNG;높/VV,16,0.6600123670632958,Dovish
21,43, 부을/VV,64,0.7091295664726573,Dovish
6,17, 실적/NNG;개선/NNG;기대/NNG;크/VV,23,0.5124801908962061,Dovish
3,14, 홀가분/NNG,17,0.3111486873298395,Dovish
6,12, 받아들/VV,18,0.7260136037696254,Dovish
27,73, 특급/NNG,100,0.5370511589528736,Dovish
25,48, 선풍/NNG,73,0.7562641705933597,Dovish
20,63, 클래식/NNG,83,0.4609610182664288,Dovish
4,19, 지표/NNG;부진/NNG;일시적/VAX,23,0.30568993842931597,Dovish
20,41, 감시인/NNG,61,0.7083059548971955,Dovish
15,41, 差/NNG,56,0.5312294661728967,Dovish
23,49, 사다리/NNG,72,0.681563791293934,Dovish
16,39,시한/NNG,55,0.5957034697596926,Dovish
8,19, 사업시행인가/NNG,27,0.6113798768586319,Dovish
20,47,숏/NNG,67,0.6178839181018089,Dovish
4,14, 앉힐/VV,18,0.41486491643978596,Dovish
7,19,대응책/NNG,26,0.5349573922513029,Dovish
14,27,통상/MAG,41,0.7529029965018337,Dovish
8,17,산업협회/NNG,25,0.6833069211949414,Dovish
8,21,우라늄/NNG,29,0.5531532219197145,Dovish
9,20, 정체/NNG;빠지/VV,29,0.6534122433926629,Dovish
11,51, 순이익/NNG;시장/NNG;예상/NNG;웃돌/VV,62,0.3131823388810148,Dovish
20,55, 독거/NNG,75,0.5280098936506367,Dovish
51,125,전미주택건설업협회/NNG,176,0.5924271006760143,Dovish
5,12, 지수/NNG;충격/NNG,17,0.6050113364746877,Dovish
36,74, 하락/NNG;우호적/VAX,110,0.7063916144785545,Dovish
6,13, 바닥/NNG;없/VA,19,0.6701664034796543,Dovish
7,15, 저점/NNG;밑돌/VV,22,0.6776126968516504,Dovish
17,42,베이비부머/NNG,59,0.5877252982896968,Dovish
31,64, 돈/NNG;넘/VV,95,0.7033256786518246,Dovish
4,16, 금리/NNG;상한/NNG;인하/NNG,20,0.36300680188481266,Dovish
12,23,황제/NNG,35,0.7575794126291744,Dovish
5,15, 전고점/NNG;회복/NNG,20,0.48400906917975023,Dovish
6,19, 보습/NNG,25,0.458534907643974,Dovish
5,11,따라선/VV,16,0.6600123670632958,Dovish
4,16, 달러엔/NNG;환율/NNG;최저/NNG,20,0.36300680188481266,Dovish
4,24, 표대/NNG,28,0.2420045345898751,Dovish
13,58,핑크/NNG,71,0.3254543741036252,Dovish
3,18, 잃어버릴/VV,21,0.24200453458987514,Dovish
13,30, 세계/NNG;경제/NNG;위축/NNG,43,0.6292117899336753,Dovish
4,23, 금리/NNG;인상/NNG;신호/NNG;주/VV;않/VX,27,0.2525264708763914,Dovish
8,18, 경제/NNG;전망/NNG;낮/VV,26,0.6453454255730003,Dovish
6,22,지키/VV,28,0.3960074202379775,Dovish
7,29, 중소기업/NNG;대출/NNG;급증/NNG,36,0.3504893259577502,Dovish
6,15, 골리앗/NNG,21,0.5808108830157004,Dovish
7,25, 소득/NNG;증빙/NNG;어렵/VA,32,0.40656761811099024,Dovish
6,13, 점친다/VV,19,0.6701664034796543,Dovish
39,111, 미/NNG;국채/NNG;금리/NNG;오르/VV,150,0.5101717215678448,Dovish
10,21, 투자조합/NNG,31,0.6914415273996433,Dovish
2,14, gni/NNG;감소/NNG,16,0.20743245821989298,Dovish
6,12, 번쩍/MAG,18,0.7260136037696254,Dovish
9,27, 금리/NNG;스프레드/NNG;확대/NNG,36,0.4840090691797503,Dovish
4,12, 꾸릴/VV,16,0.4840090691797502,Dovish
7,15, 캘/VV,22,0.6776126968516504,Dovish
3,15, 경제/NNG;불확실성/NNG;증대/NNG,18,0.2904054415078502,Dovish
7,14, 예상밖/NNG;급증/NNG,21,0.7260136037696254,Dovish
7,16, 쌌/VV,23,0.6352619032984222,Dovish
9,22, 종합보험/NNG,31,0.5940111303569663,Dovish
6,15, 보험료납입기간/NNG,21,0.5808108830157004,Dovish
3,24,격리/NNG,27,0.18150340094240636,Dovish
3,13, 암흑/NNG,16,0.33508320173982714,Dovish
13,60, 축산업/NNG,73,0.31460589496683766,Dovish
14,39,이미지/NNG,53,0.5212405360397311,Dovish
3,13,발병/NNG,16,0.33508320173982714,Dovish
15,38,건보/NNG,53,0.5731686345549674,Dovish
6,18,반기보고서/NNG,24,0.4840090691797503,Dovish
5,11, 경기/NNG;과열/NNG;방지/NNG,16,0.6600123670632958,Dovish
21,44, 안길/VV,65,0.6930129854164606,Dovish
10,28,영장/NNG,38,0.5185811455497324,Dovish
5,14, 현관/NNG,19,0.5185811455497324,Dovish
8,20,기본형/NNG,28,0.5808108830157003,Dovish
17,35, 신규/NNG;대출/NNG;중단/NNG,52,0.7052703579476362,Dovish
5,11, gdp/NNG;증가율/NNG;호조/NNG,16,0.6600123670632958,Dovish
4,17,휴면/NNG,21,0.3416534605974707,Dovish
24,56, 정모/NNG,80,0.622297374659679,Dovish
8,42, 병장/NNG,50,0.27657661095985725,Dovish
8,22, 추행/NNG,30,0.5280098936506367,Dovish
5,19,명지/NNG,24,0.38211242303664494,Dovish
6,14, 강해져서/VA,20,0.622297374659679,Dovish
5,13, 외환시장/NNG;달러원/NNG;금리/NNG;인상/NNG,18,0.5584720028997119,Dovish
12,30,앨/NNG,42,0.5808108830157004,Dovish
5,11, 높/VA;원화/NNG;강세/NNG,16,0.6600123670632958,Dovish
4,12, 급거/MAG,16,0.4840090691797502,Dovish
6,23, 정읍/NNG,29,0.3787897063145872,Dovish
2,15, 정차/NNG,17,0.1936036276719001,Dovish
10,24, 人民/NNG,34,0.6050113364746877,Dovish
5,12, 求/NNG,17,0.6050113364746877,Dovish
6,14,일반공모/NNG,20,0.622297374659679,Dovish
4,20, 내온/VV,24,0.29040544150785014,Dovish
6,27, 많/VA;돈/NNG;풀/VV,33,0.32267271278650017,Dovish
6,16, 大連/NNG,22,0.5445102028272191,Dovish
6,16, 채권펀드/NNG;강세/NNG,22,0.5445102028272191,Dovish
10,29,관심종목/NNG,39,0.5006990370825003,Dovish
4,18, 지웠/VV,22,0.32267271278650017,Dovish
4,22, 수출/NNG;전망/NNG;어둡/VA,26,0.26400494682531833,Dovish
5,12, 수입/NNG;물가/NNG;높/VV,17,0.6050113364746877,Dovish
5,11, 기대/NNG;강하/VA;상승/NNG,16,0.6600123670632958,Dovish
3,15, 투자/NNG;비중/NNG;넘/VV,18,0.2904054415078502,Dovish
4,14,파생시장/NNG,18,0.41486491643978596,Dovish
6,15, 대중/NNG;수출/NNG;감소/NNG,21,0.5808108830157004,Dovish
8,23,범죄/NNG,31,0.5050529417527828,Dovish
6,15, 개인/NNG;소비/NNG;지출/NNG;늘/VV,21,0.5808108830157004,Dovish
55,108, 산와/NNG,163,0.7394583001357296,Dovish
6,18, 다비/NNG,24,0.4840090691797503,Dovish
3,17, 감액손/NNG,20,0.25624009544810306,Dovish
12,28,상각/NNG,40,0.622297374659679,Dovish
4,12,골든/NNG,16,0.4840090691797502,Dovish
6,16, 저승/NNG,22,0.5445102028272191,Dovish
28,66, 가져다줄/VV,94,0.6160115425924094,Dovish
4,16,가용/NNG,20,0.36300680188481266,Dovish
10,24, 결제수수료/NNG,34,0.6050113364746877,Dovish
5,11,리서치팀/NNG,16,0.6600123670632958,Dovish
11,30, 서진/NNG,41,0.5324099760977252,Dovish
6,15, 성장/NNG;밑돌/VV,21,0.5808108830157004,Dovish
8,17, 불미/NNG,25,0.6833069211949414,Dovish
4,13, 강재/NNG,17,0.44677760231976943,Dovish
13,38, 이자율/NNG;내리/VV,51,0.49674614994763844,Dovish
4,12, 건선/NNG,16,0.4840090691797502,Dovish
13,26,외화유동성비율/NNG,39,0.7260136037696254,Dovish
7,14,대손율/NNG,21,0.7260136037696254,Dovish
5,31, 대외/NNG;취약/NNG,36,0.23419793669987918,Dovish
4,12, 취약/NNG;줄/VV,16,0.4840090691797502,Dovish
15,38,창조/NNG,53,0.5731686345549674,Dovish
3,17, 특별상/NNG,20,0.25624009544810306,Dovish
3,15, 일관성/NNG,18,0.2904054415078502,Dovish
14,37, 놨/VV,51,0.5494157001499868,Dovish
6,23, 미/NNG;국채/NNG;수익률/NNG;내리/VV,29,0.3787897063145872,Dovish
58,161,컨센서스/NNG,219,0.5230905468153823,Dovish
9,32, 개발지구/NNG,41,0.4083826521204143,Dovish
9,24, 유가/NNG;낙폭/NNG;확대/NNG,33,0.5445102028272191,Dovish
5,16, 휘/MAG,21,0.4537585023560159,Dovish
10,26, 광폭/NNG,36,0.5584720028997119,Dovish
6,18,조사대상기업/NNG,24,0.4840090691797503,Dovish
12,36,어린이집/NNG,48,0.4840090691797503,Dovish
9,20, 새싹/NNG,29,0.6534122433926629,Dovish
10,30, 뜨뜻미지근/NNG,40,0.48400906917975023,Dovish
1,16, 동백/NNG,17,0.09075170047120316,Dovish
15,51, 전한다/VV,66,0.4270668257468384,Dovish
3,14, 천막/NNG,17,0.3111486873298395,Dovish
17,33, 가의/NNG,50,0.7480140160050687,Dovish
4,15, 샤먼/NNG,19,0.3872072553438002,Dovish
5,12, 부동산/NNG;성장/NNG,17,0.6050113364746877,Dovish
15,30, 크라운/NNG,45,0.7260136037696253,Dovish
25,50, 수익성/NNG;나쁘/VA,75,0.7260136037696254,Dovish
3,19,기업경영분석/NNG,22,0.229267453821987,Dovish
19,46, 고용/NNG;지표/NNG;부진/NNG;금리/NNG;인상/NNG,65,0.5997503683314297,Dovish
6,12, 내수/NNG;회복/NNG;긍정적/VAX,18,0.7260136037696254,Dovish
3,18, 원화/NNG;절상/NNG;유가/NNG;급등/NNG,21,0.24200453458987514,Dovish
5,16, 박리다매/NNG,21,0.4537585023560159,Dovish
3,18, 보냈으나/VV,21,0.24200453458987514,Dovish
17,33, 뒤집힐/VV,50,0.7480140160050687,Dovish
5,12,엑스트라/NNG,17,0.6050113364746877,Dovish
6,14, 독야청청/NNG,20,0.622297374659679,Dovish
7,15, 무역/NNG;적자/NNG;해소/NNG,22,0.6776126968516504,Dovish
10,23, 수입/NNG;가격/NNG;오르/VV,33,0.6313161771909785,Dovish
6,13, 경제/NNG;회복/NNG;부담/NNG,19,0.6701664034796543,Dovish
8,27, 비용/NNG;최대/NNG,35,0.4302302837153335,Dovish
49,135, 자통법/NNG,184,0.5270320975512837,Dovish
12,28,하도급/NNG,40,0.622297374659679,Dovish
12,23, 수요/NNG;증가/NNG;둔화/NNG,35,0.7575794126291744,Dovish
2,17, 가쁜/VA,19,0.17082673029873535,Dovish
8,22, 영어교육/NNG,30,0.5280098936506367,Dovish
4,19, 중고생/NNG,23,0.30568993842931597,Dovish
8,26,익/NNG,34,0.44677760231976943,Dovish
7,15, 지킨다면/VV,22,0.6776126968516504,Dovish
10,32,현실화/NNG,42,0.4537585023560159,Dovish
5,13, 두드러진다고/VV,18,0.5584720028997119,Dovish
10,54,라이/NNG,64,0.26889392732208345,Dovish
9,22, 디테일/NNG,31,0.5940111303569663,Dovish
17,37, 합쳐진/VV,54,0.6671476358964126,Dovish
4,15, 총학생회/NNG,19,0.3872072553438002,Dovish
24,56, 염원/NNG,80,0.622297374659679,Dovish
11,23, 제로금리/NNG;탈출/NNG,34,0.6944477949100765,Dovish
5,11, 불성실/NNG,16,0.6600123670632958,Dovish
3,15, 문예/NNG,18,0.2904054415078502,Dovish
5,16, 경제/NNG;충격/NNG;완화/NNG,21,0.4537585023560159,Dovish
10,27,잔여/NNG,37,0.5377878546441669,Dovish
6,26,룸/NNG,32,0.33508320173982714,Dovish
3,21, gdp/NNG;성장률/NNG;하락/NNG,24,0.20743245821989298,Dovish
14,52, 증권선물회사/NNG,66,0.3909304020297983,Dovish
7,21,상장폐지/NNG,28,0.4840090691797503,Dovish
29,64,보건/NNG,93,0.657949828416223,Dovish
18,44, 옥상/NNG,62,0.5940111303569663,Dovish
23,89, 이용객/NNG,112,0.3752429862180086,Dovish
31,69,중국인/NNG,100,0.6523600497640113,Dovish
8,20, 우려/NNG;경제/NNG;지표/NNG;부진/NNG,28,0.5808108830157003,Dovish
4,12, 금리/NNG;오르/VV;가계/NNG;부담/NNG,16,0.4840090691797502,Dovish
6,13,장쑤/NNG,19,0.6701664034796543,Dovish
5,19, 고철/NNG,24,0.38211242303664494,Dovish
6,14,상속세/NNG,20,0.622297374659679,Dovish
8,21, 모친/NNG,29,0.5531532219197145,Dovish
8,27, 전당포/NNG,35,0.4302302837153335,Dovish
6,28, 교복/NNG,34,0.3111486873298395,Dovish
5,12, 문전성시/NNG,17,0.6050113364746877,Dovish
4,13, 나들이/NNG,17,0.44677760231976943,Dovish
41,100, 스트레티지스트/NNG,141,0.5953311550910929,Dovish
5,12, 도망/NNG,17,0.6050113364746877,Dovish
8,20, 바닥/NNG;아니/VCN,28,0.5808108830157003,Dovish
5,12, 조순/NNG,17,0.6050113364746877,Dovish
5,16, 원자재/NNG;가격/NNG;고공행진/NNG,21,0.4537585023560159,Dovish
7,17, 외국인/NNG;수급/NNG;악화/NNG,24,0.5978935560455738,Dovish
7,25, 단기/NNG;조정/NNG;압력/NNG,32,0.40656761811099024,Dovish
16,38, 완만/NNG;속도/NNG;성장/NNG,54,0.6113798768586319,Dovish
8,19, 국제/NNG;원자재/NNG;가격/NNG;급락/NNG,27,0.6113798768586319,Dovish
6,17, 펼지/VV,23,0.5124801908962061,Dovish
4,12, 고정/NNG;투자/NNG;증가/NNG,16,0.4840090691797502,Dovish
11,31, 은행/NNG;금리/NNG;내리/VV,42,0.5152354607397341,Dovish
5,12, 변두리/NNG,17,0.6050113364746877,Dovish
4,17, 식품의약품안전청/NNG,21,0.3416534605974707,Dovish
6,12,취재진/NNG,18,0.7260136037696254,Dovish
65,125, 살인/NNG,190,0.7550541479204104,Dovish
7,15, 리라/NNG;가격/NNG;급락/NNG,22,0.6776126968516504,Dovish
7,18, 원유/NNG;수요/NNG;전망/NNG;하향/NNG,25,0.5646772473763753,Dovish
7,24, 로데오/NNG,31,0.42350793553228144,Dovish
5,12, 차려야/VV,17,0.6050113364746877,Dovish
5,12,초과유동성/NNG,17,0.6050113364746877,Dovish
11,23, 집값/NNG;하락/NNG;우려/NNG,34,0.6944477949100765,Dovish
16,35,봐도/VV,51,0.6637838663036575,Dovish
11,30, 금/NNG;가격/NNG;떨어/VV,41,0.5324099760977252,Dovish
8,21, 당분간/MAG;불확실성/NNG,29,0.5531532219197145,Dovish
5,13, 단기/NNG;금리/NNG;인상/NNG;우려/NNG,18,0.5584720028997119,Dovish
10,22, 배기량/NNG,32,0.6600123670632958,Dovish
8,19, 세워졌/VV,27,0.6113798768586319,Dovish
7,14, 민구/NNG,21,0.7260136037696254,Dovish
13,34, 전단/VV,47,0.55518687347089,Dovish
19,41, 실에/NNG,60,0.6728906571523358,Dovish
4,12,장실/NNG,16,0.4840090691797502,Dovish
16,38, 사역/NNG,54,0.6113798768586319,Dovish
8,16, 묘지/NNG,24,0.7260136037696253,Dovish
6,15, 합의체/NNG,21,0.5808108830157004,Dovish
10,27, 급과/NNG,37,0.5377878546441669,Dovish
3,29, 투표소/NNG,32,0.1502097111247501,Dovish
5,32, 실망/NNG;확산/NNG,37,0.22687925117800795,Dovish
4,14, 모르쇠/NNG,18,0.41486491643978596,Dovish
4,16, 우려/NNG;감추/VV;않/VX,20,0.36300680188481266,Dovish
17,39,나눠/VV,56,0.6329349366196735,Dovish
23,44, 영국인/NNG,67,0.7590142221227901,Dovish
2,20, 메인스트리트/NNG,22,0.14520272075392507,Dovish
3,13, 필요경비/NNG,16,0.33508320173982714,Dovish
4,13, 유훈/NNG,17,0.44677760231976943,Dovish
39,119,신용거래/NNG,158,0.4758744629750486,Dovish
5,13, 대출/NNG;증가/NNG;완화/NNG,18,0.5584720028997119,Dovish
3,20, 주택담보대출/NNG;부실/NNG;우려/NNG,23,0.21780408113088762,Dovish
11,23, 하도/MAG,34,0.6944477949100765,Dovish
2,18,우리사주조합/NNG,20,0.16133635639325009,Dovish
8,24, 쓴다고/VV,32,0.4840090691797502,Dovish
4,13, 실적발표/NNG;끝/NNG,17,0.44677760231976943,Dovish
14,35, 서부텍사스산원유/NNG;하락/NNG,49,0.5808108830157003,Dovish
6,28, 네프/NNG,34,0.3111486873298395,Dovish
10,36, 연방시장/NNG,46,0.4033408909831252,Dovish
12,24, 은행/NNG;대출/NNG;받/VV;어렵/VA,36,0.7260136037696254,Dovish
41,101,예대율/NNG,142,0.5894367872189038,Dovish
5,19, 이익/NNG;하락/NNG,24,0.38211242303664494,Dovish
39,99, 다이렉트뱅킹/NNG,138,0.572010718121523,Dovish
11,35,다이렉트뱅킹/NNG,46,0.4563514080837645,Dovish
8,31, 국제/NNG;상품/NNG;가격/NNG;하락/NNG,39,0.3747166987198067,Dovish
11,23, 자산/NNG;거품/NNG;억제/NNG,34,0.6944477949100765,Dovish
69,148,인터넷은행/NNG,217,0.676958630541948,Dovish
19,44, 유로넥스트/NNG,63,0.6270117487101311,Dovish
8,21,유로넥스트/NNG,29,0.5531532219197145,Dovish
16,34, 국채/NNG;가격/NNG;금리/NNG;인상/NNG,50,0.6833069211949414,Dovish
7,16, 경기/NNG;확장/NNG;둔화/NNG,23,0.6352619032984222,Dovish
6,17, 글로벌/NNG;시장/NNG;안전자산/NNG;선호/NNG,23,0.5124801908962061,Dovish
17,37, 조선족/NNG,54,0.6671476358964126,Dovish
0,31, 일시적/VAX;경기/NNG;과열/NNG,31,0.0,Dovish
3,17, 어렵/VA;하락/NNG,20,0.25624009544810306,Dovish
32,72,행보/NNG,104,0.6453454255730003,Dovish
8,17,긍정/NNG,25,0.6833069211949414,Dovish
13,28, 공포/NNG;빠지/VV,41,0.6741554892146522,Dovish
3,18, 금리/NNG;오르내리/VV,21,0.24200453458987514,Dovish
8,17,갑작스레/MAG,25,0.6833069211949414,Dovish
14,32, 구매력/NNG;약화/NNG,46,0.6352619032984222,Dovish
15,36, 가계/NNG;부채/NNG;높/VA,51,0.6050113364746877,Dovish
4,15, 고점/NNG;떨어/VV,19,0.3872072553438002,Dovish
115,248,정원/NNG,363,0.6733190680121526,Dovish
4,13, 채권시장/NNG;밀리/VV,17,0.44677760231976943,Dovish
28,55,롱/NNG,83,0.7392138511108913,Dovish
9,30,조달청/NNG,39,0.43560816226177523,Dovish
4,17, 인터넷광고/NNG,21,0.3416534605974707,Dovish
3,15, 대출/NNG;떨어/VV,18,0.2904054415078502,Dovish
41,87, 메가뱅크/NNG,128,0.6842886840127503,Dovish
17,33, 자산부채종합관리/NNG,50,0.7480140160050687,Dovish
80,183,체크카드/NNG,263,0.6347659923668856,Dovish
11,22, 전쟁터/NNG,33,0.7260136037696254,Dovish
5,11, 성장/NNG;힘들/VA,16,0.6600123670632958,Dovish
16,45, 경기/NNG;하락/NNG;막/VV,61,0.5162763404584002,Dovish
5,16, 급락/NNG;피하/VV,21,0.4537585023560159,Dovish
45,90, 변동성지수/NNG;하락/NNG,135,0.7260136037696254,Dovish
3,18,카르텔/NNG,21,0.24200453458987514,Dovish
10,20, 직권조사/NNG,30,0.7260136037696254,Dovish
13,30, 연패/NNG,43,0.6292117899336753,Dovish
7,15, 재용/NNG,22,0.6776126968516504,Dovish
18,50, 금리/NNG;많이/MAG;빠지/VV,68,0.5227297947141304,Dovish
10,20,재할인/NNG,30,0.7260136037696254,Dovish
1,15, 대출/NNG;금리/NNG;소폭/MAG;상승/NNG,16,0.09680181383595005,Dovish
6,15, 실적/NNG;개선/NNG;가능성/NNG;높/VA,21,0.5808108830157004,Dovish
1,16, 당일결제/NNG,17,0.09075170047120316,Dovish
31,64, 핫라인/NNG,95,0.7033256786518246,Dovish
74,170,중소기업중앙회/NNG,244,0.632058902105321,Dovish
5,13, 지분법손실/NNG,18,0.5584720028997119,Dovish
2,16, 경계선/NNG;넘/VV,18,0.18150340094240633,Dovish
11,26, 금리/NNG;상승/NNG;취약/NNG,37,0.614319203189683,Dovish
1,17, 원형/NNG,18,0.08541336514936768,Dovish
4,18, 지정학/NNG;불안/NNG;완화/NNG,22,0.32267271278650017,Dovish
10,24, 원자재/NNG;가격/NNG;내리/VV,34,0.6050113364746877,Dovish
4,12,동발/NNG,16,0.4840090691797502,Dovish
6,12,벽/NNG,18,0.7260136037696254,Dovish
3,19,금리대/NNG,22,0.229267453821987,Dovish
48,101, 라이어빌리티스왑/NNG,149,0.6900723362562776,Dovish
9,18,압도/NNG,27,0.7260136037696254,Dovish
5,14, 통화/NNG;가격/NNG;하락/NNG,19,0.5185811455497324,Dovish
6,16, 해변/NNG,22,0.5445102028272191,Dovish
25,78, 피격/NNG,103,0.4653933357497599,Dovish
3,19, 내모/VV,22,0.229267453821987,Dovish
4,17, 금융정보분석원/NNG,21,0.3416534605974707,Dovish
1,20, 작업장/NNG,21,0.07260136037696253,Dovish
16,33,광산업/NNG,49,0.7040131915341822,Dovish
3,13, 금리/NNG;하락/NNG;영향/NNG;받/VV;강세/NNG,16,0.33508320173982714,Dovish
1,15, 계약자배당/NNG,16,0.09680181383595005,Dovish
18,36,최신/NNG,54,0.7260136037696254,Dovish
6,19, 성도/NNG,25,0.458534907643974,Dovish
3,13, 고유동성/NNG;높/VA,16,0.33508320173982714,Dovish
19,49, 내부자거래/NNG,68,0.5630309580254238,Dovish
3,14,대폭락/NNG,17,0.3111486873298395,Dovish
96,224, crs/NNG;오르/VV,320,0.622297374659679,Dovish
9,24,현충일/NNG,33,0.5445102028272191,Dovish
7,21,폭락장/NNG,28,0.4840090691797503,Dovish
18,40, 약물/NNG,58,0.6534122433926629,Dovish
7,17, 독신/NNG,24,0.5978935560455738,Dovish
5,13, 입소/NNG,18,0.5584720028997119,Dovish
7,25, 짓눌린/VV,32,0.40656761811099024,Dovish
8,16, 주진/NNG,24,0.7260136037696253,Dovish
6,18, 금리/NNG;인상/NNG;작/VV,24,0.4840090691797503,Dovish
22,62, 가격/NNG;추락/NNG,84,0.5152354607397341,Dovish
6,13,상장종목/NNG,19,0.6701664034796543,Dovish
5,12, 긴급통화/NNG,17,0.6050113364746877,Dovish
100,347, cd/NNG;금리/NNG;하락/NNG,447,0.4184516448239916,Dovish
5,19, 비정부기구/NNG,24,0.38211242303664494,Dovish
8,17, 達/NNG,25,0.6833069211949414,Dovish
6,28, 지수/NNG;경제/NNG;지표/NNG;부진/NNG,34,0.3111486873298395,Dovish
12,23, 심리/NNG;나쁘/VA,35,0.7575794126291744,Dovish
17,34, 격랑/NNG,51,0.7260136037696254,Dovish
18,41,밤새/NNG,59,0.637475359407476,Dovish
3,14, 곶감/NNG,17,0.3111486873298395,Dovish
36,83, 계파/NNG,119,0.6297949333905184,Dovish
7,14, 온천/NNG,21,0.7260136037696254,Dovish
12,26, 업황/NNG;좋/VA,38,0.6701664034796543,Dovish
5,20,보증보험/NNG,25,0.3630068018848127,Dovish
4,12, 전망/NNG;내리/VV;잡/VV,16,0.4840090691797502,Dovish
2,16, 글로벌/NNG;경기/NNG;둔화/NNG;금리/NNG;인상/NNG,18,0.18150340094240633,Dovish
7,18,후발주자/NNG,25,0.5646772473763753,Dovish
8,22, 돈/NNG;가격/NNG;떨어/VV,30,0.5280098936506367,Dovish
9,46,중앙은행장/NNG,55,0.28409227973594037,Dovish
11,25, 대손비용/NNG;줄/VV,36,0.6388919713172704,Dovish
18,42, 에디터/NNG,60,0.6222973746596789,Dovish
8,29, 피습/NNG,37,0.4005592296660002,Dovish
7,18, 은행/NNG;예금/NNG;금리/NNG;높/VA,25,0.5646772473763753,Dovish
7,15,드러난/VV,22,0.6776126968516504,Dovish
4,14,환경오염/NNG,18,0.41486491643978596,Dovish
8,28,즉시/MAG,36,0.41486491643978596,Dovish
10,31,관영/NNG,41,0.46839587339975836,Dovish
14,27,초상/NNG,41,0.7529029965018337,Dovish
7,22, 어렵/VA;관측/NNG;우세/NNG,29,0.4620086569443071,Dovish
10,24, 내려간다는/VV,34,0.6050113364746877,Dovish
7,16, 주택담보대출/NNG;상환/NNG;부담/NNG,23,0.6352619032984222,Dovish
4,12, 외국인/NNG;안전자산/NNG;선호/NNG,16,0.4840090691797502,Dovish
6,12, 위험자산/NNG;피하/VV,18,0.7260136037696254,Dovish
6,15, 가실/VV,21,0.5808108830157004,Dovish
5,17, 기대/NNG;반대/NNG,22,0.42706682574683846,Dovish
5,14, 무승부/NNG,19,0.5185811455497324,Dovish
7,28,산정/NNG,35,0.3630068018848127,Dovish
6,14,나무/NNG,20,0.622297374659679,Dovish
7,18, 부동산/NNG;자산/NNG;가격/NNG;하락/NNG,25,0.5646772473763753,Dovish
23,47, 당직자/NNG,70,0.7105665058170801,Dovish
6,12, 당헌/NNG,18,0.7260136037696254,Dovish
5,13, 共同/NNG,18,0.5584720028997119,Dovish
5,25, 집수리/NNG,30,0.2904054415078502,Dovish
5,15, 폐막식/NNG,20,0.48400906917975023,Dovish
3,13, 솔로/NNG,16,0.33508320173982714,Dovish
6,16, 수익/NNG;긍정적/VAX,22,0.5445102028272191,Dovish
15,36, 지표/NNG;호조/NNG;fed/NNG;금리/NNG;인상/NNG,51,0.6050113364746877,Dovish
10,34, 주택담보대출/NNG;금리/NNG;최저/NNG,44,0.42706682574683846,Dovish
23,52, 관청/NNG,75,0.6422428033346685,Dovish
6,14,발의/NNG,20,0.622297374659679,Dovish
27,56, 무역거래/NNG,83,0.7000845464921388,Dovish
7,23, 구설/NNG,30,0.441921324033685,Dovish
5,26,혹독/NNG,31,0.27923600144985594,Dovish
11,25,리더십/NNG,36,0.6388919713172704,Dovish
17,44,브루킹스연구소/NNG,61,0.5610105120038015,Dovish
6,14,리스트/NNG,20,0.622297374659679,Dovish
392,775,호주달러/NNG,1167,0.7344447294908212,Dovish
8,16, 악영향/NNG;상쇄/NNG,24,0.7260136037696253,Dovish
5,13, 면도/NNG,18,0.5584720028997119,Dovish
10,20,장거리미사일발사/NNG,30,0.7260136037696254,Dovish
13,33, 규제개혁위원회/NNG,46,0.572010718121523,Dovish
77,200,송고/NNG,277,0.5590304749026116,Dovish
14,41, 사들인다/VV,55,0.4958141684280369,Dovish
5,12, 자금량/NNG,17,0.6050113364746877,Dovish
23,47, 금융협회/NNG,70,0.7105665058170801,Dovish
11,27, 화약/NNG,38,0.5915666401085836,Dovish
5,11, 勝/NNG,16,0.6600123670632958,Dovish
24,49, 국조/NNG,73,0.7111969996110616,Dovish
6,12, 인상/NNG;가능성/NNG;그치/VV,18,0.7260136037696254,Dovish
5,12,실적치/NNG,17,0.6050113364746877,Dovish
8,17, 모니/NNG,25,0.6833069211949414,Dovish
2,14, 호조/NNG;경제/NNG;성장/NNG,16,0.20743245821989298,Dovish
8,17, 비켜서/VV,25,0.6833069211949414,Dovish
7,14, 발행/NNG;금리/NNG;떨어/VV,21,0.7260136037696254,Dovish
201,565,채권스왑/NNG,766,0.5165618915316627,Dovish
6,18, 채권스왑/NNG;스프레드/NNG;확대/NNG,24,0.4840090691797503,Dovish
28,62, 오퍼우위/NNG,90,0.6557542227596617,Dovish
7,14, 통안채/NNG;금리/NNG;떨어/VV,21,0.7260136037696254,Dovish
15,33,기상/NNG,48,0.6600123670632958,Dovish
5,12, 세계/NNG;경제/NNG;하락/NNG,17,0.6050113364746877,Dovish
19,37, 강연자/NNG,56,0.7456355930606964,Dovish
67,139,바이트/NNG,206,0.6998980065117251,Dovish
11,27, 전망/NNG;소폭/MAG;하락/NNG,38,0.5915666401085836,Dovish
18,57, 비명/NNG,75,0.4585349076439739,Dovish
11,92, 콕스/NNG,103,0.17361194872751912,Dovish
13,29,셰/NNG,42,0.6509087482072504,Dovish
2,14, 저성장/NNG;늪/NNG,16,0.20743245821989298,Dovish
40,83,유로스타트/NNG,123,0.6997721482116871,Dovish
16,40,랜드화/NNG,56,0.5808108830157003,Dovish
17,39, 홍대/NNG,56,0.6329349366196735,Dovish
3,19, 애꿎/VA,22,0.229267453821987,Dovish
33,87, 보직/NNG,120,0.5507689407907502,Dovish
9,35, 면직/NNG,44,0.3733784247958074,Dovish
3,15, 일반직/NNG,18,0.2904054415078502,Dovish
13,28,진흥/NNG,41,0.6741554892146522,Dovish
7,18, 금리갭/NNG;최저/NNG,25,0.5646772473763753,Dovish
6,25,입찰일/NNG,31,0.34848652980942024,Dovish
26,65, 꾸리/VV,91,0.5808108830157004,Dovish
12,33, 역주행/NNG,45,0.5280098936506367,Dovish
8,16, 산업/NNG;내리/VV,24,0.7260136037696253,Dovish
8,20, 해외/NNG;경제/NNG;둔화/NNG,28,0.5808108830157003,Dovish
75,157, 공동구매/NNG,232,0.6936435704805338,Dovish
12,25, 실수요자/NNG;피해/NNG,37,0.6969730596188405,Dovish
5,16, 반찬/NNG,21,0.4537585023560159,Dovish
4,16, 재정비촉진지구/NNG,20,0.36300680188481266,Dovish
7,17, 정책/NNG;경계/NNG,24,0.5978935560455738,Dovish
50,126, crs/NNG;금리/NNG;오르/VV,176,0.576201272833036,Dovish
8,28, irs/NNG;금리/NNG;떨어/VV,36,0.41486491643978596,Dovish
5,13, 노장/NNG,18,0.5584720028997119,Dovish
4,50, 향남/NNG,54,0.11616217660314006,Dovish
8,16, 주택담보대출/NNG;금리/NNG;낮/VV,24,0.7260136037696253,Dovish
9,26,긴급회의/NNG,35,0.5026248026097407,Dovish
187,555,디폴트/NNG,742,0.4892415996573692,Dovish
308,643,cds/NNG,951,0.6955278070327982,Dovish
4,21, 래드/NNG,25,0.27657661095985725,Dovish
9,27, 기초/NNG;재정/NNG;흑자/NNG,36,0.4840090691797503,Dovish
12,32, 이미/MAG;fed/NNG;금리/NNG;인상/NNG,44,0.5445102028272191,Dovish
6,16, 공급/NNG;촉진/NNG,22,0.5445102028272191,Dovish
19,41, 통영/NNG,60,0.6728906571523358,Dovish
6,13, 대출/NNG;증가/NNG;확대/NNG,19,0.6701664034796543,Dovish
7,24, 부동산/NNG;가격/NNG;내리/VV,31,0.42350793553228144,Dovish
10,20, 꼬일/VV,30,0.7260136037696254,Dovish
7,17, 사각/NNG,24,0.5978935560455738,Dovish
9,22, 높/VA;주가/NNG;상승/NNG,31,0.5940111303569663,Dovish
12,43,양자/NNG,55,0.4052168951272328,Dovish
7,24, 전자파/NNG,31,0.42350793553228144,Dovish
13,29, 신청액/NNG,42,0.6509087482072504,Dovish
14,41,용어/NNG,55,0.4958141684280369,Dovish
5,14, 형편없이/MAG,19,0.5185811455497324,Dovish
6,20,외곽/NNG,26,0.43560816226177523,Dovish
14,33, 번개/NNG,47,0.6160115425924094,Dovish
9,23, 무소/NNG,32,0.5681845594718807,Dovish
12,23, 언질/NNG,35,0.7575794126291744,Dovish
5,13, 아슬/NNG,18,0.5584720028997119,Dovish
2,14, fed/NNG;시장/NNG;불확실성/NNG,16,0.20743245821989298,Dovish
8,19, 경제/NNG;성장/NNG;불확실성/NNG,27,0.6113798768586319,Dovish
12,29, 모욕/NNG,41,0.6008388444990004,Dovish
5,13, 등교/NNG,18,0.5584720028997119,Dovish
28,57, 가자지구/NNG,85,0.7132765230017372,Dovish
4,14, 금리/NNG;인상/NNG;기대/NNG;희석/NNG,18,0.41486491643978596,Dovish
30,71,경제활동참가율/NNG,101,0.6135326229039088,Dovish
7,15, 테제/NNG,22,0.6776126968516504,Dovish
4,12,구직자/NNG,16,0.4840090691797502,Dovish
5,12,진동수/NNG,17,0.6050113364746877,Dovish
42,100, 공안/NNG,142,0.6098514271664853,Dovish
8,26, 형사부/NNG,34,0.44677760231976943,Dovish
12,36,구청장/NNG,48,0.4840090691797503,Dovish
6,32, 부조리/NNG,38,0.27225510141360953,Dovish
1,15, 지수/NNG;최저/NNG;추락/NNG,16,0.09680181383595005,Dovish
29,64,영업손실/NNG,93,0.657949828416223,Dovish
3,15, 비선형/NNG,18,0.2904054415078502,Dovish
5,12, 기대/NNG;좋/VA;않/VX,17,0.6050113364746877,Dovish
8,23,국세청장/NNG,31,0.5050529417527828,Dovish
16,54,경제수장/NNG,70,0.4302302837153335,Dovish
5,20, 주춧돌/NNG,25,0.3630068018848127,Dovish
11,23,금융투자상품/NNG,34,0.6944477949100765,Dovish
5,20, 기가/NNG,25,0.3630068018848127,Dovish
7,26,지대/NNG,33,0.3909304020297983,Dovish
2,16, 신빈곤층/NNG,18,0.18150340094240633,Dovish
37,83,에르/NNG,120,0.6472892370958107,Dovish
6,22, 수사학/NNG,28,0.3960074202379775,Dovish
5,19,신상/NNG,24,0.38211242303664494,Dovish
4,20, 정리매매/NNG,24,0.29040544150785014,Dovish
5,18, 인문학/NNG,23,0.4033408909831252,Dovish
11,30, 외국인투자기업/NNG,41,0.5324099760977252,Dovish
106,265, crs/NNG;금리/NNG;하락/NNG,371,0.5808108830157004,Dovish
90,223, irs/NNG;금리/NNG;하락/NNG,313,0.5860199492310877,Dovish
8,23, 당청/NNG,31,0.5050529417527828,Dovish
9,21, 원엔/NNG;환율/NNG;최저/NNG,30,0.6222973746596789,Dovish
10,27,보조/NNG,37,0.5377878546441669,Dovish
20,42, 잠적/NNG,62,0.6914415273996433,Dovish
4,17, 월액/NNG,21,0.3416534605974707,Dovish
4,21, 경기/NNG;불안/NNG;크/VV,25,0.27657661095985725,Dovish
13,31, 잇속/NNG,44,0.6089146354196858,Dovish
8,25,산불/NNG,33,0.46464870641256023,Dovish
11,22,선인/NNG,33,0.7260136037696254,Dovish
16,41, 양허/NNG,57,0.5666447639177564,Dovish
10,20, 유동성/NNG;문제/NNG;해소/NNG,30,0.7260136037696254,Dovish
7,16, 문란/NNG,23,0.6352619032984222,Dovish
27,64, 전화회의/NNG,91,0.6125739781806214,Dovish
10,20,지하/NNG,30,0.7260136037696254,Dovish
12,28, 미확인/NNG,40,0.622297374659679,Dovish
4,18,미사/NNG,22,0.32267271278650017,Dovish
5,15, 차주/NNG;상환/NNG;부담/NNG,20,0.48400906917975023,Dovish
8,17, 시몬/NNG,25,0.6833069211949414,Dovish
3,17, 결제비율/NNG,20,0.25624009544810306,Dovish
4,12, 불확실성/NNG;시장/NNG;불안/NNG,16,0.4840090691797502,Dovish
57,140,위안화예금/NNG,197,0.591182505926695,Dovish
10,25, 고용/NNG;성장/NNG;둔화/NNG,35,0.5808108830157004,Dovish
4,12, 위험자산/NNG;축소/NNG,16,0.4840090691797502,Dovish
6,12,최종안/NNG,18,0.7260136037696254,Dovish
3,17, 경제/NNG;제재/NNG;강화/NNG,20,0.25624009544810306,Dovish
22,54, 실습/NNG,76,0.5915666401085836,Dovish
3,13, 채권/NNG;신용등급/NNG;낮/VA,16,0.33508320173982714,Dovish
6,12, 성품/NNG,18,0.7260136037696254,Dovish
5,14, 수입/NNG;보험료/NNG;증가/NNG,19,0.5185811455497324,Dovish
5,16, gdp/NNG;마이너스성장/NNG,21,0.4537585023560159,Dovish
4,19,연비/NNG,23,0.30568993842931597,Dovish
3,13, 헤아릴/VV,16,0.33508320173982714,Dovish
4,12,장전/NNG,16,0.4840090691797502,Dovish
10,25,예수금/NNG,35,0.5808108830157004,Dovish
6,14, 반선/NNG,20,0.622297374659679,Dovish
3,13, 이자/NNG;수입/NNG;증가/NNG,16,0.33508320173982714,Dovish
13,40, 처우/NNG,53,0.4719088424502565,Dovish
18,39, 거래패턴/NNG,57,0.6701664034796543,Dovish
10,25, 유동성/NNG;긴축/NNG;우려/NNG,35,0.5808108830157004,Dovish
17,38,개별기업/NNG,55,0.6495911191622965,Dovish
5,13, 거시/NNG;불안/NNG,18,0.5584720028997119,Dovish
5,11, 표결권/NNG,16,0.6600123670632958,Dovish
6,15, 기간스프레드/NNG,21,0.5808108830157004,Dovish
12,34,조찬/NNG,46,0.5124801908962061,Dovish
47,94,공습/NNG,141,0.7260136037696254,Dovish
8,24, 매크로/NNG;모멘텀/NNG,32,0.4840090691797502,Dovish
40,108, 금리/NNG;인상/NNG;가능성/NNG;인상/NNG,148,0.5377878546441669,Dovish
6,20, 세계/NNG;경제/NNG;침체/NNG;우려/NNG,26,0.43560816226177523,Dovish
7,15, 외교전/NNG,22,0.6776126968516504,Dovish
15,33,법조/NNG,48,0.6600123670632958,Dovish
14,27, 시너/NNG,41,0.7529029965018337,Dovish
10,24, 취약/NNG;않/VX,34,0.6050113364746877,Dovish
57,115,임시/NNG,172,0.7197004419977157,Dovish
8,24, 로열층/NNG,32,0.4840090691797502,Dovish
4,23, 특별교부세/NNG,27,0.2525264708763914,Dovish
33,115, 실종자/NNG,148,0.41666867694604587,Dovish
12,27, 유실/NNG,39,0.6453454255730003,Dovish
11,25, 국번/NNG,36,0.6388919713172704,Dovish
7,21, 재난관리/NNG,28,0.4840090691797503,Dovish
28,63,피해자/NNG,91,0.6453454255730003,Dovish
3,16, 체납처분/NNG,19,0.27225510141360953,Dovish
6,16, 비상근/NNG,22,0.5445102028272191,Dovish
9,19, 순이자마진/NNG;방어/NNG,28,0.687802361465961,Dovish
11,22,강사/NNG,33,0.7260136037696254,Dovish
3,14, 경제/NNG;살/VV;못하/VX,17,0.3111486873298395,Dovish
5,11, 첩경/NNG,16,0.6600123670632958,Dovish
12,25,양질/NNG,37,0.6969730596188405,Dovish
6,15, 경기/NNG;부양책/NNG;없/VA,21,0.5808108830157004,Dovish
4,16, 이자/NNG;납입/NNG;유예/NNG,20,0.36300680188481266,Dovish
10,24,중고/NNG,34,0.6050113364746877,Dovish
6,28, 긴급운영자금/NNG,34,0.3111486873298395,Dovish
14,35,콜센터/NNG,49,0.5808108830157003,Dovish
12,36, 끌어안/VV,48,0.4840090691797503,Dovish
19,56, 동선/NNG,75,0.4926520882722459,Dovish
10,21, 물린다/VV,31,0.6914415273996433,Dovish
7,15,조율/NNG,22,0.6776126968516504,Dovish
12,31, 경제/NNG;하방/NNG;위험/NNG;크/VV,43,0.5620750480797101,Dovish
13,35,별개/NNG,48,0.5393243913717217,Dovish
9,19, 경제/NNG;침체/NNG;빠지/VV;않/VX,28,0.687802361465961,Dovish
2,14, 신규/NNG;수주/NNG;호조/NNG,16,0.20743245821989298,Dovish
6,18, 매도가격/NNG,24,0.4840090691797503,Dovish
3,18, 면회소/NNG,21,0.24200453458987514,Dovish
8,21, 발화/NNG,29,0.5531532219197145,Dovish
8,16, 목격자/NNG,24,0.7260136037696253,Dovish
6,30, 감식/NNG,36,0.2904054415078502,Dovish
9,24, 빼돌려/VV,33,0.5445102028272191,Dovish
6,17,기밀/NNG,23,0.5124801908962061,Dovish
3,13, 살만/NNG,16,0.33508320173982714,Dovish
5,14, 양극단/NNG,19,0.5185811455497324,Dovish
6,19, fed/NNG;인플레이션/NNG;상승/NNG,25,0.458534907643974,Dovish
16,31, 상승률/NNG;최대/NNG,47,0.7494333974396133,Dovish
4,12, 눈코/NNG,16,0.4840090691797502,Dovish
6,13, 그려왔/VV,19,0.6701664034796543,Dovish
7,19, 틔우/VV,26,0.5349573922513029,Dovish
5,13, 건설공제조합/NNG,18,0.5584720028997119,Dovish
5,18, 여태/NNG,23,0.4033408909831252,Dovish
18,66, 표절/NNG,84,0.3960074202379775,Dovish
26,110, 입주민/NNG,136,0.34320643087291386,Dovish
8,18, 둔화/NNG;공포/NNG,26,0.6453454255730003,Dovish
7,22, 둔화/NNG;우려/NNG;하락/NNG,29,0.4620086569443071,Dovish
55,124,밀/NNG,179,0.6440443259246678,Dovish
6,21, 연보/NNG,27,0.41486491643978596,Dovish
13,37,진보/NNG,50,0.5101717215678448,Dovish
4,13, 소신껏/MAG,17,0.44677760231976943,Dovish
7,17, 자금/NNG;작/VA,24,0.5978935560455738,Dovish
6,26, 통화정책/NNG;불확실성/NNG;크/VV,32,0.33508320173982714,Dovish
8,35, 방류/NNG,43,0.33189193315182874,Dovish
5,18, 신용등급/NNG;추락/NNG,23,0.4033408909831252,Dovish
4,25, 깎였/VV,29,0.23232435320628012,Dovish
6,15, 회복/NNG;불가능/NNG,21,0.5808108830157004,Dovish
10,20, 채권/NNG;발행/NNG;어렵/VA,30,0.7260136037696254,Dovish
11,29, 타르/NNG,40,0.5507689407907503,Dovish
5,17, gdp/NNG;성장률/NNG;밑돌/VV,22,0.42706682574683846,Dovish
5,15, 금융시스템/NNG;강화/NNG,20,0.48400906917975023,Dovish
5,12, 이로울/VA,17,0.6050113364746877,Dovish
14,28,본질/NNG,42,0.7260136037696254,Dovish
49,103,억제/NNG,152,0.6907702249458573,Dovish
15,40, 소매/NNG;판매가격/NNG;부진/NNG,55,0.544510202827219,Dovish
5,11, 금리/NNG;최대한/MAG;낮/VV,16,0.6600123670632958,Dovish
8,16, 전세가격/NNG;오르/VV;상승/NNG,24,0.7260136037696253,Dovish
9,20, 비차/NNG,29,0.6534122433926629,Dovish
27,56, 패스트리테일링/NNG,83,0.7000845464921388,Dovish
7,18, 휘발유/NNG;가격/NNG;내리/VV,25,0.5646772473763753,Dovish
10,54, 해수욕장/NNG,64,0.26889392732208345,Dovish
35,68, 低下/NNG,103,0.7473669450569673,Dovish
7,25, 악성코드/NNG,32,0.40656761811099024,Dovish
3,16, 케인스/NNG,19,0.27225510141360953,Dovish
10,29,유럽연합집행위원회/NNG,39,0.5006990370825003,Dovish
6,24, 금리상환/NNG,30,0.3630068018848127,Dovish
38,94, 중소기업중앙회/NNG,132,0.5869897221967184,Dovish
14,42,반월/NNG,56,0.4840090691797503,Dovish
7,17,코치/NNG,24,0.5978935560455738,Dovish
3,25, 물가/NNG;시장/NNG;예상/NNG;밑돌/VV,28,0.17424326490471012,Dovish
72,157, 세계/NNG;경제/NNG;침체/NNG,229,0.6658978276613124,Dovish
13,55, 플랜b/NNG,68,0.34320643087291386,Dovish
10,35, 천둥/NNG,45,0.41486491643978596,Dovish
5,27, 실적/NNG;시장/NNG;예상/NNG;넘/VV,32,0.26889392732208345,Dovish
5,17, 진천/NNG,22,0.42706682574683846,Dovish
6,13, 지배적사업자/NNG,19,0.6701664034796543,Dovish
36,74, 견본주택/NNG,110,0.7063916144785545,Dovish
9,23,경제인/NNG,32,0.5681845594718807,Dovish
43,90, 바우처/NNG,133,0.6937463324909754,Dovish
5,17, 초속/NNG,22,0.42706682574683846,Dovish
6,18, 숙인/VV,24,0.4840090691797503,Dovish
6,15, 금리/NNG;내리/VV;가능성/NNG;높/VA,21,0.5808108830157004,Dovish
6,15, 환위험/NNG;피하/VV,21,0.5808108830157004,Dovish
61,119, 떠받칠/VV,180,0.7443164677302042,Dovish
32,63, 승무원/NNG,95,0.7375376292262861,Dovish
13,29,인재/NNG,42,0.6509087482072504,Dovish
4,13, 경기민감섹터/NNG,17,0.44677760231976943,Dovish
7,16, 식료품비/NNG,23,0.6352619032984222,Dovish
14,39, 금리/NNG;내리/VV;오르/VV,53,0.5212405360397311,Dovish
8,16,유사시/NNG,24,0.7260136037696253,Dovish
4,13, 외국인/NNG;투자자금/NNG;빠지/VV,17,0.44677760231976943,Dovish
7,15, 원화/NNG;소폭/MAG;강세/NNG,22,0.6776126968516504,Dovish
6,20, 진풍경/NNG,26,0.43560816226177523,Dovish
5,14, 원법/NNG,19,0.5185811455497324,Dovish
5,18, irs/NNG;강세/NNG,23,0.4033408909831252,Dovish
13,27,부대/NNG,40,0.6991242110374171,Dovish
5,15, 점차/MAG;하락/NNG;압력/NNG,20,0.48400906917975023,Dovish
7,14, 미시경제/NNG,21,0.7260136037696254,Dovish
10,20, 지표물/NNG;금리/NNG;오르/VV,30,0.7260136037696254,Dovish
27,60, 예상/NNG;웃돌/VV;상승/NNG,87,0.6534122433926628,Dovish
10,29, 유로스톡스50/NNG,39,0.5006990370825003,Dovish
7,21, 부진/NNG;우려/NNG;크/VV,28,0.4840090691797503,Dovish
223,601,매매주체/NNG,824,0.5387721585378584,Dovish
5,12, 재정/NNG;역할/NNG;확대/NNG,17,0.6050113364746877,Dovish
6,19,포스/NNG,25,0.458534907643974,Dovish
5,14,수익원/NNG,19,0.5185811455497324,Dovish
5,15, 집행임원/NNG,20,0.48400906917975023,Dovish
5,14,순환출자/NNG,19,0.5185811455497324,Dovish
4,14, 둔화/NNG;심각/NNG,18,0.41486491643978596,Dovish
25,66, 채권시장/NNG;강세/NNG;채권/NNG;금리/NNG;하락/NNG,91,0.5500103058860799,Dovish
11,28,기고문/NNG,39,0.5704392601047057,Dovish
12,25,진주/NNG,37,0.6969730596188405,Dovish
5,11,극/NNG,16,0.6600123670632958,Dovish
29,61, 영화제/NNG,90,0.6903080166989881,Dovish
6,24,휴전/NNG,30,0.3630068018848127,Dovish
7,16, 열렬/NNG,23,0.6352619032984222,Dovish
49,100, 병열/NNG,149,0.711493331694233,Dovish
7,17, 중태/NNG,24,0.5978935560455738,Dovish
27,93,외환선물/NNG,120,0.42155628605978246,Dovish
4,23, 대출/NNG;부담/NNG;줄/VV,27,0.2525264708763914,Dovish
4,15, 대출/NNG;이자/NNG;줄/VV,19,0.3872072553438002,Dovish
26,57, 麻/NNG,83,0.6623281999301845,Dovish
49,104, 生太/NNG,153,0.6841282035521471,Dovish
59,124, 郞/NNG,183,0.6908839132646435,Dovish
11,22, 일교차/NNG,33,0.7260136037696254,Dovish
4,14, 마두/NNG,18,0.41486491643978596,Dovish
4,15, gdp/NNG;내리/VV,19,0.3872072553438002,Dovish
5,16, 동광/NNG,21,0.4537585023560159,Dovish
53,102, 항소심/NNG,155,0.7544847254860813,Dovish
11,27,폭염/NNG,38,0.5915666401085836,Dovish
4,22, 폭파/NNG,26,0.26400494682531833,Dovish
4,12, 장기물/NNG;금리/NNG;급락/NNG,16,0.4840090691797502,Dovish
7,21,아이디/NNG,28,0.4840090691797503,Dovish
4,25, 경마/NNG,29,0.23232435320628012,Dovish
5,16, cd/NNG;발행/NNG;줄/VV,21,0.4537585023560159,Dovish
6,12, 통할까/VV,18,0.7260136037696254,Dovish
2,17, 근현/NNG,19,0.17082673029873535,Dovish
5,18, 외부효과/NNG,23,0.4033408909831252,Dovish
11,38, 기술적/VAX;침체/NNG,49,0.42032366534030946,Dovish
7,18, 강하/VA;강세/NNG,25,0.5646772473763753,Dovish
15,32, 꿀/NNG,47,0.6806377535340238,Dovish
5,12, 수익/NNG;강화/NNG,17,0.6050113364746877,Dovish
3,14, 영업이익/NNG;악화/NNG,17,0.3111486873298395,Dovish
2,16, 복합기업/NNG,18,0.18150340094240633,Dovish
3,14, 경제/NNG;지표/NNG;개선/NNG;금리/NNG;인상/NNG,17,0.3111486873298395,Dovish
7,19,안타깝/VA,26,0.5349573922513029,Dovish
21,41, 내부통제/NNG;강화/NNG,62,0.7437212526420554,Dovish
8,23, 높/VA;이자/NNG;부담/NNG,31,0.5050529417527828,Dovish
13,25, 예상/NNG;밑돌/VV;금리/NNG;인상/NNG,38,0.7550541479204105,Dovish
4,14, 숨겼/VV,18,0.41486491643978596,Dovish
2,16, 감소량/NNG,18,0.18150340094240633,Dovish
10,20, 수출/NNG;침체/NNG,30,0.7260136037696254,Dovish
7,25, 기부채납/NNG,32,0.40656761811099024,Dovish
4,12, 출장비/NNG,16,0.4840090691797502,Dovish
10,24, 돼온/VV,34,0.6050113364746877,Dovish
9,24, 내린데다/VV,33,0.5445102028272191,Dovish
6,14, 된서리/NNG,20,0.622297374659679,Dovish
7,26,교역국/NNG,33,0.3909304020297983,Dovish
10,32,조처/NNG,42,0.4537585023560159,Dovish
5,17, 예상/NNG;감소/NNG;증가/NNG,22,0.42706682574683846,Dovish
5,12, 역외/NNG;금리/NNG;인상/NNG,17,0.6050113364746877,Dovish
4,13, 예대마진/NNG;늘/VV,17,0.44677760231976943,Dovish
7,15, 삼박자/NNG,22,0.6776126968516504,Dovish
21,43, 나쁘/VA;우려/NNG,64,0.7091295664726573,Dovish
6,19, 신혼집/NNG,25,0.458534907643974,Dovish
7,16, 수출기업/NNG;부정적/VAX,23,0.6352619032984222,Dovish
2,16, 고용/NNG;경기/NNG;둔화/NNG,18,0.18150340094240633,Dovish
8,16, 경기/NNG;침체/NNG;가능성/NNG;우려/NNG,24,0.7260136037696253,Dovish
6,17, 경착륙/NNG;막/VV,23,0.5124801908962061,Dovish
4,15, fed/NNG;금리/NNG;인상/NNG;막/VV,19,0.3872072553438002,Dovish
7,21, 공무원연금공단/NNG,28,0.4840090691797503,Dovish
4,12, 영등/NNG,16,0.4840090691797502,Dovish
12,24, 매긴다/VV,36,0.7260136037696254,Dovish
3,14, 주택담보대출/NNG;부담/NNG,17,0.3111486873298395,Dovish
5,11, 신규/NNG;주택/NNG;판매/NNG;최저/NNG,16,0.6600123670632958,Dovish
4,14, 오븐/NNG,18,0.41486491643978596,Dovish
23,49, 월세/NNG;부담/NNG,72,0.681563791293934,Dovish
13,29, 행정관/NNG,42,0.6509087482072504,Dovish
12,24, 해상도/NNG,36,0.7260136037696254,Dovish
11,25, 외관/NNG,36,0.6388919713172704,Dovish
10,46, 썸/NNG,56,0.3156580885954893,Dovish
5,16, 퍼니/MAG,21,0.4537585023560159,Dovish
4,13, 비회원/NNG,17,0.44677760231976943,Dovish
3,14, 성장/NNG;속도/NNG;떨어/VV,17,0.3111486873298395,Dovish
8,21, 건질/VV,29,0.5531532219197145,Dovish
17,69, 의료원/NNG,86,0.35774583374155455,Dovish
8,21, 성형외과/NNG,29,0.5531532219197145,Dovish
5,15,신선/NNG,20,0.48400906917975023,Dovish
4,12, cac40/NNG;지수/NNG;상승/NNG,16,0.4840090691797502,Dovish
19,45, 욱/NNG,64,0.6130781542943504,Dovish
9,24, 주택/NNG;경기/NNG;부양/NNG,33,0.5445102028272191,Dovish
10,30, 원유/NNG;재고/NNG;예상밖/NNG;증가/NNG,40,0.48400906917975023,Dovish
6,15, 이릅니다/VV,21,0.5808108830157004,Dovish
13,25, 봅니다/VV,38,0.7550541479204105,Dovish
7,16, 빠트릴/VV,23,0.6352619032984222,Dovish
6,15, 국채시장/NNG;금리/NNG;인상/NNG,21,0.5808108830157004,Dovish
8,16, 예대마진/NNG;크/VV,24,0.7260136037696253,Dovish
5,34, 금리/NNG;인상/NNG;견인/NNG,39,0.21353341287341923,Dovish
8,22, 근원/NNG;pce/NNG;물가/NNG;오르/VV,30,0.5280098936506367,Dovish
11,23, 지수/NNG;기준점/NNG;넘/VV;경기/NNG;확장/NNG,34,0.6944477949100765,Dovish
11,35,회계기준/NNG,46,0.4563514080837645,Dovish
20,65, 측은/NNG,85,0.44677760231976954,Dovish
4,13, 수출드라이브/NNG,17,0.44677760231976943,Dovish
30,72, 키위/NNG,102,0.6050113364746877,Dovish
4,14, 출혈성/NNG,18,0.41486491643978596,Dovish
6,14, 고용/NNG;fed/NNG;금리/NNG;인상/NNG,20,0.622297374659679,Dovish
4,22, 기업/NNG;이익/NNG;하향/NNG,26,0.26400494682531833,Dovish
9,22,신계약/NNG,31,0.5940111303569663,Dovish
6,21, 벌이/NNG,27,0.41486491643978596,Dovish
13,27, 국제/NNG;금융시장/NNG;불안정/NNG,40,0.6991242110374171,Dovish
6,20, 통화/NNG;팽창/NNG;압력/NNG,26,0.43560816226177523,Dovish
6,19, 콜elw/NNG,25,0.458534907643974,Dovish
5,14, 가격/NNG;주가/NNG;상승/NNG,19,0.5185811455497324,Dovish
12,27, 이자수익/NNG;오르/VV,39,0.6453454255730003,Dovish
16,32, 신용등급/NNG;최대/NNG,48,0.7260136037696253,Dovish
5,18, 물가/NNG;시장/NNG;예상/NNG;웃돌/VV,23,0.4033408909831252,Dovish
17,48, 채권시장/NNG;국고채/NNG;금리/NNG;상승/NNG,65,0.5142596360034847,Dovish
3,16,콕스/NNG,19,0.27225510141360953,Dovish
7,19, 은행/NNG;경제/NNG;성장/NNG,26,0.5349573922513029,Dovish
6,13,진/NNG,19,0.6701664034796543,Dovish
19,62,개인정보/NNG,81,0.44497607972977044,Dovish
42,105,지배구조/NNG,147,0.5808108830157003,Dovish
9,30, 지표/NNG;금리/NNG;인하/NNG,39,0.43560816226177523,Dovish
6,12, 껍데기/NNG,18,0.7260136037696254,Dovish
4,15, 은행/NNG;매파/NNG,19,0.3872072553438002,Dovish
7,19, 플러스알파/NNG,26,0.5349573922513029,Dovish
12,31,특수은행/NNG,43,0.5620750480797101,Dovish
16,38,공모펀드/NNG,54,0.6113798768586319,Dovish
2,22,선진국지수/NNG,24,0.13200247341265917,Dovish
147,373, 롱심리/NNG,520,0.5722466474752543,Dovish
3,14, 우려/NNG;증대/NNG,17,0.3111486873298395,Dovish
12,41, 바닥날/VV,53,0.42498357293831734,Dovish
19,51,만기상환/NNG,70,0.540951312612662,Dovish
15,38, 서부텍사스산원유/NNG;떨어/VV,53,0.5731686345549674,Dovish
10,23, 장판/NNG,33,0.6313161771909785,Dovish
5,13, 자금/NNG;조달/NNG;비용/NNG;부담/NNG,18,0.5584720028997119,Dovish
4,12, 수지/NNG;부담/NNG,16,0.4840090691797502,Dovish
13,28, 고정/NNG;금리/NNG;대출비중/NNG;확대/NNG,41,0.6741554892146522,Dovish
4,14,지구온난화/NNG,18,0.41486491643978596,Dovish
8,21,개봉/NNG,29,0.5531532219197145,Dovish
20,42, 낮/VA;인플레이션/NNG;우려/NNG,62,0.6914415273996433,Dovish
0,16, 임인/NNG,16,0.0,Dovish
6,13, 물가/NNG;상승/NNG;경제/NNG;성장/NNG,19,0.6701664034796543,Dovish
15,103,원월물/NNG,118,0.21146027294260933,Dovish
5,12, 서부텍사스산원유/NNG;가격/NNG;떨어/VV,17,0.6050113364746877,Dovish
25,66, 예상/NNG;증가/NNG;밑돌/VV,91,0.5500103058860799,Dovish
7,16, 휴양림/NNG,23,0.6352619032984222,Dovish
6,18, 소나무/NNG,24,0.4840090691797503,Dovish
14,34, 서식/NNG,48,0.5978935560455738,Dovish
17,48,하이브리드채/NNG,65,0.5142596360034847,Dovish
5,11, 공급/NNG;어렵/VA,16,0.6600123670632958,Dovish
7,24,수상자/NNG,31,0.42350793553228144,Dovish
7,17, 지표/NNG;물가/NNG;압력/NNG,24,0.5978935560455738,Dovish
13,40,정제유/NNG,53,0.4719088424502565,Dovish
6,12,무역기금/NNG,18,0.7260136037696254,Dovish
4,12, 스탭/NNG,16,0.4840090691797502,Dovish
4,30, 상대방/NNG;위험/NNG,34,0.1936036276719001,Dovish
2,14, 불법성/NNG,16,0.20743245821989298,Dovish
5,11, 이자비용/NNG;급증/NNG,16,0.6600123670632958,Dovish
6,23,후폭풍/NNG,29,0.3787897063145872,Dovish
15,61,유신/NNG,76,0.3570558707063731,Dovish
9,25, 주택저당/NNG,34,0.5227297947141304,Dovish
118,245, 패니메이/NNG,363,0.6993437162842107,Dovish
4,16, 가격/NNG;오르/VV;그치/VV,20,0.36300680188481266,Dovish
4,20, 외평기금/NNG;적자/NNG,24,0.29040544150785014,Dovish
7,22, 중소기업/NNG;금리/NNG;부담/NNG,29,0.4620086569443071,Dovish
11,37, 국채/NNG;가격/NNG;소폭/MAG;하락/NNG,48,0.431683764403561,Dovish
8,16, 기대/NNG;지수/NNG;높/VA,24,0.7260136037696253,Dovish
5,11, 기대/NNG;이어지/VV;상승/NNG,16,0.6600123670632958,Dovish
8,20, 원화/NNG;하락/NNG;압력/NNG,28,0.5808108830157003,Dovish
15,36,예기/NNG,51,0.6050113364746877,Dovish
11,34, 작별/NNG,45,0.46977350832152226,Dovish
7,19,신청서/NNG,26,0.5349573922513029,Dovish
8,19, 아낌없이/MAG,27,0.6113798768586319,Dovish
7,29,신규물/NNG,36,0.3504893259577502,Dovish
37,72, crs/NNG;상승/NNG,109,0.7461806483187817,Dovish
17,36, 가격/NNG;밀리/VV,53,0.6856795146713129,Dovish
16,59, cd/NNG;금리/NNG;내리/VV,75,0.3937700901801358,Dovish
6,18, 칭한/VV,24,0.4840090691797503,Dovish
4,16, 라만/NNG,20,0.36300680188481266,Dovish
7,16, 음식/NNG;가격/NNG;오르/VV,23,0.6352619032984222,Dovish
9,21,최종결제/NNG,30,0.6222973746596789,Dovish
11,26, 경제/NNG;지표/NNG;약세/NNG,37,0.614319203189683,Dovish
11,45,쿠데타/NNG,56,0.3549399840651502,Dovish
5,12, 벌어질까/VV,17,0.6050113364746877,Dovish
6,16, 경제/NNG;성장률/NNG;급락/NNG,22,0.5445102028272191,Dovish
14,31,군부/NNG,45,0.6557542227596617,Dovish
3,15,금품/NNG,18,0.2904054415078502,Dovish
2,18, 해수면/NNG,20,0.16133635639325009,Dovish
26,82, 저가성/NNG,108,0.4603988706831771,Dovish
3,16, 선각자/NNG,19,0.27225510141360953,Dovish
12,40, 유서/NNG,52,0.43560816226177523,Dovish
5,13,지준마감일/NNG,18,0.5584720028997119,Dovish
50,119,금시장/NNG,169,0.6100954653526264,Dovish
4,12, 세계은행그룹/NNG,16,0.4840090691797502,Dovish
1,17, 원유/NNG;상품/NNG;가격/NNG;하락/NNG,18,0.08541336514936768,Dovish
28,56, 실적/NNG;시장/NNG;예상/NNG;상회/NNG,84,0.7260136037696254,Dovish
11,31, ff/NNG;금리선물/NNG;fed/NNG;금리/NNG;인하/NNG,42,0.5152354607397341,Dovish
4,19, 지표/NNG;넘/VV,23,0.30568993842931597,Dovish
5,11, 사회책임경영/NNG,16,0.6600123670632958,Dovish
4,21, 출자액/NNG,25,0.27657661095985725,Dovish
5,14,경품/NNG,19,0.5185811455497324,Dovish
14,30, 환전소/NNG,44,0.6776126968516504,Dovish
6,17, 불안/NNG;심각/NNG,23,0.5124801908962061,Dovish
18,36,공개시장/NNG,54,0.7260136037696254,Dovish
9,18,불편/NNG,27,0.7260136037696254,Dovish
28,64, 해경/NNG,92,0.6352619032984222,Dovish
11,22,해경/NNG,33,0.7260136037696254,Dovish
13,57, 국제/NNG;유가/NNG;opec/NNG;감산/NNG,70,0.3311640999650923,Dovish
7,17, 소득/NNG;최대/NNG,24,0.5978935560455738,Dovish
15,30,필수/NNG,45,0.7260136037696253,Dovish
37,72,외무/NNG,109,0.7461806483187817,Dovish
6,26, 지표/NNG;예상/NNG;하회/NNG,32,0.33508320173982714,Dovish
7,14, 개인/NNG;소비/NNG;늘/VV,21,0.7260136037696254,Dovish
19,73, 경기/NNG;둔화/NNG;막/VV,92,0.3779248896335037,Dovish
4,25,세간/NNG,29,0.23232435320628012,Dovish
4,13, 노인복지시설/NNG,17,0.44677760231976943,Dovish
10,36, 의료시설/NNG,46,0.4033408909831252,Dovish
5,14, 설비/NNG;투자/NNG;성장/NNG,19,0.5185811455497324,Dovish
4,16, 채권펀드/NNG;금리/NNG;인하/NNG,20,0.36300680188481266,Dovish
3,15, 따라왔/VV,18,0.2904054415078502,Dovish
6,36, 금리/NNG;인하/NNG;최대/NNG,42,0.24200453458987514,Dovish
5,14,유례/NNG,19,0.5185811455497324,Dovish
43,96, 예상/NNG;웃돌/VV;증가/NNG,139,0.6503871867102894,Dovish
4,18, 대내외/NNG;여건/NNG;악화/NNG,22,0.32267271278650017,Dovish
3,13, 성장/NNG;낮/VV,16,0.33508320173982714,Dovish
4,15,중소기업자금/NNG,19,0.3872072553438002,Dovish
6,12, 최소결제비율/NNG,18,0.7260136037696254,Dovish
5,13, 침울/NNG,18,0.5584720028997119,Dovish
4,19, 가격/NNG;보합권/NNG;혼조/NNG,23,0.30568993842931597,Dovish
8,22, 天津/NNG,30,0.5280098936506367,Dovish
12,30,경기방어주/NNG,42,0.5808108830157004,Dovish
5,17, 이미/MAG;침체/NNG;빠지/VV,22,0.42706682574683846,Dovish
1,21, 곧/NNG,22,0.06914415273996431,Dovish
4,13, 경제/NNG;지표/NNG;예상/NNG;양호/NNG,17,0.44677760231976943,Dovish
10,21, 우려/NNG;경기/NNG;침체/NNG,31,0.6914415273996433,Dovish
2,18, 주판알/NNG,20,0.16133635639325009,Dovish
4,14, 튕기/VV,18,0.41486491643978596,Dovish
0,17, 유가/NNG;하락/NNG;막/VV,17,0.0,Dovish
6,13, 가격/NNG;조정/NNG;압력/NNG,19,0.6701664034796543,Dovish
16,37, 집값/NNG;바닥/NNG,53,0.6279036573142706,Dovish
14,39, 대여금고/NNG,53,0.5212405360397311,Dovish
10,30, 비농업/NNG;일자리/NNG;늘/VV,40,0.48400906917975023,Dovish
19,44, 뒤처져/VV,63,0.6270117487101311,Dovish
9,29, 성과지표/NNG,38,0.45062913337425026,Dovish
9,23, opec/NNG;원유/NNG;감산/NNG,32,0.5681845594718807,Dovish
86,345,리보/NNG,431,0.36195460825616105,Dovish
7,25, 헤이/NNG,32,0.40656761811099024,Dovish
5,13,도박/NNG,18,0.5584720028997119,Dovish
13,35, 우상향/NNG;곡선/NNG;그리/VV,48,0.5393243913717217,Dovish
6,29, 고용/NNG;긍정적/VAX,35,0.3004194222495002,Dovish
11,27,녹록/NNG,38,0.5915666401085836,Dovish
13,26, 창건/NNG,39,0.7260136037696254,Dovish
9,22, 틱증/NNG,31,0.5940111303569663,Dovish
13,31, 목돈마련저축/NNG,44,0.6089146354196858,Dovish
3,13, 장공/NNG,16,0.33508320173982714,Dovish
14,37,크로네/NNG,51,0.5494157001499868,Dovish
13,25, 안전자산/NNG;채권/NNG;선호/NNG,38,0.7550541479204105,Dovish
13,43, 은행/NNG;대출/NNG;어렵/VA,56,0.43898496972116885,Dovish
55,123,거래자/NNG,178,0.6492804586557626,Dovish
3,17,싱글/MAG,20,0.25624009544810306,Dovish
17,44, 이자이익/NNG;줄/VV,61,0.5610105120038015,Dovish
8,21, 늦/VA;금리/NNG;오르/VV,29,0.5531532219197145,Dovish
58,126, cds/NNG;프리미엄/NNG;상승/NNG,184,0.6683934764863217,Dovish
8,16, 어울림/VV,24,0.7260136037696253,Dovish
23,52,블록/NNG,75,0.6422428033346685,Dovish
5,11, 금리/NNG;인하/NNG;기대/NNG;과도/NNG,16,0.6600123670632958,Dovish
5,11,트레이딩센터/NNG,16,0.6600123670632958,Dovish
5,13,해상/NNG,18,0.5584720028997119,Dovish
5,14,오직/MAG,19,0.5185811455497324,Dovish
3,15, 은행/NNG;유가/NNG;하락/NNG,18,0.2904054415078502,Dovish
20,57, 기초지수/NNG,77,0.5094832307155266,Dovish
5,14, 비르/NNG,19,0.5185811455497324,Dovish
7,35,쉬/MAG,42,0.29040544150785014,Dovish
6,17, 사회책임투자/NNG,23,0.5124801908962061,Dovish
8,20, 아파트론/NNG,28,0.5808108830157003,Dovish
5,16, 북서쪽/NNG,21,0.4537585023560159,Dovish
9,27, 인공위성/NNG,36,0.4840090691797503,Dovish
11,35, 형법/NNG,46,0.4563514080837645,Dovish
6,12, 보증계약/NNG,18,0.7260136037696254,Dovish
5,20,단국/NNG,25,0.3630068018848127,Dovish
7,25, 통인/NNG,32,0.40656761811099024,Dovish
3,37,시가배당률/NNG,40,0.11773193574642574,Dovish
11,32,매장/NNG,43,0.4991343525916174,Dovish
3,13, 언감생심/NNG,16,0.33508320173982714,Dovish
19,46,무이자/NNG,65,0.5997503683314297,Dovish
5,11, 낮/VA;감소/NNG,16,0.6600123670632958,Dovish
11,23, 버디/NNG,34,0.6944477949100765,Dovish
5,12, 신흥시장/NNG;부진/NNG,17,0.6050113364746877,Dovish
8,26, 푼다고/VV,34,0.44677760231976943,Dovish
11,25, 말랐/VV,36,0.6388919713172704,Dovish
6,30, 휘발유/NNG;가격/NNG;급락/NNG,36,0.2904054415078502,Dovish
9,18, 사그라질/VV,27,0.7260136037696254,Dovish
4,17,해외지점/NNG,21,0.3416534605974707,Dovish
8,16,꺾기/NNG,24,0.7260136037696253,Dovish
17,39, 비판/NNG;쏟/VV,56,0.6329349366196735,Dovish
28,67, 매뉴얼/NNG,95,0.6068173404641645,Dovish
28,69,해외진출/NNG,97,0.5892284320449134,Dovish
3,16,프로모션/NNG,19,0.27225510141360953,Dovish
3,16,레이팅/NNG,19,0.27225510141360953,Dovish
3,13, 수출/NNG;투자/NNG;부진/NNG,16,0.33508320173982714,Dovish
16,33,남동/NNG,49,0.7040131915341822,Dovish
12,41,고덕/NNG,53,0.42498357293831734,Dovish
2,31,부영/NNG,33,0.09367917467995167,Dovish
7,22, 시중/NNG;돈/NNG;많이/MAG;풀/VV,29,0.4620086569443071,Dovish
5,16, 이자/NNG;상환/NNG;부담/NNG;줄/VV,21,0.4537585023560159,Dovish
7,22, 국채선물/NNG;고점/NNG,29,0.4620086569443071,Dovish
9,20, 회사채/NNG;스프레드/NNG;확대/NNG,29,0.6534122433926629,Dovish
4,13, 행세/NNG,17,0.44677760231976943,Dovish
8,30, 부실/NNG;대출/NNG;증가/NNG,38,0.3872072553438002,Dovish
3,13, 설계도/NNG,16,0.33508320173982714,Dovish
6,13, 대양/NNG,19,0.6701664034796543,Dovish
1,15, 순이익/NNG;전망/NNG;웃돌/VV,16,0.09680181383595005,Dovish
5,13, 하향/NNG;여파/NNG;하락/NNG,18,0.5584720028997119,Dovish
5,15, 실적/NNG;전망/NNG;실망/NNG;하락/NNG,20,0.48400906917975023,Dovish
18,48,공동대표/NNG,66,0.5445102028272191,Dovish
8,20,디스인플레이션/NNG,28,0.5808108830157003,Dovish
5,15, 나온다면서/VV,20,0.48400906917975023,Dovish
27,70, l자형/NNG,97,0.560067637193711,Dovish
1,15, 캐디/NNG,16,0.09680181383595005,Dovish
10,22,로이즈/NNG,32,0.6600123670632958,Dovish
5,14, 책동/NNG,19,0.5185811455497324,Dovish
8,16, 가격/NNG;금리/NNG;인하/NNG,24,0.7260136037696253,Dovish
6,16, 幸/NNG,22,0.5445102028272191,Dovish
5,11, 기업/NNG;부담/NNG;완화/NNG,16,0.6600123670632958,Dovish
7,19, 신용/NNG;대출/NNG;최저/NNG,26,0.5349573922513029,Dovish
54,179, 국기/NNG,233,0.4380417274140757,Dovish
4,14,주택건설협회/NNG,18,0.41486491643978596,Dovish
5,11, 은행/NNG;자산/NNG;건전성/NNG;악화/NNG,16,0.6600123670632958,Dovish
7,26, gdp/NNG;성장률/NNG;최저/NNG,33,0.3909304020297983,Dovish
9,20, 의정부/NNG,29,0.6534122433926629,Dovish
5,13, 핵우산/NNG,18,0.5584720028997119,Dovish
9,22, 캘퍼스/NNG,31,0.5940111303569663,Dovish
5,15,신용위험평가/NNG,20,0.48400906917975023,Dovish
4,12, 피도/NNG,16,0.4840090691797502,Dovish
7,20, 연금소득세/NNG,27,0.5082095226387378,Dovish
9,41, 금리/NNG;내리/VV;인하/NNG,50,0.318737679703738,Dovish
3,22, 야마모토/NNG,25,0.19800371011898876,Dovish
9,31, 예상/NNG;밑돌/VV;하락/NNG,40,0.42155628605978257,Dovish
4,13, 이자/NNG;마진/NNG;줄/VV,17,0.44677760231976943,Dovish
12,31, 신규등록/NNG,43,0.5620750480797101,Dovish
12,25, 결속/NNG,37,0.6969730596188405,Dovish
4,19, 실적/NNG;선방/NNG,23,0.30568993842931597,Dovish
6,20, 매출/NNG;실망/NNG,26,0.43560816226177523,Dovish
14,40, 후면/NNG,54,0.5082095226387378,Dovish
3,19, 경제/NNG;지표/NNG;예상/NNG;웃돌/VV,22,0.229267453821987,Dovish
11,35, 라라/NNG,46,0.4563514080837645,Dovish
7,14,임시직/NNG,21,0.7260136037696254,Dovish
11,39, 성역/NNG,50,0.4095461354597887,Dovish
10,28, 국고보조금/NNG,38,0.5185811455497324,Dovish
29,62, 치러질/VV,91,0.6791740164296496,Dovish
3,21, 분립/NNG,24,0.20743245821989298,Dovish
15,46, 시중/NNG;유동성/NNG;늘/VV,61,0.4734871328932339,Dovish
49,115, 유동성/NNG;풀/VV,164,0.6186898536471591,Dovish
7,24, 민생/NNG;경제/NNG;회복/NNG,31,0.42350793553228144,Dovish
7,14, 안정/NNG;넘/VV,21,0.7260136037696254,Dovish
24,53, 신흥국/NNG;경제/NNG;성장/NNG,77,0.6575217543573967,Dovish
3,18,국빈/NNG,21,0.24200453458987514,Dovish
18,89, 어르신/NNG,107,0.2936684239967024,Dovish
2,18, 대부금/NNG,20,0.16133635639325009,Dovish
5,14, 재정상황/NNG;개선/NNG,19,0.5185811455497324,Dovish
6,12, 춘천/NNG,18,0.7260136037696254,Dovish
14,36,베어링/NNG,50,0.5646772473763753,Dovish
26,61,건수/NNG,87,0.6188968425577135,Dovish
8,18, 불안/NNG;심하/VA,26,0.6453454255730003,Dovish
26,77, 꼼수/NNG,103,0.49029490124701974,Dovish
5,12, 전망/NNG;안정/NNG;긍정적/VAX;오르/VV,17,0.6050113364746877,Dovish
1,19, 링거/NNG,20,0.07642248460732899,Dovish
11,29, 신용/NNG;대출/NNG;금리/NNG;인하/NNG,40,0.5507689407907503,Dovish
3,14, 주택구입/NNG;수요/NNG;늘/VV,17,0.3111486873298395,Dovish
7,21,장악/NNG,28,0.4840090691797503,Dovish
4,15, 출주/NNG,19,0.3872072553438002,Dovish
8,19, 리식/NNG,27,0.6113798768586319,Dovish
8,18, 광경/NNG,26,0.6453454255730003,Dovish
4,12, 금리/NNG;내리/VV;금리/NNG;오르/VV,16,0.4840090691797502,Dovish
16,31,정식/NNG,47,0.7494333974396133,Dovish
15,39, 가격/NNG;변동/NNG;심하/VA,54,0.5584720028997118,Dovish
6,12,소액결제/NNG,18,0.7260136037696254,Dovish
9,18, 성난/VV,27,0.7260136037696254,Dovish
5,12, 약간/MAG;매파/NNG,17,0.6050113364746877,Dovish
11,24, 수요자/NNG;많/VA,35,0.6655124701221565,Dovish
5,11, 생활/NNG;부담/NNG,16,0.6600123670632958,Dovish
4,16, 계획관리지역/NNG,20,0.36300680188481266,Dovish
2,19, 관광버스/NNG,21,0.15284496921465798,Dovish
5,14, 동구/NNG,19,0.5185811455497324,Dovish
5,18, 시승/NNG,23,0.4033408909831252,Dovish
7,16,지냈/VV,23,0.6352619032984222,Dovish
9,18, 원달러/NNG;상승/NNG;제한/NNG,27,0.7260136037696254,Dovish
3,13, 이자/NNG;상환/NNG;부담/NNG;증가/NNG,16,0.33508320173982714,Dovish
15,33, 기업/NNG;투자/NNG;줄/VV,48,0.6600123670632958,Dovish
4,17, 돈줄/NNG;차단/NNG,21,0.3416534605974707,Dovish
6,14, 주택담보대출/NNG;넘/VV,20,0.622297374659679,Dovish
10,20, 안절부절/MAG,30,0.7260136037696254,Dovish
6,16, 변동성/NNG;막/VV,22,0.5445102028272191,Dovish
6,13, 쫓아갔/VV,19,0.6701664034796543,Dovish
5,11, 탁상공론/NNG,16,0.6600123670632958,Dovish
6,19, 근무지/NNG,25,0.458534907643974,Dovish
4,12, 일궜/VV,16,0.4840090691797502,Dovish
1,15, 부딪친/VV,16,0.09680181383595005,Dovish
5,18, 경제/NNG;성장/NNG;정체/NNG,23,0.4033408909831252,Dovish
7,17, 놔둘/VV,24,0.5978935560455738,Dovish
40,90, 網/NNG,130,0.6453454255730003,Dovish
7,14, 막내/NNG,21,0.7260136037696254,Dovish
12,34, 소비자/NNG;태도/NNG;지수/NNG;하락/NNG,46,0.5124801908962061,Dovish
4,13, 탈진/NNG,17,0.44677760231976943,Dovish
4,19, 쓰인다고/VV,23,0.30568993842931597,Dovish
6,26, 렙/NNG,32,0.33508320173982714,Dovish
2,14, 최대/NNG;상향/NNG,16,0.20743245821989298,Dovish
8,26, 선후배/NNG,34,0.44677760231976943,Dovish
3,15, 소외감/NNG,18,0.2904054415078502,Dovish
34,81, 셋집/NNG,115,0.6094929019300559,Dovish
6,13, 쳐야/VV,19,0.6701664034796543,Dovish
5,17, 백방/NNG,22,0.42706682574683846,Dovish
4,15, 수소문/NNG,19,0.3872072553438002,Dovish
2,15,전셋집/NNG,17,0.1936036276719001,Dovish
7,16, 복리이자/NNG,23,0.6352619032984222,Dovish
5,12, 조르/VV,17,0.6050113364746877,Dovish
13,40,실은/MAG,53,0.4719088424502565,Dovish
5,15, 당리당략/NNG,20,0.48400906917975023,Dovish
2,18,귀빈/NNG,20,0.16133635639325009,Dovish
6,19, 감정가격/NNG,25,0.458534907643974,Dovish
12,28, 맨션/NNG,40,0.622297374659679,Dovish
5,16, 토막/NNG,21,0.4537585023560159,Dovish
4,35,의뢰/NNG,39,0.16594596657591437,Dovish
8,26, 위험자산/NNG;가격/NNG;오르/VV,34,0.44677760231976943,Dovish
5,23,회관/NNG,28,0.3156580885954893,Dovish
5,11,누빈/VV,16,0.6600123670632958,Dovish
7,20, 금리/NNG;결정/NNG;내리/VV,27,0.5082095226387378,Dovish
7,14,콜자금/NNG,21,0.7260136037696254,Dovish
10,24, 장외파생상품시장/NNG,34,0.6050113364746877,Dovish
15,35,무분별/NNG,50,0.6222973746596789,Dovish
7,24, 낙관론/NNG;크/VV,31,0.42350793553228144,Dovish
191,563,재현/NNG,754,0.49260603310834267,Dovish
5,22, 닮은꼴/NNG,27,0.3300061835316479,Dovish
4,19, 가격/NNG;상승/NNG;늘/VV,23,0.30568993842931597,Dovish
194,668,엔저/NNG,862,0.4216965243452316,Dovish
17,40,면적/NNG,57,0.6171115632041816,Dovish
11,22, 번가/NNG,33,0.7260136037696254,Dovish
31,64, 금융사별/NNG,95,0.7033256786518246,Dovish
30,62,우/NNG,92,0.7025938100996375,Dovish
4,12, 상하단/NNG;막/VV,16,0.4840090691797502,Dovish
7,14, 관할권/NNG,21,0.7260136037696254,Dovish
11,25, 건축주/NNG,36,0.6388919713172704,Dovish
8,17,명의/NNG,25,0.6833069211949414,Dovish
6,13, 채권펀드/NNG;수익률/NNG;양호/NNG,19,0.6701664034796543,Dovish
6,18, 황모/NNG,24,0.4840090691797503,Dovish
5,12, 모집책/NNG,17,0.6050113364746877,Dovish
14,28,사기/NNG,42,0.7260136037696254,Dovish
4,12, 이상자/NNG,16,0.4840090691797502,Dovish
6,17, 파멸/NNG,23,0.5124801908962061,Dovish
11,26, 년/NNG,37,0.614319203189683,Dovish
5,11, 타점/NNG,16,0.6600123670632958,Dovish
33,84, 지준율/NNG;낮/VV,117,0.5704392601047056,Dovish
8,16, 스포츠마케팅/NNG,24,0.7260136037696253,Dovish
8,41,통화승수/NNG,49,0.2833223819588782,Dovish
18,41, 돈/NNG;빌리/VV;어렵/VA,59,0.637475359407476,Dovish
9,26, gdp/NNG;하향/NNG,35,0.5026248026097407,Dovish
15,44, 비소비지출/NNG,59,0.49500927529747185,Dovish
4,13, 잠재/NNG;성장률/NNG;넘/VV,17,0.44677760231976943,Dovish
20,42,온혜/NNG,62,0.6914415273996433,Dovish
5,13, 임대/NNG;수익률/NNG;떨어/VV,18,0.5584720028997119,Dovish
5,12, 레이크/NNG,17,0.6050113364746877,Dovish
40,93,지하층/NNG,133,0.6245278311996777,Dovish
5,11, 둔화/NNG;최대/NNG,16,0.6600123670632958,Dovish
6,28, 유로달러/NNG;급등/NNG,34,0.3111486873298395,Dovish
9,23, 質/NNG,32,0.5681845594718807,Dovish
39,84, 유가족/NNG,123,0.6741554892146522,Dovish
6,24, 수익/NNG;떨어/VV,30,0.3630068018848127,Dovish
7,15, 운전기사/NNG,22,0.6776126968516504,Dovish
5,15,부가가치/NNG,20,0.48400906917975023,Dovish
6,32, 금/NNG;수요/NNG;증가/NNG,38,0.27225510141360953,Dovish
5,15, 사내유보/NNG,20,0.48400906917975023,Dovish
8,31,동국/NNG,39,0.3747166987198067,Dovish
20,51, 달러원/NNG;연저점/NNG,71,0.5694224343291179,Dovish
10,21, 매출/NNG;최대/NNG,31,0.6914415273996433,Dovish
4,22, 도산/NNG;우려/NNG,26,0.26400494682531833,Dovish
14,47, 데이트/NNG,61,0.4325187426712662,Dovish
7,19, 현대인/NNG,26,0.5349573922513029,Dovish
6,19, 서서히/MAG;성장/NNG,25,0.458534907643974,Dovish
9,26, fed/NNG;유가/NNG;하락/NNG,35,0.5026248026097407,Dovish
7,18, 국채/NNG;수요/NNG;많/VA,25,0.5646772473763753,Dovish
3,15,금융협회/NNG,18,0.2904054415078502,Dovish
3,15, 순이자마진/NNG;저점/NNG,18,0.2904054415078502,Dovish
3,20,캠페인/NNG,23,0.21780408113088762,Dovish
9,18, 서서히/MAG;금리/NNG;인상/NNG,27,0.7260136037696254,Dovish
30,60, 유저/NNG,90,0.7260136037696253,Dovish
28,83,장기쪽/NNG,111,0.48984050374818094,Dovish
5,41, 자본비율/NNG;오르/VV,46,0.17707648872429887,Dovish
12,29, 전세가격/NNG;고공행진/NNG,41,0.6008388444990004,Dovish
5,16,환시장/NNG,21,0.4537585023560159,Dovish
10,42,정무/NNG,52,0.34572076369982163,Dovish
6,13,높/VV,19,0.6701664034796543,Dovish
2,14, ism/NNG;제조업/NNG;지수/NNG;최저/NNG,16,0.20743245821989298,Dovish
19,67, 제조업/NNG;활동/NNG;위축/NNG,86,0.4117689096006831,Dovish
4,12, 키워라/VV,16,0.4840090691797502,Dovish
14,29, 경기/NNG;침체/NNG;피하/VV,43,0.7009786519155004,Dovish
4,18, 물가/NNG;압력/NNG;우려/NNG,22,0.32267271278650017,Dovish
3,16,보료/NNG,19,0.27225510141360953,Dovish
5,11, 양계/NNG,16,0.6600123670632958,Dovish
2,14, 수출/NNG;여건/NNG;좋/VA,16,0.20743245821989298,Dovish
4,16, 제로/NNG;성장/NNG,20,0.36300680188481266,Dovish
11,31, 도정/NNG,42,0.5152354607397341,Dovish
4,13, 지표/NNG;흔들/VV,17,0.44677760231976943,Dovish
30,109, 등가/NNG,139,0.3996405158364911,Dovish
5,14, 취약/NNG;금리/NNG;인상/NNG,19,0.5185811455497324,Dovish
8,20, 지표/NNG;쏟/VV,28,0.5808108830157003,Dovish
9,18,미달/NNG,27,0.7260136037696254,Dovish
7,26,잔존/NNG,33,0.3909304020297983,Dovish
12,24, 금리/NNG;인하/NNG;늦/VV,36,0.7260136037696254,Dovish
8,24, 통화정책/NNG;경제/NNG;성장/NNG,32,0.4840090691797502,Dovish
8,33, 금리/NNG;인하/NNG;결정/NNG;내리/VV,41,0.3520065957670911,Dovish
7,19, 장강/NNG,26,0.5349573922513029,Dovish
3,15, 휩쓸린/VV,18,0.2904054415078502,Dovish
22,46, 신용평가모델/NNG,68,0.6944477949100765,Dovish
2,17, 고용/NNG;지표/NNG;강세/NNG,19,0.17082673029873535,Dovish
6,12, 은행/NNG;cd/NNG;발행/NNG;늘/VV,18,0.7260136037696254,Dovish
4,13, 실적/NNG;자신/NNG,17,0.44677760231976943,Dovish
13,25,관/NNG,38,0.7550541479204105,Dovish
12,28,모라토리엄/NNG,40,0.622297374659679,Dovish
3,21, 비상임이사/NNG,24,0.20743245821989298,Dovish
25,53, 국무총리실/NNG,78,0.6849184941222882,Dovish
6,12, 은행/NNG;대출/NNG;중단/NNG,18,0.7260136037696254,Dovish
11,26, 案/NNG,37,0.614319203189683,Dovish
9,41, 선체/NNG,50,0.318737679703738,Dovish
14,35, 당파/NNG,49,0.5808108830157003,Dovish
30,66, 차명계좌/NNG,96,0.6600123670632958,Dovish
6,18, 천진/NNG,24,0.4840090691797503,Dovish
4,12, fed/NNG;어렵/VA,16,0.4840090691797502,Dovish
6,13, 토플/NNG,19,0.6701664034796543,Dovish
12,23, 동메달/NNG,35,0.7575794126291744,Dovish
9,22, 청렴도/NNG,31,0.5940111303569663,Dovish
7,27, 희소/NNG,34,0.37645149825091684,Dovish
14,27, 지표/NNG;호조/NNG;상승/NNG,41,0.7529029965018337,Dovish
11,25, 들여왔/VV,36,0.6388919713172704,Dovish
4,13, 가격/NNG;떨어/VV;하락/NNG,17,0.44677760231976943,Dovish
6,21, 수혜지/NNG,27,0.41486491643978596,Dovish
18,44, 불안정/NNG;우려/NNG,62,0.5940111303569663,Dovish
9,19, 분주히/MAG,28,0.687802361465961,Dovish
12,26, 하락/NNG;압력/NNG;우위/NNG,38,0.6701664034796543,Dovish
5,14, 제실/NNG,19,0.5185811455497324,Dovish
8,17, 선순환/NNG;효과/NNG,25,0.6833069211949414,Dovish
5,16, 경제/NNG;완만/NNG;속도/NNG;확장/NNG,21,0.4537585023560159,Dovish
24,59, 중개역/NNG,83,0.5906551352702037,Dovish
9,23,지/VV,32,0.5681845594718807,Dovish
4,12, 가격/NNG;상승/NNG;반납/NNG,16,0.4840090691797502,Dovish
4,12, 높/VA;금리/NNG;내리/VV,16,0.4840090691797502,Dovish
3,20, 대출/NNG;이자/NNG;낮/VV,23,0.21780408113088762,Dovish
14,43, 대내외/NNG;모멘텀/NNG,57,0.4727530443151049,Dovish
2,21, 트레이딩룸/NNG,23,0.13828830547992862,Dovish
19,41,파크/NNG,60,0.6728906571523358,Dovish
4,15, 집기/NNG,19,0.3872072553438002,Dovish
4,13, 안정화/NNG;효과/NNG,17,0.44677760231976943,Dovish
4,12, 문정/NNG,16,0.4840090691797502,Dovish
9,18,시상식/NNG,27,0.7260136037696254,Dovish
7,15, 무역/NNG;성장/NNG,22,0.6776126968516504,Dovish
5,11, 수요/NNG;완화/NNG,16,0.6600123670632958,Dovish
6,16, 기업/NNG;줄도산/NNG,22,0.5445102028272191,Dovish
4,16, 차입/NNG;금리/NNG;낮/VV,20,0.36300680188481266,Dovish
8,17, 기대/NNG;뛰/VV,25,0.6833069211949414,Dovish
7,14, 돌아봤/VV,21,0.7260136037696254,Dovish
12,28,모은/VV,40,0.622297374659679,Dovish
4,14, 튀기/VV,18,0.41486491643978596,Dovish
4,14,지적재산권/NNG,18,0.41486491643978596,Dovish
14,36, 테마펀드/NNG,50,0.5646772473763753,Dovish
2,15, 상장업체/NNG,17,0.1936036276719001,Dovish
5,27, 숙박업소/NNG,32,0.26889392732208345,Dovish
34,117, 생태/NNG,151,0.42195662441311566,Dovish
5,18, 일조량/NNG,23,0.4033408909831252,Dovish
6,17,남도/NNG,23,0.5124801908962061,Dovish
8,26, 심려/NNG,34,0.44677760231976943,Dovish
6,23, 도당/NNG,29,0.3787897063145872,Dovish
10,32, 당직/NNG,42,0.4537585023560159,Dovish
12,38, 숭례문/NNG,50,0.458534907643974,Dovish
13,42, 징용/NNG,55,0.4494369928097681,Dovish
16,33, 헌금/NNG,49,0.7040131915341822,Dovish
7,22, 천주교/NNG,29,0.4620086569443071,Dovish
27,54, 관객/NNG,81,0.7260136037696253,Dovish
3,15, 난입/NNG,18,0.2904054415078502,Dovish
4,21, 공사장/NNG,25,0.27657661095985725,Dovish
6,14,표시/NNG,20,0.622297374659679,Dovish
6,31, 낙선/NNG,37,0.28103752403985505,Dovish
5,37, 결핵/NNG,42,0.19621989291070957,Dovish
18,39,출생/NNG,57,0.6701664034796543,Dovish
7,24, 소설가/NNG,31,0.42350793553228144,Dovish
5,20, 곁눈/NNG,25,0.3630068018848127,Dovish
5,12, 벌였으며/VV,17,0.6050113364746877,Dovish
13,26,발사/NNG,39,0.7260136037696254,Dovish
9,19,숏플레이/NNG,28,0.687802361465961,Dovish
2,15,배당률/NNG,17,0.1936036276719001,Dovish
4,12, 세계/NNG;유동성/NNG;확대/NNG,16,0.4840090691797502,Dovish
7,15, 결산보고서/NNG,22,0.6776126968516504,Dovish
9,33, 실물/NNG;경기/NNG;악화/NNG,42,0.3960074202379775,Dovish
12,39, 층수/NNG,51,0.4467776023197695,Dovish
24,59,순차입/NNG,83,0.5906551352702037,Dovish
4,13, 원화/NNG;절상/NNG;압력/NNG;크/VV,17,0.44677760231976943,Dovish
21,45,지식/NNG,66,0.6776126968516504,Dovish
6,14, 경기/NNG;흔들/VV,20,0.622297374659679,Dovish
4,13, 부채/NNG;상환능력/NNG;심사/NNG;강화/NNG,17,0.44677760231976943,Dovish
7,16, 수입/NNG;확보/NNG,23,0.6352619032984222,Dovish
14,49, 스파크/NNG,63,0.4148649164397859,Dovish
21,73,자통법/NNG,94,0.41770645696334613,Dovish
7,34, 등산/NNG,41,0.2989467780227869,Dovish
9,34, 노예/NNG,43,0.3843601431721546,Dovish
4,15,추종/NNG,19,0.3872072553438002,Dovish
4,14, 상회/NNG;오르/VV,18,0.41486491643978596,Dovish
12,36, 현지인/NNG,48,0.4840090691797503,Dovish
7,27,성장전략/NNG,34,0.37645149825091684,Dovish
6,16, 총액/NNG;대출/NNG;한도/NNG;축소/NNG,22,0.5445102028272191,Dovish
5,15, 자금/NNG;조달/NNG;금리/NNG;높/VA,20,0.48400906917975023,Dovish
7,14,하오/NNG,21,0.7260136037696254,Dovish
8,19,민간경제조사/NNG,27,0.6113798768586319,Dovish
9,22, 적설량/NNG,31,0.5940111303569663,Dovish
5,13, 북단/NNG,18,0.5584720028997119,Dovish
24,50,성탄절/NNG,74,0.6969730596188405,Dovish
85,166, 제조업/NNG;지표/NNG;부진/NNG,251,0.7435079074749176,Dovish
5,16, 스미싱/NNG,21,0.4537585023560159,Dovish
15,72, 잉여세/NNG,87,0.30250566823734387,Dovish
8,23, 임신부/NNG,31,0.5050529417527828,Dovish
10,21, 소득5분위/NNG,31,0.6914415273996433,Dovish
35,72, 종합지원센터/NNG,107,0.7058465592204692,Dovish
12,31, 주택/NNG;판매/NNG;지표/NNG;호조/NNG,43,0.5620750480797101,Dovish
6,12, 우려/NNG;원화/NNG;강세/NNG,18,0.7260136037696254,Dovish
6,16,넉넉/NNG,22,0.5445102028272191,Dovish
4,13, 못난이/NNG,17,0.44677760231976943,Dovish
27,59, 유가/NNG;원유/NNG;재고/NNG;감소/NNG,86,0.6644870271789792,Dovish
6,17, 경제/NNG;지표/NNG;금리/NNG;인하/NNG,23,0.5124801908962061,Dovish
6,14, 손수/MAG,20,0.622297374659679,Dovish
7,18, 주택시장/NNG;부정적/VAX,25,0.5646772473763753,Dovish
11,27, 창의력/NNG,38,0.5915666401085836,Dovish
6,37,정책조합/NNG,43,0.23546387149285147,Dovish
5,12, 물가/NNG;목표/NNG;하회/NNG,17,0.6050113364746877,Dovish
42,99, crs/NNG;하락/NNG,141,0.6160115425924094,Dovish
1,19, 모기지뱅크/NNG,20,0.07642248460732899,Dovish
9,24, fed/NNG;금리/NNG;인하/NNG;중단/NNG,33,0.5445102028272191,Dovish
23,45,기축통화/NNG,68,0.7421472394089503,Dovish
7,20, 부실/NNG;가능성/NNG;크/VV,27,0.5082095226387378,Dovish
10,21, fed/NNG;경기/NNG;하락/NNG;위험/NNG,31,0.6914415273996433,Dovish
12,23, 국제/NNG;유가/NNG;내림/NNG,35,0.7575794126291744,Dovish
5,18, 가계/NNG;부채/NNG;많이/MAG;늘/VV,23,0.4033408909831252,Dovish
19,40, 지수/NNG;경제/NNG;지표/NNG;호조/NNG,59,0.6897129235811441,Dovish
3,15, 부실/NNG;금융/NNG;부실/NNG,18,0.2904054415078502,Dovish
16,37, 국채/NNG;금리/NNG;소폭/MAG;하락/NNG,53,0.6279036573142706,Dovish
6,12, 증명원/NNG,18,0.7260136037696254,Dovish
3,13, 비밀주의/NNG,16,0.33508320173982714,Dovish
16,33, 경기/NNG;확장/NNG;밑돌/VV;경기/NNG;위축/NNG,49,0.7040131915341822,Dovish
29,76, 레인/NNG,105,0.5540630134031351,Dovish
27,67, 미/NNG;고용/NNG;지표/NNG;호조/NNG,94,0.5851452925904443,Dovish
39,86,기간물/NNG,125,0.6584774545817532,Dovish
7,14,은퇴설계/NNG,21,0.7260136037696254,Dovish
6,14, 경기/NNG;개선/NNG;기대/NNG;크/VV,20,0.622297374659679,Dovish
12,23, 투자/NNG;약하/VA,35,0.7575794126291744,Dovish
9,20, 귤/NNG,29,0.6534122433926629,Dovish
6,15, 담보인정비율/NNG;완화/NNG,21,0.5808108830157004,Dovish
11,34, 원금손실/NNG;우려/NNG,45,0.46977350832152226,Dovish
6,16, 大馬/NNG,22,0.5445102028272191,Dovish
8,19, 노동시장/NNG;견조/NNG,27,0.6113798768586319,Dovish
7,16, 달러원/NNG;경제/NNG;지표/NNG;호조/NNG,23,0.6352619032984222,Dovish
4,17, 고용/NNG;경제/NNG;지표/NNG;호조/NNG,21,0.3416534605974707,Dovish
10,24, 가계/NNG;소득/NNG;줄/VV,34,0.6050113364746877,Dovish
8,16, 천연/NNG,24,0.7260136037696253,Dovish
8,41, 위원단/NNG,49,0.2833223819588782,Dovish
10,21, 군비/NNG,31,0.6914415273996433,Dovish
11,29, 통화정책위원회회의/NNG,40,0.5507689407907503,Dovish
4,12, 앉혔/VV,16,0.4840090691797502,Dovish
6,14, 실업/NNG;늘/VV,20,0.622297374659679,Dovish
5,11,근로장려금/NNG,16,0.6600123670632958,Dovish
4,16, 구내식당/NNG,20,0.36300680188481266,Dovish
7,18,어업/NNG,25,0.5646772473763753,Dovish
7,15,전문기업/NNG,22,0.6776126968516504,Dovish
72,168,적수/NNG,240,0.6222973746596789,Dovish
4,14, 코르/NNG,18,0.41486491643978596,Dovish
7,18, 전용자금/NNG,25,0.5646772473763753,Dovish
6,23, 대출/NNG;원리금/NNG;상환/NNG;부담/NNG,29,0.3787897063145872,Dovish
8,16, 차입/NNG;금리/NNG;오르/VV,24,0.7260136037696253,Dovish
7,19,창의/NNG,26,0.5349573922513029,Dovish
4,14, 욕먹/VV,18,0.41486491643978596,Dovish
9,18, 주택/NNG;경기/NNG;지표/NNG;호조/NNG,27,0.7260136037696254,Dovish
5,12, 신림/NNG,17,0.6050113364746877,Dovish
1,15,학장/NNG,16,0.09680181383595005,Dovish
5,16, 부액/NNG,21,0.4537585023560159,Dovish
9,19, 순직/NNG,28,0.687802361465961,Dovish
6,14, 절도/NNG,20,0.622297374659679,Dovish
5,11, 물가/NNG;상승률/NNG;유가/NNG;하락/NNG,16,0.6600123670632958,Dovish
14,46, 뉴딜정책/NNG,60,0.441921324033685,Dovish
6,12,담긴/VV,18,0.7260136037696254,Dovish
10,21,속한/VV,31,0.6914415273996433,Dovish
5,16,미국식/NNG,21,0.4537585023560159,Dovish
61,132,낙찰률/NNG,193,0.6710125731810175,Dovish
9,19, 없인/MAG,28,0.687802361465961,Dovish
11,25, 착석/NNG,36,0.6388919713172704,Dovish
18,37, 설비/NNG;투자/NNG;줄/VV,55,0.7063916144785545,Dovish
8,17, 集團/NNG,25,0.6833069211949414,Dovish
27,97, 엔원/NNG;재정환율/NNG;하락/NNG,124,0.40417252168618323,Dovish
13,26,온/VV,39,0.7260136037696254,Dovish
2,16, 전망/NNG;긍정적/VAX;않/VX,18,0.18150340094240633,Dovish
7,17, 금리/NNG;오르/VV;전망/NNG;높/VA,24,0.5978935560455738,Dovish
6,21, 유가/NNG;하락/NNG;경제/NNG;긍정적/VAX,27,0.41486491643978596,Dovish
8,24, 수출세/NNG,32,0.4840090691797502,Dovish
5,13, 연쇄/NNG;금리/NNG;인하/NNG,18,0.5584720028997119,Dovish
31,65, 경제/NNG;지표/NNG;호조/NNG;상승/NNG,96,0.6925052835956428,Dovish
9,25, 투자심리/NNG;오르/VV,34,0.5227297947141304,Dovish
7,23,총사업비/NNG,30,0.441921324033685,Dovish
11,22, 회추위/NNG,33,0.7260136037696254,Dovish
6,12, 불확실성/NNG;강하/VA,18,0.7260136037696254,Dovish
8,23, 무역/NNG;증가/NNG,31,0.5050529417527828,Dovish
1,18, 물러난다는/VV,19,0.08066817819662504,Dovish
5,14,마일리지/NNG,19,0.5185811455497324,Dovish
13,27,연회비/NNG,40,0.6991242110374171,Dovish
9,19,중소협력사/NNG,28,0.687802361465961,Dovish
6,14, 금리/NNG;인하/NNG;작/VA,20,0.622297374659679,Dovish
5,17, 보미/NNG,22,0.42706682574683846,Dovish
8,18, 레포/NNG;금리/NNG;오르/VV,26,0.6453454255730003,Dovish
4,17, 낮/VA;금리/NNG;최대/NNG,21,0.3416534605974707,Dovish
10,34,임차/NNG,44,0.42706682574683846,Dovish
14,28,주봉/NNG,42,0.7260136037696254,Dovish
5,18, 경제/NNG;전망/NNG;나쁘/VA,23,0.4033408909831252,Dovish
5,12,비축/NNG,17,0.6050113364746877,Dovish
6,14,밀집/NNG,20,0.622297374659679,Dovish
10,26, 무역/NNG;부진/NNG,36,0.5584720028997119,Dovish
5,26, 은행/NNG;실적/NNG;호조/NNG,31,0.27923600144985594,Dovish
4,17, 저축성향/NNG,21,0.3416534605974707,Dovish
14,30, 산업재해/NNG,44,0.6776126968516504,Dovish
5,13, 고용/NNG;지표/NNG;부정적/VAX,18,0.5584720028997119,Dovish
4,13, 정책/NNG;상승/NNG,17,0.44677760231976943,Dovish
15,35,인수금융/NNG,50,0.6222973746596789,Dovish
18,71,엔저현상/NNG,89,0.3681195737423453,Dovish
3,21,교훈/NNG,24,0.20743245821989298,Dovish
4,23,순천/NNG,27,0.2525264708763914,Dovish
8,28,뒷받침/NNG,36,0.41486491643978596,Dovish
3,16, 정맥/NNG,19,0.27225510141360953,Dovish
4,16, 유람선/NNG,20,0.36300680188481266,Dovish
6,12,스리/NNG,18,0.7260136037696254,Dovish
8,48, 소구/NNG,56,0.2420045345898751,Dovish
5,13, 국채/NNG;금리/NNG;내림/NNG,18,0.5584720028997119,Dovish
4,14, 주택할부금융/NNG,18,0.41486491643978596,Dovish
5,14, 경기/NNG;좀처럼/MAG;살/VV,19,0.5185811455497324,Dovish
6,18, 예상/NNG;빨리/MAG;오르/VV,24,0.4840090691797503,Dovish
15,35, 광부/NNG,50,0.6222973746596789,Dovish
2,18,리안/NNG,20,0.16133635639325009,Dovish
5,12, 매출/NNG;순이익/NNG;늘/VV,17,0.6050113364746877,Dovish
10,24, 흥행/NNG;실패/NNG,34,0.6050113364746877,Dovish
12,26, 긴장도/NNG,38,0.6701664034796543,Dovish
5,13, 상향/NNG;영향/NNG;상승/NNG,18,0.5584720028997119,Dovish
8,35, 금리/NNG;인상/NNG;서두/NNG;이유/NNG;없/VA,43,0.33189193315182874,Dovish
4,12, 국채선물/NNG;매수우위/NNG,16,0.4840090691797502,Dovish
13,26, 투자/NNG;대안/NNG;떠오르/VV,39,0.7260136037696254,Dovish
5,19,가맹/NNG,24,0.38211242303664494,Dovish
14,62, cd/NNG;금리/NNG;급락/NNG,76,0.32787711137983083,Dovish
10,50, 리마/NNG,60,0.2904054415078502,Dovish
5,12, 간추린/VV,17,0.6050113364746877,Dovish
4,13, 녹였/VV,17,0.44677760231976943,Dovish
124,237, 위안부/NNG,361,0.7597104376998611,Dovish
15,29, 강간/NNG,44,0.7510485556237504,Dovish
10,31, 귀순/NNG,41,0.46839587339975836,Dovish
11,34, 빙상/NNG,45,0.46977350832152226,Dovish
4,12, 정체/NNG;우려/NNG,16,0.4840090691797502,Dovish
5,15, 흐려져/VA,20,0.48400906917975023,Dovish
5,13, 興/NNG,18,0.5584720028997119,Dovish
9,24, 금리/NNG;경제/NNG;지표/NNG;호조/NNG,33,0.5445102028272191,Dovish
5,12,안/VV,17,0.6050113364746877,Dovish
6,33, 마스크/NNG,39,0.26400494682531833,Dovish
17,34, 탈취/NNG,51,0.7260136037696254,Dovish
6,15,후원/NNG,21,0.5808108830157004,Dovish
23,49, 나토/NNG,72,0.681563791293934,Dovish
18,38, 나주/NNG,56,0.687802361465961,Dovish
82,182, 영종/NNG,264,0.6542100605396625,Dovish
4,12, 프런티어마켓/NNG,16,0.4840090691797502,Dovish
5,11, 이자/NNG;원금/NNG;상환/NNG;부담/NNG,16,0.6600123670632958,Dovish
6,15, 높/VA;주가/NNG;하락/NNG,21,0.5808108830157004,Dovish
8,17,동종/NNG,25,0.6833069211949414,Dovish
9,25,실리콘밸리/NNG,34,0.5227297947141304,Dovish
6,14, 잉크/NNG,20,0.622297374659679,Dovish
6,19, 무언가/NNG,25,0.458534907643974,Dovish
14,32,물산/NNG,46,0.6352619032984222,Dovish
4,17,거침없이/MAG,21,0.3416534605974707,Dovish
12,31, 맞대결/NNG,43,0.5620750480797101,Dovish
6,14, 안전자산/NNG;수요/NNG;늘/VV,20,0.622297374659679,Dovish
5,17, 잠룡/NNG,22,0.42706682574683846,Dovish
53,118, 도보/NNG,171,0.6521817118608499,Dovish
5,16,바꾸/VV,21,0.4537585023560159,Dovish
9,34, 품격/NNG,43,0.3843601431721546,Dovish
6,17,인사말/NNG,23,0.5124801908962061,Dovish
4,15,인지/NNG,19,0.3872072553438002,Dovish
3,17, 나반/NNG,20,0.25624009544810306,Dovish
23,45, 가감/NNG,68,0.7421472394089503,Dovish
150,375,오피스텔/NNG,525,0.5808108830157003,Dovish
10,34, 글로벌/NNG;경기/NNG;악화/NNG,44,0.42706682574683846,Dovish
6,24, 오디/NNG,30,0.3630068018848127,Dovish
3,15, 제품/NNG;수출/NNG;감소/NNG,18,0.2904054415078502,Dovish
9,21, 지탄/NNG,30,0.6222973746596789,Dovish
6,14, 서브프라임/NNG;부실/NNG;확산/NNG,20,0.622297374659679,Dovish
5,27, 숏스퀴즈/NNG,32,0.26889392732208345,Dovish
9,51,즉시연금/NNG,60,0.25624009544810306,Dovish
3,13, 자바/NNG,16,0.33508320173982714,Dovish
6,12, 폭락/NNG;벗어나/VV,18,0.7260136037696254,Dovish
5,11,대권/NNG,16,0.6600123670632958,Dovish
3,15, 국제/NNG;금융시장/NNG;불확실성/NNG;확대/NNG,18,0.2904054415078502,Dovish
6,13, 아마겟돈/NNG,19,0.6701664034796543,Dovish
24,58,농가/NNG,82,0.6008388444990004,Dovish
11,23, 작목/NNG,34,0.6944477949100765,Dovish
2,14,상담사/NNG,16,0.20743245821989298,Dovish
10,26, 고용/NNG;지표/NNG;우려/NNG,36,0.5584720028997119,Dovish
5,15, 민간/NNG;고용자수/NNG;증가/NNG,20,0.48400906917975023,Dovish
4,18, 유통점/NNG,22,0.32267271278650017,Dovish
7,15, 불안/NNG;성장/NNG,22,0.6776126968516504,Dovish
23,64, 전셋집/NNG,87,0.5218222777094182,Dovish
3,14, 물가/NNG;좋/VA;않/VX,17,0.3111486873298395,Dovish
6,27,자진/NNG,33,0.32267271278650017,Dovish
2,16, 도스/NNG,18,0.18150340094240633,Dovish
6,18, 모액/NNG,24,0.4840090691797503,Dovish
8,16, 물가/NNG;안정/NNG;목표/NNG;밑돌/VV,24,0.7260136037696253,Dovish
1,16, 수유/NNG,17,0.09075170047120316,Dovish
11,26,자오/NNG,37,0.614319203189683,Dovish
10,33,위안부/NNG,43,0.44000824470886385,Dovish
11,35, 가계/NNG;부채/NNG;악화/NNG,46,0.4563514080837645,Dovish
5,17, 미국발/NNG;경기/NNG;침체/NNG;우려/NNG,22,0.42706682574683846,Dovish
28,65, 포렉스/NNG,93,0.6254886432476773,Dovish
5,11, 거리낌/NNG,16,0.6600123670632958,Dovish
4,12, 빈곤국/NNG,16,0.4840090691797502,Dovish
5,15, 장수채권/NNG,20,0.48400906917975023,Dovish
27,64, 국채선물시장/NNG;강세/NNG,91,0.6125739781806214,Dovish
7,14, 생물학/NNG,21,0.7260136037696254,Dovish
37,72, 반려/NNG,109,0.7461806483187817,Dovish
13,25,재생/NNG,38,0.7550541479204105,Dovish
5,28,다세대주택/NNG,33,0.2592905727748662,Dovish
4,15, gdp/NNG;성장률/NNG;낮/VV,19,0.3872072553438002,Dovish
5,18,록/NNG,23,0.4033408909831252,Dovish
0,17,아스/NNG,17,0.0,Dovish
5,19, 위기/NNG;경기/NNG;침체/NNG,24,0.38211242303664494,Dovish
17,49, 수수방관/NNG,66,0.5037645413911687,Dovish
6,23,만기기준/NNG,29,0.3787897063145872,Dovish
5,19,등기/NNG,24,0.38211242303664494,Dovish
4,15,트랜스/NNG,19,0.3872072553438002,Dovish
18,46, 과잉/NNG;공급/NNG;우려/NNG,64,0.5681845594718807,Dovish
7,15, 식스/NNG,22,0.6776126968516504,Dovish
4,16, 존엄/NNG,20,0.36300680188481266,Dovish
16,34,서브/NNG,50,0.6833069211949414,Dovish
5,17, 금리/NNG;인하/NNG;막/VV,22,0.42706682574683846,Dovish
7,14, 받아든/VV,21,0.7260136037696254,Dovish
8,29,원료/NNG,37,0.4005592296660002,Dovish
5,16, 경기/NNG;침체/NNG;악순환/NNG,21,0.4537585023560159,Dovish
8,30, 가판/NNG,38,0.3872072553438002,Dovish
2,14, 금리/NNG;인하/NNG;넘/VV,16,0.20743245821989298,Dovish
5,16, 천연/MAG,21,0.4537585023560159,Dovish
7,14, 글로벌/NNG;증시/NNG;변동성/NNG;확대/NNG,21,0.7260136037696254,Dovish
13,27, 공모전/NNG,40,0.6991242110374171,Dovish
27,91,프랑/NNG,118,0.4308212593797777,Dovish
6,22, 오프쇼어/NNG,28,0.3960074202379775,Dovish
8,25, 금융시장/NNG;위험자산/NNG;회피/NNG,33,0.46464870641256023,Dovish
4,17, 국제/NNG;유가/NNG;혼조/NNG,21,0.3416534605974707,Dovish
8,20, 명맥/NNG,28,0.5808108830157003,Dovish
10,39, 경기순환주/NNG,49,0.3723146685998079,Dovish
16,35, 藤/NNG,51,0.6637838663036575,Dovish
4,12, mmf형cma/NNG,16,0.4840090691797502,Dovish
7,15, 속였/VV,22,0.6776126968516504,Dovish
6,13, 날벼락/NNG,19,0.6701664034796543,Dovish
4,42, 금리/NNG;내리/VV;금리/NNG;인하/NNG,46,0.13828830547992862,Dovish
18,35,에스/NNG,53,0.7467568495916148,Dovish
5,28, 기부자/NNG,33,0.2592905727748662,Dovish
17,39, fed/NNG;통화정책/NNG;긴축/NNG,56,0.6329349366196735,Dovish
4,12,구체/NNG,16,0.4840090691797502,Dovish
6,13, 글로벌/NNG;물가/NNG;상승/NNG,19,0.6701664034796543,Dovish
9,20, 자금과부족/NNG,29,0.6534122433926629,Dovish
6,16, 신용시장/NNG;안정/NNG,22,0.5445102028272191,Dovish
7,17,철수/NNG,24,0.5978935560455738,Dovish
19,68, 통증/NNG,87,0.4057134844594965,Dovish
9,20, 블/VV,29,0.6534122433926629,Dovish
12,27,신사업/NNG,39,0.6453454255730003,Dovish
13,28, 종양/NNG,41,0.6741554892146522,Dovish
4,12, 판매/NNG;저조/NNG,16,0.4840090691797502,Dovish
6,12,합친/VV,18,0.7260136037696254,Dovish
6,21, 현역병/NNG,27,0.41486491643978596,Dovish
4,13, 신규/NNG;주택/NNG;판매가격/NNG;최저/NNG,17,0.44677760231976943,Dovish
4,19, 최저/NNG;금리/NNG;인하/NNG,23,0.30568993842931597,Dovish
11,28,위기감/NNG,39,0.5704392601047057,Dovish
8,17, 문도/NNG,25,0.6833069211949414,Dovish
12,31, 가공품/NNG,43,0.5620750480797101,Dovish
3,26, bis/NNG;비율/NNG;높/VV,29,0.16754160086991357,Dovish
3,16, 지표/NNG;부진/NNG;악재/NNG,19,0.27225510141360953,Dovish
6,12,연차보고서/NNG,18,0.7260136037696254,Dovish
9,29,갤/VV,38,0.45062913337425026,Dovish
5,12, 주택조합/NNG,17,0.6050113364746877,Dovish
3,14, 국제/NNG;금융시장/NNG;변동성/NNG;높/VA,17,0.3111486873298395,Dovish
2,15, 아우/NNG,17,0.1936036276719001,Dovish
6,18, 금융안정/NNG;확보/NNG,24,0.4840090691797503,Dovish
6,13, 했는데도/VV,19,0.6701664034796543,Dovish
14,39, 콘셉트/NNG,53,0.5212405360397311,Dovish
6,16, 잠재/NNG;성장률/NNG;둔화/NNG,22,0.5445102028272191,Dovish
14,32, 내장/NNG,46,0.6352619032984222,Dovish
6,12,타이거/NNG,18,0.7260136037696254,Dovish
9,33, 호주달러/NNG;급락/NNG,42,0.3960074202379775,Dovish
62,125,공포지수/NNG,187,0.7202054949394684,Dovish
8,25, 아낀/VV,33,0.46464870641256023,Dovish
2,14, 금리/NNG;상한/NNG;낮/VV,16,0.20743245821989298,Dovish
7,14, 어렵/VA;고금리/NNG,21,0.7260136037696254,Dovish
8,16, 국채선물시장/NNG;소폭/MAG;상승/NNG,24,0.7260136037696253,Dovish
19,56, 성금요일/NNG,75,0.4926520882722459,Dovish
6,28, 은대금리/NNG,34,0.3111486873298395,Dovish
6,13, 매겨진다/VV,19,0.6701664034796543,Dovish
4,12,유수/NNG,16,0.4840090691797502,Dovish
7,21, 저수지/NNG,28,0.4840090691797503,Dovish
11,27, 불법사금융시장/NNG,38,0.5915666401085836,Dovish
6,12, 기대수명/NNG;늘/VV,18,0.7260136037696254,Dovish
36,69,중화/NNG,105,0.7575794126291744,Dovish
4,16, 국채선물시장/NNG;급락/NNG,20,0.36300680188481266,Dovish
17,39, 고용/NNG;지표/NNG;호조/NNG;상승/NNG,56,0.6329349366196735,Dovish
5,14, 달러원/NNG;고용/NNG;지표/NNG;호조/NNG,19,0.5185811455497324,Dovish
4,14, 하산/NNG,18,0.41486491643978596,Dovish
20,41,레인지/NNG,61,0.7083059548971955,Dovish
6,13, 물가/NNG;부담/NNG;덜/VV,19,0.6701664034796543,Dovish
6,13, 자본시장/NNG;성장/NNG,19,0.6701664034796543,Dovish
12,31, 실적시즌/NNG;우려/NNG,43,0.5620750480797101,Dovish
9,25,선취/NNG,34,0.5227297947141304,Dovish
4,13, 대출/NNG;이자/NNG;인하/NNG,17,0.44677760231976943,Dovish
13,26,납입금/NNG,39,0.7260136037696254,Dovish
8,23, 객관성/NNG,31,0.5050529417527828,Dovish
4,18, 금리/NNG;완만/NNG;오르/VV,22,0.32267271278650017,Dovish
8,18, 캡슐/NNG,26,0.6453454255730003,Dovish
10,21, 자금사정/NNG;호전/NNG,31,0.6914415273996433,Dovish
5,13, 기업/NNG;수출/NNG;늘/VV,18,0.5584720028997119,Dovish
7,18,소득세법/NNG,25,0.5646772473763753,Dovish
6,23, 체조/NNG,29,0.3787897063145872,Dovish
2,16, 낮/VA;금리/NNG;내리/VV,18,0.18150340094240633,Dovish
21,63, 난사/NNG,84,0.48400906917975023,Dovish
2,26, 활동계좌/NNG,28,0.11169440057994236,Dovish
4,12, 실적/NNG;웃돌/VV,16,0.4840090691797502,Dovish
6,14,딩/MAG,20,0.622297374659679,Dovish
22,44, 키운다고/VV,66,0.7260136037696254,Dovish
4,14, 류성/NNG,18,0.41486491643978596,Dovish
14,38, 플레이스/NNG,52,0.5349573922513029,Dovish
5,22, 지표/NNG;부진/NNG;강세/NNG,27,0.3300061835316479,Dovish
6,13, 저격수/NNG,19,0.6701664034796543,Dovish
5,14, 이륜차/NNG,19,0.5185811455497324,Dovish
12,24, 모기지/NNG;고정/NNG;금리/NNG;하락/NNG,36,0.7260136037696254,Dovish
4,21, 실적/NNG;기대/NNG;낮/VA,25,0.27657661095985725,Dovish
7,19, 외환시장/NNG;패닉/NNG,26,0.5349573922513029,Dovish
14,33,양당/NNG,47,0.6160115425924094,Dovish
10,21, 따른다는/VV,31,0.6914415273996433,Dovish
13,35, 다룬다/VV,48,0.5393243913717217,Dovish
5,18, 미분양/NNG;주택/NNG;증가/NNG,23,0.4033408909831252,Dovish
39,87, 신용잔고/NNG,126,0.6509087482072504,Dovish
6,15, 고정/NNG;금리/NNG;낮/VA,21,0.5808108830157004,Dovish
8,27, 달러엔/NNG;강세/NNG,35,0.4302302837153335,Dovish
6,13, 오량/NNG,19,0.6701664034796543,Dovish
5,11, 생육/NNG,16,0.6600123670632958,Dovish
8,17, 육우/NNG,25,0.6833069211949414,Dovish
25,51,외은/NNG,76,0.7117780429113975,Dovish
13,34,공원/NNG,47,0.55518687347089,Dovish
5,12, 채권/NNG;과도/NNG,17,0.6050113364746877,Dovish
5,17,관리비/NNG,22,0.42706682574683846,Dovish
43,107, 대운하/NNG,150,0.5835249525625026,Dovish
7,15, 개당/NNG,22,0.6776126968516504,Dovish
6,20, 고인/VV,26,0.43560816226177523,Dovish
7,24, 기한이익/NNG,31,0.42350793553228144,Dovish
9,18, 신흥시장/NNG;경기/NNG;둔화/NNG,27,0.7260136037696254,Dovish
11,27, 학번/NNG,38,0.5915666401085836,Dovish
6,16, 방어전략/NNG,22,0.5445102028272191,Dovish
5,18,스텝/NNG,23,0.4033408909831252,Dovish
4,17, 스코프/NNG,21,0.3416534605974707,Dovish
4,16, 포렉스클럽/NNG,20,0.36300680188481266,Dovish
6,14, 합니다만/VV,20,0.622297374659679,Dovish
4,16, 아머/NNG,20,0.36300680188481266,Dovish
7,16, 오모/NNG,23,0.6352619032984222,Dovish
6,27,학력/NNG,33,0.32267271278650017,Dovish
11,22, 아자/NNG,33,0.7260136037696254,Dovish
4,13, 송이/NNG,17,0.44677760231976943,Dovish
13,36,누리꾼/NNG,49,0.5243431582780628,Dovish
14,48, 누리꾼/NNG,62,0.42350793553228144,Dovish
46,111,서명/NNG,157,0.6017410049261759,Dovish
4,14, 호조/NNG;오르/VV,18,0.41486491643978596,Dovish
5,13,폭행/NNG,18,0.5584720028997119,Dovish
7,14, 잘사/VV,21,0.7260136037696254,Dovish
6,13, 버젓이/MAG,19,0.6701664034796543,Dovish
5,13, 금리/NNG;폭등/NNG,18,0.5584720028997119,Dovish
13,32, 경진/NNG,45,0.5898860530628207,Dovish
15,36, 최악/NNG;침체/NNG,51,0.6050113364746877,Dovish
7,17, 바이오테크놀로지/NNG,24,0.5978935560455738,Dovish
11,30,경선/NNG,41,0.5324099760977252,Dovish
5,14, 칩거/NNG,19,0.5185811455497324,Dovish
28,81,모기지은행가협회/NNG,109,0.5019353310012225,Dovish
16,39, 스위트/NNG,55,0.5957034697596926,Dovish
17,44, 속초/NNG,61,0.5610105120038015,Dovish
3,13, 과부하/NNG,16,0.33508320173982714,Dovish
2,16, 금리/NNG;인상/NNG;앞당기/VV;않/VX,18,0.18150340094240633,Dovish
5,17, 지수/NNG;상승/NNG;막/VV,22,0.42706682574683846,Dovish
5,12,자택/NNG,17,0.6050113364746877,Dovish
1,20, 환전상/NNG,21,0.07260136037696253,Dovish
25,140, 중국a주/NNG,165,0.2592905727748662,Dovish
1,20, 시중/NNG;자금/NNG;넘/VV,21,0.07260136037696253,Dovish
18,38, 맴도/VV,56,0.687802361465961,Dovish
6,15, 경기/NNG;침체국면/NNG;빠지/VV,21,0.5808108830157004,Dovish
3,16, 탈회/NNG,19,0.27225510141360953,Dovish
6,19, 욕조/NNG,25,0.458534907643974,Dovish
6,13, 실태도/NNG,19,0.6701664034796543,Dovish
6,28, 안강/NNG,34,0.3111486873298395,Dovish
46,95,정경/NNG,141,0.7030868583874267,Dovish
3,18, 글로벌/NNG;경기/NNG;살/VV,21,0.24200453458987514,Dovish
8,17, 은행/NNG;문턱/NNG;넘/VV;못하/VX,25,0.6833069211949414,Dovish
14,33,상저하고/NNG,47,0.6160115425924094,Dovish
12,28,아끼/VV,40,0.622297374659679,Dovish
4,12, 총집결/NNG,16,0.4840090691797502,Dovish
10,31,정근/NNG,41,0.46839587339975836,Dovish
7,34, 외교통/NNG,41,0.2989467780227869,Dovish
4,14,항셍/NNG,18,0.41486491643978596,Dovish
4,16, 국채/NNG;금리/NNG;상승/NNG;약세/NNG,20,0.36300680188481266,Dovish
85,193,장기영역/NNG,278,0.6394938478799809,Dovish
4,14, 두루뭉술/NNG,18,0.41486491643978596,Dovish
5,11, 국채/NNG;보유/NNG;줄/VV,16,0.6600123670632958,Dovish
23,65, 서치/NNG,88,0.5137942426677349,Dovish
11,33, 콘트롤/NNG,44,0.48400906917975023,Dovish
8,25, 사노피/NNG,33,0.46464870641256023,Dovish
13,59, 캥거루본드/NNG,72,0.3199381982713604,Dovish
6,18,캥거루본드/NNG,24,0.4840090691797503,Dovish
5,12, 부책/NNG,17,0.6050113364746877,Dovish
9,25, 가로채/VV,34,0.5227297947141304,Dovish
5,12, 대출/NNG;풀/VV,17,0.6050113364746877,Dovish
6,12, 아름답/VA,18,0.7260136037696254,Dovish
9,37, 건전성/NNG;나쁘/VA,46,0.35319580723927724,Dovish
3,14,보훈/NNG,17,0.3111486873298395,Dovish
5,18, 경제/NNG;내수/NNG;부진/NNG,23,0.4033408909831252,Dovish
2,14, 이자이익/NNG;확대/NNG,16,0.20743245821989298,Dovish
8,20, 금리체계/NNG;개선/NNG,28,0.5808108830157003,Dovish
0,18, 농가/NNG;소득/NNG;안정/NNG,18,0.0,Dovish
8,21,폐업/NNG,29,0.5531532219197145,Dovish
36,87, 교통망/NNG,123,0.6008388444990004,Dovish
10,23,증권거래세/NNG,33,0.6313161771909785,Dovish
7,14, 제조업/NNG;타격/NNG,21,0.7260136037696254,Dovish
5,11, 실적/NNG;전망/NNG;넘/VV,16,0.6600123670632958,Dovish
8,23, 비농업/NNG;고용/NNG;예상/NNG;밑돌/VV,31,0.5050529417527828,Dovish
5,12, 탄신/NNG,17,0.6050113364746877,Dovish
7,14, 고용/NNG;지표/NNG;예상/NNG;상회/NNG,21,0.7260136037696254,Dovish
7,47, fed/NNG;이르/VV;금리/NNG;인상/NNG,54,0.2162593713356331,Dovish
6,18,운전/NNG,24,0.4840090691797503,Dovish
7,25, 감사관/NNG,32,0.40656761811099024,Dovish
13,34, 이자/NNG;경감/NNG,47,0.55518687347089,Dovish
4,14,동참/NNG,18,0.41486491643978596,Dovish
8,18, 위험자산/NNG;회피/NNG;크/VV,26,0.6453454255730003,Dovish
6,17,응모/NNG,23,0.5124801908962061,Dovish
8,40, 매출/NNG;예상/NNG;웃돌/VV,48,0.29040544150785014,Dovish
7,35, 지표/NNG;강세/NNG,42,0.29040544150785014,Dovish
9,18, 금융시장/NNG;하락/NNG,27,0.7260136037696254,Dovish
5,12, 실적시즌/NNG;불안/NNG,17,0.6050113364746877,Dovish
5,13, 주택담보대출/NNG;많이/MAG;늘/VV,18,0.5584720028997119,Dovish
4,15, 수출업체/NNG;네고/NNG;상승/NNG,19,0.3872072553438002,Dovish
12,31,선관위/NNG,43,0.5620750480797101,Dovish
9,19,연안/NNG,28,0.687802361465961,Dovish
33,184,노중/NNG,217,0.26041792309127865,Dovish
56,240,재정환율/NNG,296,0.3388063484258252,Dovish
6,13, 극심한/VAX;불황/NNG,19,0.6701664034796543,Dovish
6,14, 차입/NNG;비용/NNG;높/VA,20,0.622297374659679,Dovish
10,24,이민/NNG,34,0.6050113364746877,Dovish
11,23, 노역/NNG,34,0.6944477949100765,Dovish
31,71,사학연금/NNG,102,0.6339837103340391,Dovish
15,47,특례/NNG,62,0.4634129385763566,Dovish
13,52,본원/NNG,65,0.3630068018848127,Dovish
8,19,계란/NNG,27,0.6113798768586319,Dovish
12,35, 짊어진/VV,47,0.49783789972774317,Dovish
12,27,산와/NNG,39,0.6453454255730003,Dovish
4,15, 인플레이션/NNG;웃돌/VV,19,0.3872072553438002,Dovish
3,14, 인상/NNG;둔화/NNG,17,0.3111486873298395,Dovish
4,12,간사인/NNG,16,0.4840090691797502,Dovish
6,14,수술/NNG,20,0.622297374659679,Dovish
8,20, 위기감/NNG;높/VA,28,0.5808108830157003,Dovish
5,15, 부도/NNG;공포/NNG,20,0.48400906917975023,Dovish
2,15, 금융시장/NNG;자신/NNG,17,0.1936036276719001,Dovish
22,43, 씽크/NNG,65,0.7428976410665934,Dovish
1,15, 정수장/NNG,16,0.09680181383595005,Dovish
3,14, 투자매매업/NNG,17,0.3111486873298395,Dovish
6,27, 행위규제/NNG,33,0.32267271278650017,Dovish
11,23,백도/NNG,34,0.6944477949100765,Dovish
7,15,웨/NNG,22,0.6776126968516504,Dovish
14,29,합의안/NNG,43,0.7009786519155004,Dovish
6,16, 단오절/NNG,22,0.5445102028272191,Dovish
7,16, 내려보냈/VV,23,0.6352619032984222,Dovish
5,28,위안화채권/NNG,33,0.2592905727748662,Dovish
5,12,심천/NNG,17,0.6050113364746877,Dovish
30,63,연합회/NNG,93,0.6914415273996432,Dovish
5,18, 일몰제/NNG,23,0.4033408909831252,Dovish
5,13, 돈/NNG;빌리/VV;쉽/VA,18,0.5584720028997119,Dovish
12,25, 폐쇄형/NNG,37,0.6969730596188405,Dovish
5,15, 기타소득세/NNG,20,0.48400906917975023,Dovish
5,19,경기민감업종/NNG,24,0.38211242303664494,Dovish
24,46,중제/NNG,70,0.7575794126291744,Dovish
9,21,설립자/NNG,30,0.6222973746596789,Dovish
4,18, 대출/NNG;이자/NNG;부담/NNG;줄/VV,22,0.32267271278650017,Dovish
16,37, 빙산/NNG,53,0.6279036573142706,Dovish
6,15,이모/NNG,21,0.5808108830157004,Dovish
4,16,장부/NNG,20,0.36300680188481266,Dovish
9,34,배출/NNG,43,0.3843601431721546,Dovish
18,41, 입영/NNG,59,0.637475359407476,Dovish
6,13,김/NNG,19,0.6701664034796543,Dovish
2,16, 재범/NNG,18,0.18150340094240633,Dovish
5,18, 스멀스멀/MAG,23,0.4033408909831252,Dovish
11,27, 지식산업/NNG,38,0.5915666401085836,Dovish
6,13, 세계/NNG;경제/NNG;완만/NNG;성장/NNG,19,0.6701664034796543,Dovish
7,14, 유족연금/NNG,21,0.7260136037696254,Dovish
4,13, 한다든지/VV,17,0.44677760231976943,Dovish
7,17,로스쿨/NNG,24,0.5978935560455738,Dovish
5,14, 안전시설/NNG,19,0.5185811455497324,Dovish
7,19, 주택거래시장/NNG,26,0.5349573922513029,Dovish
6,13,최상위/NNG,19,0.6701664034796543,Dovish
7,18, 예상/NNG;감소/NNG;부진/NNG,25,0.5646772473763753,Dovish
5,22, 위험/NNG;회피/NNG;강하/VA,27,0.3300061835316479,Dovish
8,17, 연신/MAG,25,0.6833069211949414,Dovish
14,33,도덕적해이/NNG,47,0.6160115425924094,Dovish
4,14,가상/NNG,18,0.41486491643978596,Dovish
8,17, 인멸/NNG,25,0.6833069211949414,Dovish
5,20, 달러인덱스/NNG;고점/NNG,25,0.3630068018848127,Dovish
7,18, 지표/NNG;성장/NNG,25,0.5646772473763753,Dovish
3,16,운명/NNG,19,0.27225510141360953,Dovish
6,19, 길잡이/NNG,25,0.458534907643974,Dovish
6,17, 대못/NNG,23,0.5124801908962061,Dovish
6,22, 소치/NNG,28,0.3960074202379775,Dovish
9,26, 떨어트려/VV,35,0.5026248026097407,Dovish
6,13, 세전이익률/NNG,19,0.6701664034796543,Dovish
1,21, 고용/NNG;지표/NNG;호조/NNG;강세/NNG,22,0.06914415273996431,Dovish
5,13, 기업/NNG;수익성/NNG;나쁘/VA,18,0.5584720028997119,Dovish
6,20, 경기/NNG;회복/NNG;위협/NNG,26,0.43560816226177523,Dovish
78,164,주택연금/NNG,242,0.6905983060247657,Dovish
8,17,무/NNG,25,0.6833069211949414,Dovish
8,18, 녹조/NNG,26,0.6453454255730003,Dovish
6,23,불량/NNG,29,0.3787897063145872,Dovish
11,27,경로/NNG,38,0.5915666401085836,Dovish
6,15,기대수명/NNG,21,0.5808108830157004,Dovish
7,14, 건설/NNG;경기/NNG;악화/NNG,21,0.7260136037696254,Dovish
3,20,깁스/NNG,23,0.21780408113088762,Dovish
6,26, 공동보조/NNG,32,0.33508320173982714,Dovish
4,14, 급락/NNG;채권/NNG;가격/NNG;상승/NNG,18,0.41486491643978596,Dovish
9,24,사채권자/NNG,33,0.5445102028272191,Dovish
17,99, 인양/NNG,116,0.24933800533502287,Dovish
9,42,와인/NNG,51,0.31114868732983947,Dovish
10,20,보험업법/NNG,30,0.7260136037696254,Dovish
6,15, 그려진/VV,21,0.5808108830157004,Dovish
8,19, 조별/NNG,27,0.6113798768586319,Dovish
12,26,흥업/NNG,38,0.6701664034796543,Dovish
14,38, 멘토링/NNG,52,0.5349573922513029,Dovish
6,12, 심해서/VA,18,0.7260136037696254,Dovish
4,18, 전환배치/NNG,22,0.32267271278650017,Dovish
12,27,닥터둠/NNG,39,0.6453454255730003,Dovish
6,15, 투기등급/NNG;낮/VV,21,0.5808108830157004,Dovish
5,14,외풍/NNG,19,0.5185811455497324,Dovish
1,15, 질풍노도/NNG,16,0.09680181383595005,Dovish
8,17, 특명/NNG,25,0.6833069211949414,Dovish
9,21,덩달아/MAG,30,0.6222973746596789,Dovish
3,14, 북한리스크/NNG;감소/NNG,17,0.3111486873298395,Dovish
4,18, 물가/NNG;목표/NNG;높/VV,22,0.32267271278650017,Dovish
5,20,태/NNG,25,0.3630068018848127,Dovish
5,28, 경제/NNG;침체/NNG;막/VV,33,0.2592905727748662,Dovish
10,25,기업가/NNG,35,0.5808108830157004,Dovish
12,28,장보/NNG,40,0.622297374659679,Dovish
31,96,오버나이트/NNG,127,0.46888378576788303,Dovish
20,53, 호주달러/NNG;하락/NNG,73,0.5479347952978305,Dovish
5,11,사이드카/NNG,16,0.6600123670632958,Dovish
5,11, 끄떡없/VA,16,0.6600123670632958,Dovish
6,12, 유가/NNG;단기/NNG;급등/NNG,18,0.7260136037696254,Dovish
32,75,치러진/VV,107,0.6195316085500803,Dovish
9,21, 높/VA;수익률/NNG;낮/VA,30,0.6222973746596789,Dovish
11,24, 점보론/NNG,35,0.6655124701221565,Dovish
11,32, 금리/NNG;낮/VV;없/VA,43,0.4991343525916174,Dovish
7,23, 출몰/NNG,30,0.441921324033685,Dovish
9,23, 점보/NNG,32,0.5681845594718807,Dovish
5,22, 利/NNG,27,0.3300061835316479,Dovish
5,14,소액투자자/NNG,19,0.5185811455497324,Dovish
15,32, 신용위기/NNG;해소/NNG,47,0.6806377535340238,Dovish
7,18, 금리/NNG;인상/NNG;일시적/VAX,25,0.5646772473763753,Dovish
50,114, 와타나베부인/NNG,164,0.6368540383944082,Dovish
5,15, 중량감/NNG,20,0.48400906917975023,Dovish
37,87,신환/NNG,124,0.6175288124017504,Dovish
9,36, 눌릴/VV,45,0.3630068018848127,Dovish
19,38, 최고위/NNG,57,0.7260136037696254,Dovish
3,13, 성장/NNG;영향/NNG;줄/VV,16,0.33508320173982714,Dovish
6,18,외식업/NNG,24,0.4840090691797503,Dovish
7,17, 유동성/NNG;쏟/VV,24,0.5978935560455738,Dovish
13,35, 꺼린다/VV,48,0.5393243913717217,Dovish
12,27, 동맥/NNG,39,0.6453454255730003,Dovish
5,19, 이어져서/VV,24,0.38211242303664494,Dovish
27,52, 편취/NNG,79,0.7539372039146109,Dovish
15,39, 금융시장/NNG;과도/NNG,54,0.5584720028997118,Dovish
7,21, 빠져나간다면/VV,28,0.4840090691797503,Dovish
40,84,고용률/NNG,124,0.6914415273996433,Dovish
5,12, 세계/NNG;안전자산/NNG;선호/NNG,17,0.6050113364746877,Dovish
3,15, 금리/NNG;인하/NNG;필요/NNG;않/VX,18,0.2904054415078502,Dovish
8,16, 세계/NNG;금융/NNG;불안/NNG,24,0.7260136037696253,Dovish
8,19, 금융시장/NNG;여건/NNG;악화/NNG,27,0.6113798768586319,Dovish
8,16,참사/NNG,24,0.7260136037696253,Dovish
12,39, 금리/NNG;재할인율/NNG;인하/NNG,51,0.4467776023197695,Dovish
23,45, 보리/NNG,68,0.7421472394089503,Dovish
7,17,주성/NNG,24,0.5978935560455738,Dovish
12,24, 입당/NNG,36,0.7260136037696254,Dovish
3,22, 금리/NNG;내리/VV;돈/NNG;풀/VV,25,0.19800371011898876,Dovish
5,11, 금리/NNG;인하/NNG;주가/NNG;상승/NNG,16,0.6600123670632958,Dovish
8,37, 미국발/NNG;금융/NNG;불안/NNG,45,0.3139518286571353,Dovish
6,15, 급락/NNG;금리/NNG;인하/NNG,21,0.5808108830157004,Dovish
3,13, 우려/NNG;시장/NNG;불안/NNG,16,0.33508320173982714,Dovish
4,12, 주택차압/NNG;급증/NNG,16,0.4840090691797502,Dovish
3,13, 자산담보증권/NNG,16,0.33508320173982714,Dovish
5,15, 신용위험/NNG;해소/NNG,20,0.48400906917975023,Dovish
11,42, 하만/NNG,53,0.3802928400698038,Dovish
4,13, 신용위기/NNG;경제/NNG;성장/NNG,17,0.44677760231976943,Dovish
10,47,와타나베부인/NNG,57,0.30894195905090444,Dovish
16,34, 新聞/NNG,50,0.6833069211949414,Dovish
6,14, 총연장/NNG,20,0.622297374659679,Dovish
2,14, 국채/NNG;안전자산/NNG;선호/NNG,16,0.20743245821989298,Dovish
7,20, 침체/NNG;심각/NNG,27,0.5082095226387378,Dovish
7,23, 주택/NNG;지표/NNG;약화/NNG,30,0.441921324033685,Dovish
18,42,여객기/NNG,60,0.6222973746596789,Dovish
3,15, 전망/NNG;심각/NNG,18,0.2904054415078502,Dovish
5,17, 선발대/NNG,22,0.42706682574683846,Dovish
23,45, aa+등급/NNG,68,0.7421472394089503,Dovish
7,14, 학구/NNG,21,0.7260136037696254,Dovish
2,14, 금리/NNG;인하/NNG;줄/VV,16,0.20743245821989298,Dovish
12,37, 금융위기/NNG;불안/NNG,49,0.47092774298570295,Dovish
8,22, 뜰/NNG,30,0.5280098936506367,Dovish
6,18, 금융시장/NNG;호조/NNG,24,0.4840090691797503,Dovish
13,38, 청춘/NNG,51,0.49674614994763844,Dovish
7,14, 장보기/NNG,21,0.7260136037696254,Dovish
8,16, 아껴야/VV,24,0.7260136037696253,Dovish
5,11, 금융시장/NNG;신용경색/NNG;해소/NNG,16,0.6600123670632958,Dovish
12,23,횡령/NNG,35,0.7575794126291744,Dovish
5,11, 월성/NNG,16,0.6600123670632958,Dovish
8,16, 카자흐/NNG,24,0.7260136037696253,Dovish
6,23,예금회전율/NNG,29,0.3787897063145872,Dovish
6,19, 찾아나서/VV,25,0.458534907643974,Dovish
7,18, 이미/MAG;침체/NNG,25,0.5646772473763753,Dovish
5,16, 경기/NNG;침체/NNG;우려/NNG;하락/NNG,21,0.4537585023560159,Dovish
7,20, 끼친다는/VV,27,0.5082095226387378,Dovish
10,21, 영업이익/NNG;전망/NNG;상향/NNG,31,0.6914415273996433,Dovish
6,15, 학술지/NNG,21,0.5808108830157004,Dovish
8,34, 채권보증/NNG,42,0.3416534605974707,Dovish
29,60, 고용/NNG;지표/NNG;충격/NNG,89,0.7018131503106378,Dovish
7,16, 격성/NNG,23,0.6352619032984222,Dovish
13,35,은산분리/NNG,48,0.5393243913717217,Dovish
3,14, ecb/NNG;시장/NNG;안정/NNG,17,0.3111486873298395,Dovish
3,15,건/NNG,18,0.2904054415078502,Dovish
6,30,협의체/NNG,36,0.2904054415078502,Dovish
10,23,카드결제/NNG,33,0.6313161771909785,Dovish
25,59, 비농업/NNG;고용/NNG;지표/NNG;부진/NNG,84,0.6152657659064623,Dovish
6,12, 집유/NNG,18,0.7260136037696254,Dovish
2,18, 담뱃갑/NNG,20,0.16133635639325009,Dovish
3,18, 수출업체/NNG;네고/NNG;많/VA,21,0.24200453458987514,Dovish
5,11,재벌그룹/NNG,16,0.6600123670632958,Dovish
3,21, 불안정/NNG;해소/NNG,24,0.20743245821989298,Dovish
1,16,캘/VV,17,0.09075170047120316,Dovish
6,13, 미/NNG;원유/NNG;재고/NNG;감소/NNG,19,0.6701664034796543,Dovish
5,22, 네고우위/NNG,27,0.3300061835316479,Dovish
3,14, 금리/NNG;인하/NNG;경기/NNG;둔화/NNG,17,0.3111486873298395,Dovish
37,90, 안전자산/NNG;선호/NNG;강하/VA,127,0.5969445186550254,Dovish
5,30, 미/NNG;국채/NNG;선호/NNG,35,0.24200453458987511,Dovish
12,24, 위험/NNG;선호/NNG;살/VV,36,0.7260136037696254,Dovish
3,13, 택할지/VV,16,0.33508320173982714,Dovish
3,14, 미대/NNG,17,0.3111486873298395,Dovish
13,25, 지표/NNG;최저/NNG,38,0.7550541479204105,Dovish
5,11, 대출/NNG;비용/NNG;상승/NNG,16,0.6600123670632958,Dovish
3,16, 위기/NNG;타격/NNG,19,0.27225510141360953,Dovish
4,12, 신속/NNG;금리/NNG;인하/NNG,16,0.4840090691797502,Dovish
5,16, 인하/NNG;부정적/VAX,21,0.4537585023560159,Dovish
16,33, 외국인/NNG;수급/NNG;긍정적/VAX,49,0.7040131915341822,Dovish
3,28, 금리/NNG;인하/NNG;효과/NNG;제한적/VAX,31,0.15557434366491976,Dovish
4,14, 경기/NNG;확장/NNG;하회/NNG,18,0.41486491643978596,Dovish
8,16, 컨센서스/NNG;인하/NNG,24,0.7260136037696253,Dovish
4,12,잰/NNG,16,0.4840090691797502,Dovish
14,38, 소매/NNG;판매/NNG;지표/NNG;부진/NNG,52,0.5349573922513029,Dovish
10,22, 금융위기/NNG;심각/NNG,32,0.6600123670632958,Dovish
7,24, 금융시장/NNG;실망/NNG,31,0.42350793553228144,Dovish
5,28, 금리/NNG;인하/NNG;실망/NNG,33,0.2592905727748662,Dovish
38,87,한중/NNG,125,0.6342187803045004,Dovish
8,21,암울/NNG,29,0.5531532219197145,Dovish
12,71, 경기/NNG;침체/NNG;공포/NNG,83,0.2454130491615635,Dovish
3,14, fed/NNG;금리/NNG;재할인율/NNG;인하/NNG,17,0.3111486873298395,Dovish
6,13, 원달러/NNG;금리/NNG;인하/NNG,19,0.6701664034796543,Dovish
7,17, 영월/NNG,24,0.5978935560455738,Dovish
8,25, 밀약/NNG,33,0.46464870641256023,Dovish
5,17,임시회의/NNG,22,0.42706682574683846,Dovish
3,18, 묵과/NNG,21,0.24200453458987514,Dovish
7,30, 하락/NNG;속도/NNG;늦/VV,37,0.3388063484258252,Dovish
9,44, 달러원/NNG;금리/NNG;인하/NNG,53,0.29700556517848314,Dovish
5,11, 복권기금/NNG,16,0.6600123670632958,Dovish
4,18,중소기업정책자금/NNG,22,0.32267271278650017,Dovish
7,25, 외환시장/NNG;금리/NNG;인하/NNG,32,0.40656761811099024,Dovish
6,13, 금리/NNG;인하/NNG;힘입/VV;상승/NNG,19,0.6701664034796543,Dovish
8,24, 주택차압/NNG;막/VV,32,0.4840090691797502,Dovish
4,16,돌연/MAG,20,0.36300680188481266,Dovish
43,138,수익형/NNG,181,0.4524432603202013,Dovish
28,70, 금융시장/NNG;불안/NNG;크/VV,98,0.5808108830157003,Dovish
7,48, 리보/NNG;리보금리/NNG;하락/NNG,55,0.21175396776614072,Dovish
5,14, 경제/NNG;뇌관/NNG;떠오르/VV,19,0.5185811455497324,Dovish
6,17, 발뺌/NNG,23,0.5124801908962061,Dovish
9,31, 관심업종/NNG,40,0.42155628605978257,Dovish
211,444, 부셸/NNG,655,0.6900399567359953,Dovish
5,11,자국민/NNG,16,0.6600123670632958,Dovish
4,15, 달라이/NNG,19,0.3872072553438002,Dovish
2,33, 부동산/NNG;금리/NNG;인하/NNG,35,0.08800164894177277,Dovish
7,15,중추절/NNG,22,0.6776126968516504,Dovish
1,16, 고용/NNG;경기/NNG;개선/NNG,17,0.09075170047120316,Dovish
11,25, 회복력/NNG;강화/NNG,36,0.6388919713172704,Dovish
4,16, 조림/NNG,20,0.36300680188481266,Dovish
6,24, 접경/NNG,30,0.3630068018848127,Dovish
5,21, 경제/NNG;펀더멘털/NNG;우려/NNG,26,0.34572076369982163,Dovish
5,13, 가격/NNG;밑돌/VV,18,0.5584720028997119,Dovish
6,15, 크리스틴/NNG,21,0.5808108830157004,Dovish
3,13,환경산업/NNG,16,0.33508320173982714,Dovish
11,47,항만공사/NNG,58,0.3398361549559949,Dovish
4,15,기본급/NNG,19,0.3872072553438002,Dovish
5,58, 세계/NNG;금리/NNG;인하/NNG,63,0.12517475927062507,Dovish
5,12, 금리/NNG;인하/NNG;전망/NNG;우세/NNG,17,0.6050113364746877,Dovish
8,23, 활황기/NNG,31,0.5050529417527828,Dovish
12,36, 닉네임/NNG,48,0.4840090691797503,Dovish
4,13, 원자재/NNG;시장/NNG;상승/NNG,17,0.44677760231976943,Dovish
32,81,채무조정/NNG,113,0.5736403782871113,Dovish
9,45, 신복/NNG,54,0.2904054415078502,Dovish
5,22, 기초/NNG;여건/NNG;개선/NNG,27,0.3300061835316479,Dovish
1,15,국비/NNG,16,0.09680181383595005,Dovish
8,16, 유동성/NNG;위기/NNG;해소/NNG,24,0.7260136037696253,Dovish
29,61, 안전자산/NNG;선호/NNG;약하/VA,90,0.6903080166989881,Dovish
14,29,키스/NNG,43,0.7009786519155004,Dovish
9,18, 구제금융사태/NNG,27,0.7260136037696254,Dovish
6,13, pf/NNG;대출/NNG;부실/NNG;우려/NNG,19,0.6701664034796543,Dovish
5,11, 위험/NNG;회피/NNG;약화/NNG,16,0.6600123670632958,Dovish
74,142,공약/NNG,216,0.7566902349148208,Dovish
4,18, 옵션프리미엄/NNG,22,0.32267271278650017,Dovish
5,11, 소조/NNG,16,0.6600123670632958,Dovish
8,25,지인/NNG,33,0.46464870641256023,Dovish
12,34,프랜차이즈/NNG,46,0.5124801908962061,Dovish
4,27,합/NNG,31,0.21511514185766675,Dovish
32,65,시공사/NNG,97,0.7148441637116312,Dovish
8,21, 글로벌/NNG;시장/NNG;불확실성/NNG,29,0.5531532219197145,Dovish
6,14, 일러도/VV,20,0.622297374659679,Dovish
5,22, 유가/NNG;원유/NNG;재고/NNG;예상밖/NNG;감소/NNG,27,0.3300061835316479,Dovish
9,49,뉴욕이코노믹클럽/NNG,58,0.2666988748541481,Dovish
13,25, 굴려야/VV,38,0.7550541479204105,Dovish
2,14,스퀴즈/NNG,16,0.20743245821989298,Dovish
3,14, 경제/NNG;성장/NNG;부담/NNG,17,0.3111486873298395,Dovish
8,16, 肖/NNG,24,0.7260136037696253,Dovish
12,23, 기대/NNG;증시/NNG;긍정적/VAX,35,0.7575794126291744,Dovish
6,25, 주택/NNG;최대/NNG,31,0.34848652980942024,Dovish
8,18, 경기/NNG;침체/NNG;길/VA,26,0.6453454255730003,Dovish
4,13, 단기/NNG;가격/NNG;부담/NNG,17,0.44677760231976943,Dovish
6,12, 건져/VV,18,0.7260136037696254,Dovish
4,22,저지/NNG,26,0.26400494682531833,Dovish
17,34, 원유/NNG;재고/NNG;줄/VV,51,0.7260136037696254,Dovish
5,14, 전망/NNG;깨/VV,19,0.5185811455497324,Dovish
8,31, 당분간/MAG;변동성/NNG;확대/NNG,39,0.3747166987198067,Dovish
2,14, 명안/NNG,16,0.20743245821989298,Dovish
22,48, 자펀드/NNG,70,0.6655124701221565,Dovish
5,13, 구와/NNG,18,0.5584720028997119,Dovish
4,12, 귀책/NNG,16,0.4840090691797502,Dovish
4,12, 금리/NNG;인하/NNG;원화/NNG;강세/NNG,16,0.4840090691797502,Dovish
18,35, 가격/NNG;혼조/NNG,53,0.7467568495916148,Dovish
6,18, 에이치/NNG,24,0.4840090691797503,Dovish
6,30, 장기연체자/NNG,36,0.2904054415078502,Dovish
2,18, 아틀라스/NNG,20,0.16133635639325009,Dovish
7,24, 추락/NNG;막/VV,31,0.42350793553228144,Dovish
9,22, 세일앤리스백/NNG,31,0.5940111303569663,Dovish
18,35, 암시장/NNG,53,0.7467568495916148,Dovish
6,14,이변/NNG,20,0.622297374659679,Dovish
110,262, 박의/NNG,372,0.6096297436233495,Dovish
3,22,모노라인/NNG,25,0.19800371011898876,Dovish
5,15, 화도/NNG,20,0.48400906917975023,Dovish
10,25, 자원국/NNG,35,0.5808108830157004,Dovish
5,12, 지표/NNG;호조/NNG;기업/NNG;실적/NNG;개선/NNG,17,0.6050113364746877,Dovish
6,13, 신용위기/NNG;공포/NNG,19,0.6701664034796543,Dovish
2,17, 저성장/NNG;빠지/VV,19,0.17082673029873535,Dovish
6,20, 리보금리/NNG;급등/NNG,26,0.43560816226177523,Dovish
6,17, 회의소/NNG,23,0.5124801908962061,Dovish
5,19, 아론/NNG,24,0.38211242303664494,Dovish
5,12, 정책/NNG;과도/NNG,17,0.6050113364746877,Dovish
8,16, 날아든/VV,24,0.7260136037696253,Dovish
14,29, 회사채/NNG;금리/NNG;오르/VV,43,0.7009786519155004,Dovish
5,12, 스치/VV,17,0.6050113364746877,Dovish
4,14, 초상화/NNG,18,0.41486491643978596,Dovish
14,28, 금리설계보금자리론/NNG,42,0.7260136037696254,Dovish
8,23, 신용/NNG;악재/NNG,31,0.5050529417527828,Dovish
6,13, 드러낸다고/VV,19,0.6701664034796543,Dovish
3,13, 어항/NNG,16,0.33508320173982714,Dovish
49,119, 미사/NNG,168,0.5978935560455739,Dovish
9,20,유관/NNG,29,0.6534122433926629,Dovish
7,17,혐의/NNG,24,0.5978935560455738,Dovish
5,13, 吉林/NNG,18,0.5584720028997119,Dovish
7,16, 물가/NNG;밀/VV;오르/VV,23,0.6352619032984222,Dovish
2,14, 자금/NNG;조달/NNG;환경/NNG;악화/NNG,16,0.20743245821989298,Dovish
69,165, 보이스피싱/NNG,234,0.6072113776982322,Dovish
7,15, 결사/NNG,22,0.6776126968516504,Dovish
8,25, 면사무소/NNG,33,0.46464870641256023,Dovish
8,19, 풍조/NNG,27,0.6113798768586319,Dovish
12,30,원화자산/NNG,42,0.5808108830157004,Dovish
3,17, 금리/NNG;인하/NNG;가능성/NNG;원화/NNG;절상/NNG,20,0.25624009544810306,Dovish
24,102, 외화/NNG;유동성/NNG;확보/NNG,126,0.34165346059747076,Dovish
3,14, 미계/NNG,17,0.3111486873298395,Dovish
4,23,융자금/NNG,27,0.2525264708763914,Dovish
13,26, 은메달/NNG,39,0.7260136037696254,Dovish
3,21, 총점/NNG,24,0.20743245821989298,Dovish
4,14, 불안/NNG;주가/NNG;하락/NNG,18,0.41486491643978596,Dovish
2,19,커뮤니티/NNG,21,0.15284496921465798,Dovish
5,28, 발행주체/NNG;부도/NNG;위험/NNG,33,0.2592905727748662,Dovish
9,27, 변동성지수/NNG;오르/VV,36,0.4840090691797503,Dovish
5,16, 해외/NNG;시장/NNG;불안/NNG,21,0.4537585023560159,Dovish
6,17, 불안/NNG;위험/NNG;회피/NNG,23,0.5124801908962061,Dovish
6,12, 선행매매/NNG,18,0.7260136037696254,Dovish
7,15,일정금액/NNG,22,0.6776126968516504,Dovish
7,19, 한상/NNG,26,0.5349573922513029,Dovish
8,19,경매시장/NNG,27,0.6113798768586319,Dovish
8,24, 외화자금/NNG;시장/NNG;불안/NNG,32,0.4840090691797502,Dovish
6,20, 관광숙박시설/NNG,26,0.43560816226177523,Dovish
8,18, 자금난/NNG;심각/NNG,26,0.6453454255730003,Dovish
5,20, 유동성공급계획/NNG,25,0.3630068018848127,Dovish
8,16, 되돌아온/VV,24,0.7260136037696253,Dovish
14,32, 국제/NNG;곡물/NNG;가격/NNG;상승/NNG,46,0.6352619032984222,Dovish
5,18, 내수/NNG;줄/VV,23,0.4033408909831252,Dovish
3,15, 호조/NNG;실적/NNG;전망/NNG;상향/NNG,18,0.2904054415078502,Dovish
5,13, 세계/NNG;경제/NNG;악재/NNG,18,0.5584720028997119,Dovish
3,18, 위기/NNG;회복/NNG,21,0.24200453458987514,Dovish
6,24, 글로벌/NNG;위험자산/NNG;회피/NNG,30,0.3630068018848127,Dovish
20,56,aa등급/NNG,76,0.5185811455497324,Dovish
10,24, 경기방어업종/NNG,34,0.6050113364746877,Dovish
3,18, 빈사/NNG,21,0.24200453458987514,Dovish
7,17,해제/NNG,24,0.5978935560455738,Dovish
3,14, 겉보기/NNG,17,0.3111486873298395,Dovish
5,19,실전/NNG,24,0.38211242303664494,Dovish
13,28, 달러원/NNG;변동성/NNG;확대/NNG,41,0.6741554892146522,Dovish
6,15, 대출/NNG;금리/NNG;내리/VV;않/VX,21,0.5808108830157004,Dovish
298,800,테너/NNG,1098,0.5408801348083709,Dovish
5,13, 고발장/NNG,18,0.5584720028997119,Dovish
7,24, 넘겨졌/VV,31,0.42350793553228144,Dovish
12,23, 량의/NNG,35,0.7575794126291744,Dovish
14,40, 등판/NNG,54,0.5082095226387378,Dovish
52,128,특검/NNG,180,0.5898860530628207,Dovish
4,14, 점수제/NNG,18,0.41486491643978596,Dovish
3,16, 치여/VV,19,0.27225510141360953,Dovish
5,12,웅/NNG,17,0.6050113364746877,Dovish
5,14, 해외/NNG;금융시장/NNG;불안/NNG,19,0.5185811455497324,Dovish
11,32, 실업률/NNG;웃돌/VV,43,0.4991343525916174,Dovish
3,15,유임/NNG,18,0.2904054415078502,Dovish
10,54, 판다본드/NNG,64,0.26889392732208345,Dovish
5,13, 부진/NNG;발목/NNG;잡/VV,18,0.5584720028997119,Dovish
4,12, 구조화투자회사/NNG,16,0.4840090691797502,Dovish
5,12, 경보음/NNG,17,0.6050113364746877,Dovish
25,70, 갱신청구권/NNG,95,0.5185811455497324,Dovish
8,24,연면적/NNG,32,0.4840090691797502,Dovish
12,41, 취소소송/NNG,53,0.42498357293831734,Dovish
3,13, 당분간/MAG;변동성/NNG;크/VV,16,0.33508320173982714,Dovish
11,35, 자산관리시장/NNG,46,0.4563514080837645,Dovish
9,26, 압류사태/NNG,35,0.5026248026097407,Dovish
6,13, 통화/NNG;완화정책/NNG;금리/NNG;인하/NNG,19,0.6701664034796543,Dovish
6,15,퀀트/NNG,21,0.5808108830157004,Dovish
6,13, 금융시장/NNG;좋/VA;않/VX,19,0.6701664034796543,Dovish
11,26, 실적/NNG;발목/NNG;잡/VV,37,0.614319203189683,Dovish
5,11, 가격/NNG;도크/NNG;오르/VV,16,0.6600123670632958,Dovish
12,23, 재해보험/NNG,35,0.7575794126291744,Dovish
22,56, 할당관세/NNG,78,0.5704392601047057,Dovish
8,17, 해병/NNG,25,0.6833069211949414,Dovish
7,15, 여론전/NNG,22,0.6776126968516504,Dovish
14,27,변호인/NNG,41,0.7529029965018337,Dovish
2,22, 자금/NNG;경색/NNG;해소/NNG,24,0.13200247341265917,Dovish
8,18, 걸으며/VV,26,0.6453454255730003,Dovish
14,54, 괴한/NNG,68,0.37645149825091684,Dovish
10,36,확정치/NNG,46,0.4033408909831252,Dovish
4,13, ff/NNG;금리선물/NNG;인하/NNG,17,0.44677760231976943,Dovish
21,49,금융사별/NNG,70,0.6222973746596789,Dovish
7,29, 장애인기업/NNG,36,0.3504893259577502,Dovish
5,13, 불확실성/NNG;가시/VV;않/VX,18,0.5584720028997119,Dovish
5,11, 앞세웠/VV,16,0.6600123670632958,Dovish
4,17, 상장예비심사/NNG,21,0.3416534605974707,Dovish
3,14, 잠복기/NNG,17,0.3111486873298395,Dovish
4,15, 자금/NNG;경색/NNG;풀/VV,19,0.3872072553438002,Dovish
18,63, ted스프레드/NNG,81,0.41486491643978596,Dovish
5,25, 금리/NNG;인상/NNG;가능성/NNG;넘/VV,30,0.2904054415078502,Dovish
8,18, 모르핀/NNG,26,0.6453454255730003,Dovish
4,12, 인하/NNG;가능성/NNG;크/VV,16,0.4840090691797502,Dovish
8,26, 외환시장/NNG;원달러/NNG;상승/NNG,34,0.44677760231976943,Dovish
2,23, 방제/NNG,25,0.1262632354381957,Dovish
4,13, 저버렸/VV,17,0.44677760231976943,Dovish
6,17, 기간제근로자/NNG,23,0.5124801908962061,Dovish
7,20, 부동산/NNG;좋/VA,27,0.5082095226387378,Dovish
12,23, 영어자금/NNG,35,0.7575794126291744,Dovish
4,18, 최대/NNG;유예/NNG,22,0.32267271278650017,Dovish
4,15, 금융시장/NNG;살/VV,19,0.3872072553438002,Dovish
9,22, 통화정책/NNG;반대/NNG,31,0.5940111303569663,Dovish
9,18, 손꼽혔/VV,27,0.7260136037696254,Dovish
10,28, 금융시장/NNG;신뢰/NNG;회복/NNG,38,0.5185811455497324,Dovish
7,30, 비웠/VV,37,0.3388063484258252,Dovish
2,14,원천/NNG,16,0.20743245821989298,Dovish
7,17, 소비자/NNG;물가/NNG;최대/NNG,24,0.5978935560455738,Dovish
10,21, 양적/VAX;성장/NNG;질적/VAX;성장/NNG,31,0.6914415273996433,Dovish
2,23, 세계/NNG;경제/NNG;성장률/NNG;전망/NNG;낮/VV,25,0.1262632354381957,Dovish
13,42, 치즈/NNG,55,0.4494369928097681,Dovish
8,49, 투표일/NNG,57,0.23706566653702052,Dovish
40,85, 출구조사/NNG,125,0.6833069211949416,Dovish
10,31, 수출업체/NNG;고점/NNG,41,0.46839587339975836,Dovish
7,21, 이자율/NNG;떨어/VV,28,0.4840090691797503,Dovish
11,24, 차입/NNG;어렵/VA,35,0.6655124701221565,Dovish
4,15, 풀려야/VV,19,0.3872072553438002,Dovish
6,19, 살길/NNG,25,0.458534907643974,Dovish
12,26, 법치/NNG,38,0.6701664034796543,Dovish
7,25, 유동성/NNG;경색/NNG;해소/NNG,32,0.40656761811099024,Dovish
3,15,사방/NNG,18,0.2904054415078502,Dovish
5,19, 둘러봐도/VV,24,0.38211242303664494,Dovish
4,18, 제조업/NNG;경기/NNG;최악/NNG,22,0.32267271278650017,Dovish
6,16, 거시/NNG;지표/NNG;부진/NNG,22,0.5445102028272191,Dovish
2,14, 민간/NNG;투자/NNG;늘/VV,16,0.20743245821989298,Dovish
1,15, 위축/NNG;일시적/VAX,16,0.09680181383595005,Dovish
4,17, 판상/NNG,21,0.3416534605974707,Dovish
2,14, 조성공사/NNG,16,0.20743245821989298,Dovish
16,41,비니/NNG,57,0.5666447639177564,Dovish
11,29, 대내외/NNG;불확실성/NNG;확대/NNG,40,0.5507689407907503,Dovish
3,13, 악연/NNG,16,0.33508320173982714,Dovish
5,13, 상환/NNG;부담/NNG;높/VV,18,0.5584720028997119,Dovish
17,36, 커피숍/NNG,53,0.6856795146713129,Dovish
14,29, 한식/NNG,43,0.7009786519155004,Dovish
4,16, 이북/NNG,20,0.36300680188481266,Dovish
2,16,사회보험/NNG,18,0.18150340094240633,Dovish
6,14, 실적/NNG;고공행진/NNG,20,0.622297374659679,Dovish
5,13, 경기/NNG;위축/NNG;확장/NNG,18,0.5584720028997119,Dovish
5,25,유리보/NNG,30,0.2904054415078502,Dovish
252,512,당선인/NNG,764,0.7146696412107251,Dovish
7,17, 인유/NNG,24,0.5978935560455738,Dovish
4,14, 엇나가/VV,18,0.41486491643978596,Dovish
7,16,황봉/NNG,23,0.6352619032984222,Dovish
3,14,사용량/NNG,17,0.3111486873298395,Dovish
7,15, 풀어낸/VV,22,0.6776126968516504,Dovish
5,13,지회/NNG,18,0.5584720028997119,Dovish
4,14, 경제/NNG;성장률/NNG;예상/NNG;밑돌/VV,18,0.41486491643978596,Dovish
4,16, 공심/NNG,20,0.36300680188481266,Dovish
3,15,모럴해저드/NNG,18,0.2904054415078502,Dovish
15,32, 가격/NNG;파운드/NNG;오르/VV,47,0.6806377535340238,Dovish
430,837,장순/NNG,1267,0.7459637983773929,Dovish
4,20, 산행/NNG,24,0.29040544150785014,Dovish
5,19, 경제/NNG;가라앉/VV,24,0.38211242303664494,Dovish
19,37,통신요금/NNG,56,0.7456355930606964,Dovish
63,152,메뉴/NNG,215,0.6018270662827159,Dovish
7,18, 콤플렉스/NNG,25,0.5646772473763753,Dovish
2,14, 금리/NNG;주택담보대출/NNG;금리/NNG;상승/NNG,16,0.20743245821989298,Dovish
1,16, 리스회사/NNG,17,0.09075170047120316,Dovish
18,41,채무재조정/NNG,59,0.637475359407476,Dovish
9,20,일전/NNG,29,0.6534122433926629,Dovish
5,16,금융감독체계/NNG,21,0.4537585023560159,Dovish
11,29, 세계/NNG;경기/NNG;침체/NNG;우려/NNG,40,0.5507689407907503,Dovish
28,64, 뒤쪽/NNG,92,0.6352619032984222,Dovish
5,13,히로/NNG,18,0.5584720028997119,Dovish
17,64,측근/NNG,81,0.38569472700261354,Dovish
6,14,남녀/NNG,20,0.622297374659679,Dovish
5,23, cd/NNG;하락/NNG,28,0.3156580885954893,Dovish
7,17, 하락/NNG;속도/NNG;제한/NNG,24,0.5978935560455738,Dovish
5,20, cd/NNG;내리/VV,25,0.3630068018848127,Dovish
12,25, 와트/NNG,37,0.6969730596188405,Dovish
8,28, 고시가격/NNG,36,0.41486491643978596,Dovish
23,44, 따라간/VV,67,0.7590142221227901,Dovish
9,18, 키워나갔/VV,27,0.7260136037696254,Dovish
2,16,지분형주택/NNG,18,0.18150340094240633,Dovish
2,14, 지분형주택/NNG,16,0.20743245821989298,Dovish
9,19, 역외/NNG;환율/NNG;급등/NNG,28,0.687802361465961,Dovish
6,19,만나/NNG,25,0.458534907643974,Dovish
1,16, 먹혔/VV,17,0.09075170047120316,Dovish
3,13, 탁상행정/NNG,16,0.33508320173982714,Dovish
4,13, 경기/NNG;부양책/NNG;지지/NNG,17,0.44677760231976943,Dovish
4,13,펀드판매사/NNG,17,0.44677760231976943,Dovish
5,17,펀드런/NNG,22,0.42706682574683846,Dovish
6,23, 아케이드/NNG,29,0.3787897063145872,Dovish
3,20, 소폭/MAG;금리/NNG;인하/NNG,23,0.21780408113088762,Dovish
15,30, 보행자/NNG,45,0.7260136037696253,Dovish
10,24,만찬/NNG,34,0.6050113364746877,Dovish
37,90,대두가격/NNG,127,0.5969445186550254,Dovish
3,13, 주거권/NNG,16,0.33508320173982714,Dovish
5,20, 차우/NNG,25,0.3630068018848127,Dovish
6,17, 실물/NNG;경제/NNG;부양/NNG,23,0.5124801908962061,Dovish
6,13, 말라붙/VV,19,0.6701664034796543,Dovish
3,20, 산업/NNG;생산/NNG;위축/NNG,23,0.21780408113088762,Dovish
8,17, ecb/NNG;부담/NNG,25,0.6833069211949414,Dovish
1,15, 세구/NNG,16,0.09680181383595005,Dovish
4,14, 글로벌/NNG;경제/NNG;악화/NNG,18,0.41486491643978596,Dovish
6,15, 외국인/NNG;수급/NNG;부담/NNG,21,0.5808108830157004,Dovish
3,18, 금리/NNG;낮/VV;금리/NNG;인하/NNG,21,0.24200453458987514,Dovish
4,12, 금리/NNG;인하/NNG;멈추/VV,16,0.4840090691797502,Dovish
5,14, 소비자/NNG;금리/NNG;인하/NNG,19,0.5185811455497324,Dovish
11,23, 광역경제권/NNG,34,0.6944477949100765,Dovish
1,16, 미국발/NNG;금융위기/NNG;확산/NNG,17,0.09075170047120316,Dovish
5,15, 심각/NNG;경기/NNG;하락/NNG,20,0.48400906917975023,Dovish
10,33, 금리/NNG;인하/NNG;경계/NNG,43,0.44000824470886385,Dovish
5,14, 브렌트유/NNG;가격/NNG;상승/NNG,19,0.5185811455497324,Dovish
8,17, 임금/NNG;상승/NNG;가속/NNG,25,0.6833069211949414,Dovish
4,12, 비판/NNG;자유/NNG;못하/VX,16,0.4840090691797502,Dovish
12,37,옥/NNG,49,0.47092774298570295,Dovish
6,17, 중앙부/NNG,23,0.5124801908962061,Dovish
15,43, 응급실/NNG,58,0.506521118909041,Dovish
9,27, 혼란기/NNG,36,0.4840090691797503,Dovish
7,14, 하락/NNG;꺾/VV,21,0.7260136037696254,Dovish
10,24,개발은행/NNG,34,0.6050113364746877,Dovish
3,13, 동진/NNG,16,0.33508320173982714,Dovish
3,15,선주/NNG,18,0.2904054415078502,Dovish
9,18, 기대/NNG;증시/NNG;오르/VV,27,0.7260136037696254,Dovish
0,21,출품/NNG,21,0.0,Dovish
19,37,州/NNG,56,0.7456355930606964,Dovish
12,25, 이동점/NNG,37,0.6969730596188405,Dovish
16,39,만남/NNG,55,0.5957034697596926,Dovish
2,14, 유동성/NNG;공급/NNG;경기/NNG;부양/NNG,16,0.20743245821989298,Dovish
8,16, 지남/VV,24,0.7260136037696253,Dovish
5,12, 노른자/NNG,17,0.6050113364746877,Dovish
2,25,합참/NNG,27,0.11616217660314006,Dovish
5,26, 동체/NNG,31,0.27923600144985594,Dovish
5,11,인베스트먼츠/NNG,16,0.6600123670632958,Dovish
5,12, 국채/NNG;금리갭/NNG;확대/NNG,17,0.6050113364746877,Dovish
7,29,뱅크런/NNG,36,0.3504893259577502,Dovish
5,12, 원유/NNG;생산/NNG;감산/NNG,17,0.6050113364746877,Dovish
8,27, 현판/NNG,35,0.4302302837153335,Dovish
6,20, gdp/NNG;증가율/NNG;마이너스/NNG,26,0.43560816226177523,Dovish
8,26, 첫차/NNG,34,0.44677760231976943,Dovish
4,20,경차/NNG,24,0.29040544150785014,Dovish
6,30, 교습/NNG,36,0.2904054415078502,Dovish
0,20, 일본식/NNG;장기/NNG;침체/NNG,20,0.0,Dovish
5,11, 도우려고/VV,16,0.6600123670632958,Dovish
102,230, 黑/NNG,332,0.6439425007347982,Dovish
9,25, 자연환경/NNG,34,0.5227297947141304,Dovish
6,18, 부끄러운/VA,24,0.4840090691797503,Dovish
5,22, 편찬/NNG,27,0.3300061835316479,Dovish
2,24, 선진국/NNG;금리/NNG;인하/NNG,26,0.12100226729493754,Dovish
13,98, 금융위기/NNG;해소/NNG,111,0.1926158540613292,Dovish
4,12,지역구/NNG,16,0.4840090691797502,Dovish
5,21, 부동산/NNG;투자/NNG;늘/VV,26,0.34572076369982163,Dovish
6,14, 드레/NNG,20,0.622297374659679,Dovish
5,14,캐쉬백/NNG,19,0.5185811455497324,Dovish
7,14, 소득5분위배율/NNG,21,0.7260136037696254,Dovish
3,19,편하/VA,22,0.229267453821987,Dovish
12,27, 뜯어고치/VV,39,0.6453454255730003,Dovish
5,17, 선제/NNG;금리/NNG;내리/VV,22,0.42706682574683846,Dovish
6,24, 금리/NNG;내리/VV;압박/NNG,30,0.3630068018848127,Dovish
4,33, 한옥/NNG,37,0.17600329788354555,Dovish
5,18, 삼정/NNG,23,0.4033408909831252,Dovish
24,49, 해수부/NNG,73,0.7111969996110616,Dovish
7,19, 은성/NNG,26,0.5349573922513029,Dovish
7,15, 복도/NNG,22,0.6776126968516504,Dovish
35,96, 대두가격/NNG,131,0.5293849194153518,Dovish
44,134, 채권평가이익/NNG,178,0.47678505322184356,Dovish
24,58, 업무지구/NNG,82,0.6008388444990004,Dovish
6,14, 수익/NNG;압박/NNG,20,0.622297374659679,Dovish
7,15, 확대일로/NNG,22,0.6776126968516504,Dovish
7,29, 감봉/NNG,36,0.3504893259577502,Dovish
9,25, 견책/NNG,34,0.5227297947141304,Dovish
19,40,무제한/NNG,59,0.6897129235811441,Dovish
4,19, fed/NNG;경제/NNG;성장률/NNG;전망/NNG;하향/NNG,23,0.30568993842931597,Dovish
6,15, 금융위기/NNG;실물/NNG;경기/NNG;침체/NNG,21,0.5808108830157004,Dovish
8,22, 생계비/NNG;부담/NNG,30,0.5280098936506367,Dovish
33,67, gdp/NNG;성장률/NNG;마이너스/NNG,100,0.7151775798327653,Dovish
8,18, 낮/VA;실업률/NNG;높/VA,26,0.6453454255730003,Dovish
8,18,쑹/NNG,26,0.6453454255730003,Dovish
4,14, 가격/NNG;전세가격/NNG;상승/NNG,18,0.41486491643978596,Dovish
2,14,보건소/NNG,16,0.20743245821989298,Dovish
6,17, 김성/NNG,23,0.5124801908962061,Dovish
7,16, 하락/NNG;위험/NNG;방어/NNG,23,0.6352619032984222,Dovish
3,16, 경기/NNG;부진/NNG;우려/NNG;크/VV,19,0.27225510141360953,Dovish
3,23, 우려/NNG;크/VV;금리/NNG;인하/NNG,26,0.1893948531572936,Dovish
5,17, 테크노폴리스/NNG,22,0.42706682574683846,Dovish
10,24, 소비자/NNG;태도/NNG;지수/NNG;최저/NNG,34,0.6050113364746877,Dovish
5,12,각의/NNG,17,0.6050113364746877,Dovish
4,15, 농자/NNG,19,0.3872072553438002,Dovish
6,16, gdp/NNG;확대/NNG,22,0.5445102028272191,Dovish
5,14,출퇴근/NNG,19,0.5185811455497324,Dovish
5,20,입점/NNG,25,0.3630068018848127,Dovish
4,14,계획안/NNG,18,0.41486491643978596,Dovish
13,34, 콜린/NNG,47,0.55518687347089,Dovish
3,14, 선진국/NNG;경제/NNG;침체/NNG,17,0.3111486873298395,Dovish
4,19, 탑승자/NNG,23,0.30568993842931597,Dovish
5,18, 글로벌/NNG;경제/NNG;하방/NNG;위험/NNG,23,0.4033408909831252,Dovish
32,75, 方明/NNG,107,0.6195316085500803,Dovish
2,18,공천/NNG,20,0.16133635639325009,Dovish
3,15, 연쇄/NNG;부도/NNG;우려/NNG,18,0.2904054415078502,Dovish
19,43,발행주관사/NNG,62,0.6415934172847853,Dovish
1,16, 기다린다는/VV,17,0.09075170047120316,Dovish
23,46,반군/NNG,69,0.7260136037696253,Dovish
5,14, 부울/VV,19,0.5185811455497324,Dovish
17,45, 세계/NNG;경제/NNG;회복/NNG;지연/NNG,62,0.5485436117370504,Dovish
8,43, 서부텍사스산원유/NNG;내리/VV,51,0.2701445967514885,Dovish
4,19, 미연방수사국/NNG,23,0.30568993842931597,Dovish
6,18, 감분/NNG,24,0.4840090691797503,Dovish
8,21, 소비/NNG;투자/NNG;늘/VV,29,0.5531532219197145,Dovish
4,16,황이/NNG,20,0.36300680188481266,Dovish
20,92, 국채/NNG;수익률/NNG;마이너스/NNG,112,0.3156580885954893,Dovish
6,14,이머징채권/NNG,20,0.622297374659679,Dovish
2,16, crs/NNG;하락/NNG;압력/NNG,18,0.18150340094240633,Dovish
6,19, cds/NNG;급등/NNG,25,0.458534907643974,Dovish
4,13, 주택가격/NNG;하락/NNG;막/VV,17,0.44677760231976943,Dovish
107,353, 풀기/NNG,460,0.4401328929368267,Dovish
12,53, 춘/VA,65,0.32876087717869834,Dovish
7,17, 가격/NNG;유가/NNG;상승/NNG,24,0.5978935560455738,Dovish
21,47,증권감독관리위원회/NNG,68,0.6487781140068993,Dovish
5,38,랑화/NNG,43,0.19105621151832247,Dovish
3,20, 방분/NNG,23,0.21780408113088762,Dovish
9,18,최후/NNG,27,0.7260136037696254,Dovish
6,27, 의료인/NNG,33,0.32267271278650017,Dovish
8,19, 가격/NNG;많이/MAG;내리/VV,27,0.6113798768586319,Dovish
8,21,로펌/NNG,29,0.5531532219197145,Dovish
10,33,몰락/NNG,43,0.44000824470886385,Dovish
9,20,김성/NNG,29,0.6534122433926629,Dovish
10,27, 귀향/NNG,37,0.5377878546441669,Dovish
8,18, 영체/NNG,26,0.6453454255730003,Dovish
6,14,엇박자/NNG,20,0.622297374659679,Dovish
4,14, 엠파이어스테이트/NNG;제조업/NNG;지수/NNG;마이너스/NNG,18,0.41486491643978596,Dovish
3,19, 주택차압/NNG;방지/NNG,22,0.229267453821987,Dovish
6,27, 금융위기/NNG;공포/NNG,33,0.32267271278650017,Dovish
54,141, 기준가격/NNG;오르/VV,195,0.556095526291628,Dovish
17,56, 회견/NNG;금리/NNG;인하/NNG,73,0.44079397371727264,Dovish
4,17, 자산/NNG;건전성/NNG;높/VV,21,0.3416534605974707,Dovish
10,29, 판박이/NNG,39,0.5006990370825003,Dovish
13,28, 청두/NNG,41,0.6741554892146522,Dovish
5,18, 하락/NNG;심상/NNG;않/VX,23,0.4033408909831252,Dovish
4,14, 지출/NNG;성장/NNG,18,0.41486491643978596,Dovish
4,25, 금융시장/NNG;변동성/NNG;증폭/NNG,29,0.23232435320628012,Dovish
3,13, 치욕/NNG,16,0.33508320173982714,Dovish
16,36, 저점/NNG;이탈/NNG,52,0.6453454255730003,Dovish
13,36,메가뱅크/NNG,49,0.5243431582780628,Dovish
9,24, 실물/NNG;경제/NNG;살/VV,33,0.5445102028272191,Dovish
4,19, 신용등급/NNG;전망/NNG;안정/NNG;부정적/VAX;낮/VV,23,0.30568993842931597,Dovish
3,13, 발행/NNG;여건/NNG;나쁘/VA,16,0.33508320173982714,Dovish
4,13, 경영비/NNG,17,0.44677760231976943,Dovish
0,19, 해갈/VV,19,0.0,Dovish
3,17, 금리/NNG;인하/NNG;종결/NNG,20,0.25624009544810306,Dovish
2,19, 꽃샘추위/NNG,21,0.15284496921465798,Dovish
11,47, 미네르바/NNG,58,0.3398361549559949,Dovish
144,293, 만수/NNG,437,0.7136242931250926,Dovish
3,13, 펀더멘털/NNG;건전/NNG,16,0.33508320173982714,Dovish
2,17, 상호대출/NNG,19,0.17082673029873535,Dovish
2,21, 금리/NNG;인하/NNG;원화/NNG;약세/NNG,23,0.13828830547992862,Dovish
4,15, 닥쳐오/VV,19,0.3872072553438002,Dovish
6,12,실천/NNG,18,0.7260136037696254,Dovish
5,18,바깥/NNG,23,0.4033408909831252,Dovish
11,51,고액자산가/NNG,62,0.3131823388810148,Dovish
5,12,식/NNG,17,0.6050113364746877,Dovish
2,14, 예금보장한도/NNG,16,0.20743245821989298,Dovish
3,14, 의뢰서/NNG,17,0.3111486873298395,Dovish
6,12, 돌아와야/VV,18,0.7260136037696254,Dovish
6,18, 기업/NNG;실적/NNG;불안/NNG,24,0.4840090691797503,Dovish
8,17,기류/NNG,25,0.6833069211949414,Dovish
5,11,희망자/NNG,16,0.6600123670632958,Dovish
14,30,법상/NNG,44,0.6776126968516504,Dovish
6,14, 수입/NNG;반대/NNG,20,0.622297374659679,Dovish
8,23,임정/NNG,31,0.5050529417527828,Dovish
117,253, bei/NNG,370,0.6714908430122227,Dovish
5,11, bei/NNG;확대/NNG,16,0.6600123670632958,Dovish
4,17, bei/NNG;오르/VV,21,0.3416534605974707,Dovish
3,17, 금융시장/NNG;트리플강세/NNG,20,0.25624009544810306,Dovish
7,15, 소비/NNG;투자/NNG;내수/NNG;부진/NNG,22,0.6776126968516504,Dovish
11,25, 국채/NNG;일드커브/NNG;플래트닝/NNG,36,0.6388919713172704,Dovish
7,15, 경제/NNG;공포/NNG,22,0.6776126968516504,Dovish
6,15, 기량/NNG,21,0.5808108830157004,Dovish
5,12, 됐으니/VV,17,0.6050113364746877,Dovish
7,16, 경기/NNG;한파/NNG,23,0.6352619032984222,Dovish
14,37,白/NNG,51,0.5494157001499868,Dovish
7,37, 하락/NNG;최대/NNG;하락/NNG,44,0.2747078500749934,Dovish
4,29, 경기/NNG;부양책/NNG;쏟/VV,33,0.2002796148330001,Dovish
3,18,귀속/NNG,21,0.24200453458987514,Dovish
14,28,대검찰청/NNG,42,0.7260136037696254,Dovish
6,22, 엥겔계수/NNG,28,0.3960074202379775,Dovish
6,15, 부동산/NNG;악영향/NNG,21,0.5808108830157004,Dovish
7,28,모하메드/NNG,35,0.3630068018848127,Dovish
6,22,잰/VA,28,0.3960074202379775,Dovish
4,19, 방임/NNG,23,0.30568993842931597,Dovish
6,13, 가격/NNG;강하/VA;상승/NNG,19,0.6701664034796543,Dovish
4,13, 스타급/NNG,17,0.44677760231976943,Dovish
5,18, 경제부처수장/NNG,23,0.4033408909831252,Dovish
6,14,게시/NNG,20,0.622297374659679,Dovish
3,15,수보/NNG,18,0.2904054415078502,Dovish
26,61, 스탁론/NNG,87,0.6188968425577135,Dovish
9,18,당정청/NNG,27,0.7260136037696254,Dovish
3,14,뷔/NNG,17,0.3111486873298395,Dovish
4,16, 지표/NNG;물가/NNG;상승/NNG;압력/NNG,20,0.36300680188481266,Dovish
9,18, 억눌린/VV,27,0.7260136037696254,Dovish
7,15, 구루/NNG,22,0.6776126968516504,Dovish
12,27, 유로존/NNG;경제/NNG;지표/NNG;부진/NNG,39,0.6453454255730003,Dovish
2,18, 입식/NNG,20,0.16133635639325009,Dovish
6,19, 쪼그라드/VV,25,0.458534907643974,Dovish
7,15, 일자리/NNG;성장/NNG,22,0.6776126968516504,Dovish
6,25, 페퍼/NNG,31,0.34848652980942024,Dovish
5,13, 통화/NNG;금리/NNG;인하/NNG,18,0.5584720028997119,Dovish
8,17, 세팅/NNG,25,0.6833069211949414,Dovish
8,23,경제난/NNG,31,0.5050529417527828,Dovish
6,15, 신흥시장/NNG;충격/NNG,21,0.5808108830157004,Dovish
7,23, 자본/NNG;유입/NNG;증가/NNG,30,0.441921324033685,Dovish
0,23, 세일앤드리스/NNG,23,0.0,Dovish
18,40, 유동외채/NNG,58,0.6534122433926629,Dovish
3,14, 상훈/NNG,17,0.3111486873298395,Dovish
10,29, gdp/NNG;마이너스/NNG,39,0.5006990370825003,Dovish
6,13, 부실/NNG;높/VA,19,0.6701664034796543,Dovish
5,15,순이자/NNG,20,0.48400906917975023,Dovish
5,16, gdp/NNG;갭/NNG;확대/NNG,21,0.4537585023560159,Dovish
7,20, 금융위기/NNG;넘/VV,27,0.5082095226387378,Dovish
24,67, fx마진거래/NNG,91,0.5201291489692839,Dovish
7,22, 해외/NNG;수요/NNG;감소/NNG,29,0.4620086569443071,Dovish
13,30,통화청/NNG,43,0.6292117899336753,Dovish
10,25, 장학기금/NNG,35,0.5808108830157004,Dovish
65,191,산유량/NNG,256,0.49414538476466646,Dovish
5,11, 자금/NNG;많이/MAG;풀/VV,16,0.6600123670632958,Dovish
14,30, 국채선물/NNG;계약/NNG;넘/VV,44,0.6776126968516504,Dovish
19,47, 양파/NNG,66,0.5869897221967184,Dovish
5,11, 총의/NNG,16,0.6600123670632958,Dovish
6,19, 도축장/NNG,25,0.458534907643974,Dovish
4,14,내세운/VV,18,0.41486491643978596,Dovish
3,17, 추후/NNG;금리/NNG;인하/NNG,20,0.25624009544810306,Dovish
8,20, 조세회피처/NNG,28,0.5808108830157003,Dovish
5,19, 산지/VV,24,0.38211242303664494,Dovish
5,13, 냉해/NNG,18,0.5584720028997119,Dovish
7,14, 成都/NNG,21,0.7260136037696254,Dovish
4,15, 사전수요조사/NNG,19,0.3872072553438002,Dovish
9,25,지원금액/NNG,34,0.5227297947141304,Dovish
21,45,연다/VV,66,0.6776126968516504,Dovish
4,18, 신흥국/NNG;성장률/NNG;둔화/NNG,22,0.32267271278650017,Dovish
4,13, 금리/NNG;인하/NNG;경제/NNG;회복/NNG,17,0.44677760231976943,Dovish
6,12, 여전업계/NNG,18,0.7260136037696254,Dovish
4,12, 가로막힌/VV,16,0.4840090691797502,Dovish
4,12, 지표/NNG;영향/NNG;하락/NNG,16,0.4840090691797502,Dovish
9,26, gdp/NNG;전망/NNG;하향/NNG,35,0.5026248026097407,Dovish
4,12, 여겨집니다/VV,16,0.4840090691797502,Dovish
5,16, 국민참여재판/NNG,21,0.4537585023560159,Dovish
4,13, 시브/NNG,17,0.44677760231976943,Dovish
4,21,청두/NNG,25,0.27657661095985725,Dovish
6,13, 정치/NNG;불안/NNG;우려/NNG,19,0.6701664034796543,Dovish
7,17, 바트화채권/NNG,24,0.5978935560455738,Dovish
4,19, 재정/NNG;어렵/VA,23,0.30568993842931597,Dovish
12,31, 인플레이션/NNG;목표/NNG;상향/NNG,43,0.5620750480797101,Dovish
21,52, 달러원/NNG;넘/VV,73,0.5863956030446974,Dovish
6,15, 위험자산/NNG;투자심리/NNG;회복/NNG,21,0.5808108830157004,Dovish
17,36,측은/NNG,53,0.6856795146713129,Dovish
19,64,키코/NNG,83,0.4310705772382151,Dovish
6,13, 성현/NNG,19,0.6701664034796543,Dovish
8,17,특강/NNG,25,0.6833069211949414,Dovish
4,16,승인액/NNG,20,0.36300680188481266,Dovish
7,18, 공공청사/NNG,25,0.5646772473763753,Dovish
5,12,수행/NNG,17,0.6050113364746877,Dovish
0,19, 사용후핵연료/NNG,19,0.0,Dovish
2,15,구제금융설/NNG,17,0.1936036276719001,Dovish
5,19, 어렵/VA;전망/NNG;확산/NNG,24,0.38211242303664494,Dovish
2,16, 인플레이션/NNG;목표/NNG;하회/NNG,18,0.18150340094240633,Dovish
7,25,영동/NNG,32,0.40656761811099024,Dovish
4,16,변액연금보험/NNG,20,0.36300680188481266,Dovish
8,16,원면/NNG,24,0.7260136037696253,Dovish
4,15, 구매/NNG;촉진/NNG,19,0.3872072553438002,Dovish
3,16, 얌체/NNG,19,0.27225510141360953,Dovish
16,43,영국채/NNG,59,0.540289193502977,Dovish
1,26, 송전탑/NNG,27,0.05584720028997118,Dovish
9,32, 캠핑/NNG,41,0.4083826521204143,Dovish
5,16,상방/NNG,21,0.4537585023560159,Dovish
6,17, 재고/NNG;증가/NNG;우려/NNG,23,0.5124801908962061,Dovish
10,22, 배구/NNG,32,0.6600123670632958,Dovish
5,13, 대내외/NNG;경제/NNG;여건/NNG;악화/NNG,18,0.5584720028997119,Dovish
7,14, 매입외환/NNG,21,0.7260136037696254,Dovish
11,30, 준가/NNG,41,0.5324099760977252,Dovish
104,215,카드론/NNG,319,0.7023759515538702,Dovish
5,12, 강전/NNG,17,0.6050113364746877,Dovish
5,20, 소득/NNG;증가율/NNG;웃돌/VV,25,0.3630068018848127,Dovish
3,15, 만리장성/NNG,18,0.2904054415078502,Dovish
5,11, 비올/NNG,16,0.6600123670632958,Dovish
23,65, 채권펀드/NNG;상승/NNG,88,0.5137942426677349,Dovish
3,21, 겸해/VV,24,0.20743245821989298,Dovish
7,15,입시/NNG,22,0.6776126968516504,Dovish
22,60, 최고운용책임자/NNG,82,0.5324099760977252,Dovish
3,15, 이익/NNG;증가/NNG;둔화/NNG,18,0.2904054415078502,Dovish
4,13, 입장객/NNG,17,0.44677760231976943,Dovish
9,26,나비/NNG,35,0.5026248026097407,Dovish
4,13, 최대한/NNG;확대/NNG,17,0.44677760231976943,Dovish
4,18, 지수/NNG;국제/NNG;유가/NNG;하락/NNG,22,0.32267271278650017,Dovish
4,13, 입전/NNG,17,0.44677760231976943,Dovish
17,34,민생안정/NNG,51,0.7260136037696254,Dovish
6,14, 원해/VV,20,0.622297374659679,Dovish
9,22, 트래픽/NNG,31,0.5940111303569663,Dovish
4,14, 부양책/NNG;반대/NNG,18,0.41486491643978596,Dovish
8,17, 가격/NNG;하단/NNG,25,0.6833069211949414,Dovish
20,57, 딜미스/NNG,77,0.5094832307155266,Dovish
2,17,형편/NNG,19,0.17082673029873535,Dovish
16,38, 진흥공단/NNG,54,0.6113798768586319,Dovish
17,42, 대출/NNG;문턱/NNG;높/VA,59,0.5877252982896968,Dovish
5,11, 자본비율/NNG;낮/VA,16,0.6600123670632958,Dovish
7,22, 키코손실/NNG,29,0.4620086569443071,Dovish
48,108, 외환시장/NNG;원달러/NNG;오르/VV,156,0.6453454255730003,Dovish
4,13, 국제/NNG;금융시장/NNG;악화/NNG,17,0.44677760231976943,Dovish
19,41,예탁/NNG,60,0.6728906571523358,Dovish
6,17, 복장/NNG,23,0.5124801908962061,Dovish
12,41, 이호/NNG,53,0.42498357293831734,Dovish
29,74,패니메이/NNG,103,0.5690376894410577,Dovish
4,20,차액결제선물환/NNG,24,0.29040544150785014,Dovish
71,141,집주인/NNG,212,0.7311626364204739,Dovish
9,20, 미뤄뒀/VV,29,0.6534122433926629,Dovish
3,13, 아낌없/VA,16,0.33508320173982714,Dovish
8,17,신작/NNG,25,0.6833069211949414,Dovish
3,31, fed/NNG;서둘/VV;금리/NNG;인상/NNG,34,0.14051876201992752,Dovish
8,25, 번호판/NNG,33,0.46464870641256023,Dovish
7,17, 시중/NNG;금리/NNG;떨어/VV,24,0.5978935560455738,Dovish
8,42, 외화/NNG;유동성/NNG;우려/NNG,50,0.27657661095985725,Dovish
8,21, 다층/NNG,29,0.5531532219197145,Dovish
2,16, 자산/NNG;비중/NNG;줄/VV,18,0.18150340094240633,Dovish
12,23,하반/NNG,35,0.7575794126291744,Dovish
38,101,배민/NNG,139,0.5463072662028865,Dovish
14,30, 위기감/NNG;크/VV,44,0.6776126968516504,Dovish
5,11, 낭설/NNG,16,0.6600123670632958,Dovish
8,42, 연보수/NNG,50,0.27657661095985725,Dovish
7,19,유연탄/NNG,26,0.5349573922513029,Dovish
4,12,페니메이/NNG,16,0.4840090691797502,Dovish
9,22, 누진제/NNG,31,0.5940111303569663,Dovish
8,29, opec/NNG;생산/NNG;증가/NNG,37,0.4005592296660002,Dovish
4,13,계약직/NNG,17,0.44677760231976943,Dovish
4,12, 경제/NNG;유가/NNG;하락/NNG,16,0.4840090691797502,Dovish
3,26, 겹친다/VV,29,0.16754160086991357,Dovish
1,21,갤러리/NNG,22,0.06914415273996431,Dovish
4,14,취업난/NNG,18,0.41486491643978596,Dovish
16,48,국가정책조정회의/NNG,64,0.4840090691797502,Dovish
4,17, 병동/NNG,21,0.3416534605974707,Dovish
8,28, 탄저균/NNG,36,0.41486491643978596,Dovish
10,24,엄/NNG,34,0.6050113364746877,Dovish
15,41, 병우/NNG,56,0.5312294661728967,Dovish
4,12,작심/NNG,16,0.4840090691797502,Dovish
19,38, 금/NNG;수요/NNG;감소/NNG,57,0.7260136037696254,Dovish
10,28, 품안/NNG,38,0.5185811455497324,Dovish
3,13, 잡힌다면/VV,16,0.33508320173982714,Dovish
5,11, 대출/NNG;이자/NNG;높/VA,16,0.6600123670632958,Dovish
8,19, 순이자마진/NNG;부정적/VAX,27,0.6113798768586319,Dovish
10,32, 금리/NNG;인상/NNG;취약/NNG,42,0.4537585023560159,Dovish
8,43, 분수/NNG,51,0.2701445967514885,Dovish
5,15, 단기/NNG;유가/NNG;하락/NNG,20,0.48400906917975023,Dovish
6,30, 다달/NNG,36,0.2904054415078502,Dovish
5,16, 미/NNG;도매/NNG;재고/NNG;증가/NNG,21,0.4537585023560159,Dovish
8,21, 요충지/NNG,29,0.5531532219197145,Dovish
17,46, 크레딧/NNG;스프레드/NNG;확대/NNG,63,0.5366187506123319,Dovish
4,18,좁혀/VV,22,0.32267271278650017,Dovish
5,12, 완화/NNG;기대/NNG;강세/NNG,17,0.6050113364746877,Dovish
4,16, 개인/NNG;금리/NNG;인상/NNG,20,0.36300680188481266,Dovish
4,12, 물가채/NNG;시장/NNG;활성화/NNG,16,0.4840090691797502,Dovish
4,14, 완화/NNG;경제/NNG;성장/NNG,18,0.41486491643978596,Dovish
19,42, 저탄소/NNG;녹색성장/NNG,61,0.6568694510296611,Dovish
8,20, 뒷걸음쳤/VV,28,0.5808108830157003,Dovish
4,28, 금융위기/NNG;위험/NNG,32,0.20743245821989298,Dovish
6,27, 금융시장/NNG;변동성/NNG;높/VV,33,0.32267271278650017,Dovish
7,16,일환/NNG,23,0.6352619032984222,Dovish
6,12, 생계/NNG;어렵/VA,18,0.7260136037696254,Dovish
3,14, 지표/NNG;호조/NNG;혼조/NNG,17,0.3111486873298395,Dovish
6,12,유동외채/NNG,18,0.7260136037696254,Dovish
7,28, 흑자율/NNG,35,0.3630068018848127,Dovish
3,13,항간/NNG,16,0.33508320173982714,Dovish
10,22, 금융시장/NNG;모니터링/NNG;강화/NNG,32,0.6600123670632958,Dovish
5,11, 수출/NNG;가격/NNG;내리/VV,16,0.6600123670632958,Dovish
3,17, 배드민턴/NNG,20,0.25624009544810306,Dovish
7,17, 불안/NNG;경기/NNG;침체/NNG,24,0.5978935560455738,Dovish
45,92, cds/NNG;프리미엄/NNG;오르/VV,137,0.7102306993398508,Dovish
8,43,재정난/NNG,51,0.2701445967514885,Dovish
5,12, 부채/NNG;질/NNG;악화/NNG,17,0.6050113364746877,Dovish
25,86, 온렌딩/NNG,111,0.4221009324242008,Dovish
9,20, 주택/NNG;지표/NNG;긍정적/VAX,29,0.6534122433926629,Dovish
14,39, 원달러/NNG;넘/VV,53,0.5212405360397311,Dovish
14,33, 바꿀지/VV,47,0.6160115425924094,Dovish
10,41, 구제금융계획/NNG,51,0.35415297744859775,Dovish
12,36, 유로존/NNG;침체/NNG,48,0.4840090691797503,Dovish
4,15,중계/NNG,19,0.3872072553438002,Dovish
6,15, 생존/NNG;어렵/VA,21,0.5808108830157004,Dovish
1,22, 유가/NNG;낙폭/NNG;축소/NNG,23,0.06600123670632958,Dovish
13,29, 대출/NNG;문턱/NNG;높/VV,42,0.6509087482072504,Dovish
13,27, 부검/NNG,40,0.6991242110374171,Dovish
8,18, irs/NNG;커브/NNG;스티프닝/NNG,26,0.6453454255730003,Dovish
65,199, crs/NNG;내리/VV,264,0.47428024366859944,Dovish
4,14, 기업/NNG;자금/NNG;조달/NNG;여건/NNG;악화/NNG,18,0.41486491643978596,Dovish
5,47, 사저/NNG,52,0.15447097952545222,Dovish
8,19, 登/NNG,27,0.6113798768586319,Dovish
5,16, 상장계열사/NNG,21,0.4537585023560159,Dovish
24,46,처분가능/NNG,70,0.7575794126291744,Dovish
6,30, 가계/NNG;부실/NNG;위험/NNG,36,0.2904054415078502,Dovish
77,177,리먼브라더스사태/NNG,254,0.6316728529973012,Dovish
1,15, 대출/NNG;금리/NNG;지준율/NNG;인하/NNG,16,0.09680181383595005,Dovish
5,13, 금융위기/NNG;끝/NNG,18,0.5584720028997119,Dovish
2,27, 미국발/NNG;금융/NNG;충격/NNG,29,0.10755757092883338,Dovish
5,12, 대외/NNG;불확실성/NNG;줄/VV,17,0.6050113364746877,Dovish
5,13, 위험자산/NNG;회피/NNG;확산/NNG,18,0.5584720028997119,Dovish
7,32, 물가/NNG;안정/NNG;촉진/NNG,39,0.3176309516492111,Dovish
5,11, 채권/NNG;부도/NNG;위험/NNG,16,0.6600123670632958,Dovish
4,13, 금융위기/NNG;악화/NNG,17,0.44677760231976943,Dovish
9,24, cds/NNG;상승/NNG,33,0.5445102028272191,Dovish
3,14, 경색/NNG;우려/NNG;크/VV,17,0.3111486873298395,Dovish
15,54, 바주카포/NNG,69,0.4033408909831252,Dovish
5,11, 관리사무소/NNG,16,0.6600123670632958,Dovish
8,24, 부양책/NNG;쏟/VV,32,0.4840090691797502,Dovish
6,21,본연/NNG,27,0.41486491643978596,Dovish
18,40, 레몬/NNG,58,0.6534122433926629,Dovish
6,27, cds/NNG;프리미엄/NNG;떨어/VV,33,0.32267271278650017,Dovish
11,26,아소/NNG,37,0.614319203189683,Dovish
5,11, 破/NNG,16,0.6600123670632958,Dovish
1,24, 글로벌/NNG;금융위기/NNG;해소/NNG,25,0.06050113364746877,Dovish
11,95,구제금융안/NNG,106,0.16812946613612376,Dovish
9,18,시너/NNG,27,0.7260136037696254,Dovish
4,15, 유동성/NNG;우려/NNG;크/VV,19,0.3872072553438002,Dovish
0,101,구제금융법안/NNG,101,0.0,Dovish
3,14, 중소기업/NNG;흑자/NNG;도산/NNG,17,0.3111486873298395,Dovish
5,17,기업회생절차/NNG,22,0.42706682574683846,Dovish
0,16,협상안/NNG,16,0.0,Dovish
3,16, cp/NNG;금리/NNG;하락/NNG,19,0.27225510141360953,Dovish
5,12, 고용/NNG;상승/NNG,17,0.6050113364746877,Dovish
1,22, 습지/NNG,23,0.06600123670632958,Dovish
8,17, 경비정/NNG,25,0.6833069211949414,Dovish
5,24, 앞당긴다고/VV,29,0.30250566823734387,Dovish
4,22, 이자/NNG;유예/NNG,26,0.26400494682531833,Dovish
5,13,아기/NNG,18,0.5584720028997119,Dovish
5,18,고졸/NNG,23,0.4033408909831252,Dovish
6,12, 세계/NNG;경기/NNG;좋/VA,18,0.7260136037696254,Dovish
7,14, 채권/NNG;밀리/VV,21,0.7260136037696254,Dovish
4,37, 총액/NNG;한도/NNG;대출/NNG;늘/VV,41,0.15697591432856764,Dovish
3,15, 환어음/NNG,18,0.2904054415078502,Dovish
0,19, 환가료율/NNG,19,0.0,Dovish
2,15, 어음교환소/NNG,17,0.1936036276719001,Dovish
8,25, 부실/NNG;늘/VV,33,0.46464870641256023,Dovish
5,13,조명/NNG,18,0.5584720028997119,Dovish
6,15, 해약금/NNG,21,0.5808108830157004,Dovish
7,21, 허용량/NNG,28,0.4840090691797503,Dovish
2,31, 금융위기/NNG;실물/NNG;경제/NNG;침체/NNG,33,0.09367917467995167,Dovish
0,19, 벽제/NNG,19,0.0,Dovish
3,15, 외화/NNG;풀/VV,18,0.2904054415078502,Dovish
2,16, 실물/NNG;경제/NNG;침체/NNG;우려/NNG,18,0.18150340094240633,Dovish
3,14,자구노력/NNG,17,0.3111486873298395,Dovish
4,19, 차보/NNG,23,0.30568993842931597,Dovish
8,16, 글로벌/NNG;금융위기/NNG;확산/NNG,24,0.7260136037696253,Dovish
4,16, 대출/NNG;피해/NNG,20,0.36300680188481266,Dovish
5,14, crs/NNG;금리/NNG;소폭/MAG;오르/VV,19,0.5185811455497324,Dovish
7,19, 글로벌/NNG;금융시장/NNG;흔들/VV,26,0.5349573922513029,Dovish
1,15, 토지은행/NNG,16,0.09680181383595005,Dovish
23,50,麻/NNG,73,0.6679325154680553,Dovish
2,26, 궂/VA,28,0.11169440057994236,Dovish
8,18, 최루탄/NNG,26,0.6453454255730003,Dovish
8,27, 글로벌/NNG;금융위기/NNG;경기/NNG;침체/NNG,35,0.4302302837153335,Dovish
7,17, 마이너스/NNG;증가/NNG,24,0.5978935560455738,Dovish
5,15, 공무원연금법/NNG,20,0.48400906917975023,Dovish
7,14, 은행/NNG;대출/NNG;금리/NNG;높/VA,21,0.7260136037696254,Dovish
3,19,문망/NNG,22,0.229267453821987,Dovish
5,21, 인하/NNG;결정/NNG;내리/VV,26,0.34572076369982163,Dovish
39,96, 준호/NNG,135,0.5898860530628206,Dovish
4,12, 안전자산/NNG;확보/NNG,16,0.4840090691797502,Dovish
27,61, 의사봉/NNG,88,0.6427005672714716,Dovish
6,15, 금리/NNG;대출/NNG;금리/NNG;내리/VV,21,0.5808108830157004,Dovish
5,14,매출채권보험/NNG,19,0.5185811455497324,Dovish
5,14,웃돈/NNG,19,0.5185811455497324,Dovish
3,16, 영빈관/NNG,19,0.27225510141360953,Dovish
10,20, 불기소/NNG,30,0.7260136037696254,Dovish
1,18, 금리/NNG;인하/NNG;소식/NNG;상승/NNG,19,0.08066817819662504,Dovish
5,18, 대손충당금/NNG;늘/VV,23,0.4033408909831252,Dovish
5,26,국과/NNG,31,0.27923600144985594,Dovish
112,269,사드/NNG,381,0.604561513919688,Dovish
8,30,대법/NNG,38,0.3872072553438002,Dovish
4,19, 금리/NNG;제로/NNG;떨어/VV,23,0.30568993842931597,Dovish
8,24, 숙청/NNG,32,0.4840090691797502,Dovish
5,13,광모/NNG,18,0.5584720028997119,Dovish
7,14, 금융위기/NNG;타격/NNG,21,0.7260136037696254,Dovish
2,17, 星/NNG,19,0.17082673029873535,Dovish
7,14, 門/NNG,21,0.7260136037696254,Dovish
14,29, 농민공/NNG,43,0.7009786519155004,Dovish
6,17, 지수/NNG;넘/VV;하락/NNG,23,0.5124801908962061,Dovish
32,73, 금융위기/NNG;터지/VV,105,0.6365050772774797,Dovish
4,22, 실물/NNG;침체/NNG,26,0.26400494682531833,Dovish
3,15, 재정/NNG;건전성/NNG;해치/VV,18,0.2904054415078502,Dovish
6,21, 일생일대/NNG,27,0.41486491643978596,Dovish
2,15,경인/NNG,17,0.1936036276719001,Dovish
12,27,교육감/NNG,39,0.6453454255730003,Dovish
15,36, 신흥국/NNG;경기/NNG;침체/NNG,51,0.6050113364746877,Dovish
7,26, 기술적/VAX;침체/NNG;빠지/VV,33,0.3909304020297983,Dovish
6,13, 키블/NNG,19,0.6701664034796543,Dovish
14,53, 쌀직불금/NNG,67,0.38355435670848137,Dovish
4,13,꽁꽁/MAG,17,0.44677760231976943,Dovish
4,25, 대출/NNG;금리/NNG;인하/NNG;압박/NNG,29,0.23232435320628012,Dovish
3,45, cd/NNG;금리/NNG;인하/NNG,48,0.09680181383595006,Dovish
13,41, 엠파이어스테이트/NNG;지수/NNG;마이너스/NNG,54,0.4603988706831771,Dovish
1,15, 실물/NNG;경제/NNG;지표/NNG;부진/NNG,16,0.09680181383595005,Dovish
10,20,대훈/NNG,30,0.7260136037696254,Dovish
4,13, 은행/NNG;대출/NNG;금리/NNG;하락/NNG,17,0.44677760231976943,Dovish
5,21, 돈줄/NNG;풀/VV,26,0.34572076369982163,Dovish
4,17, rp/NNG;금리/NNG;내리/VV,21,0.3416534605974707,Dovish
1,16, 산업/NNG;생산/NNG;급감/NNG,17,0.09075170047120316,Dovish
18,49, 유가/NNG;opec/NNG;감산/NNG,67,0.5333977497082962,Dovish
4,16, 부동산/NNG;경매/NNG;전문업체/NNG;지지/NNG,20,0.36300680188481266,Dovish
6,20,깡통/NNG,26,0.43560816226177523,Dovish
2,18, rp/NNG;금리/NNG;인하/NNG,20,0.16133635639325009,Dovish
6,20, 경제/NNG;심리/NNG;회복/NNG,26,0.43560816226177523,Dovish
6,25, 대출/NNG;부담/NNG;완화/NNG,31,0.34848652980942024,Dovish
6,13, 역외/NNG;환율/NNG;급락/NNG,19,0.6701664034796543,Dovish
14,35, 강력/NNG;완화/NNG,49,0.5808108830157003,Dovish
1,16, 회복/NNG;매우/MAG;미약/NNG,17,0.09075170047120316,Dovish
5,14, cd/NNG;금리/NNG;낮/VV,19,0.5185811455497324,Dovish
2,14, 금리/NNG;낮/VA;내리/VV,16,0.20743245821989298,Dovish
1,15, d의공포/NNG,16,0.09680181383595005,Dovish
7,20,초과지준/NNG,27,0.5082095226387378,Dovish
4,12, 영리기업/NNG,16,0.4840090691797502,Dovish
3,14, 금리/NNG;인하/NNG;여력/NNG;없/VA,17,0.3111486873298395,Dovish
6,19, 빗/VV,25,0.458534907643974,Dovish
8,16, 증거금률/NNG,24,0.7260136037696253,Dovish
10,21, 회견장/NNG,31,0.6914415273996433,Dovish
36,77, 생활권/NNG,113,0.6788698632651042,Dovish
28,84, 매입기금/NNG,112,0.4840090691797503,Dovish
5,27,이행/NNG,32,0.26889392732208345,Dovish
6,14, 모국/NNG,20,0.622297374659679,Dovish
11,23,보선/NNG,34,0.6944477949100765,Dovish
4,12, 외화예금/NNG;늘/VV,16,0.4840090691797502,Dovish
5,14, 경제/NNG;성장률/NNG;전망/NNG;마이너스/NNG,19,0.5185811455497324,Dovish
5,17, 은행/NNG;금리/NNG;떨어/VV,22,0.42706682574683846,Dovish
7,25, cds/NNG;프리미엄/NNG;안정/NNG,32,0.40656761811099024,Dovish
8,18, 강력/NNG;경제/NNG;회복/NNG,26,0.6453454255730003,Dovish
4,14, 우남/NNG,18,0.41486491643978596,Dovish
3,15,입주민/NNG,18,0.2904054415078502,Dovish
28,73,채권은행/NNG,101,0.5569419426177948,Dovish
3,13, 급감/NNG;감소/NNG,16,0.33508320173982714,Dovish
6,13, 경제/NNG;성장률/NNG;우려/NNG,19,0.6701664034796543,Dovish
6,42, cds/NNG;프리미엄/NNG;낮/VA,48,0.20743245821989298,Dovish
1,26,교섭단체/NNG,27,0.05584720028997118,Dovish
7,17, 금리/NNG;인하/NNG;유동성/NNG;확대/NNG,24,0.5978935560455738,Dovish
24,59, 부도났/VV,83,0.5906551352702037,Dovish
5,15, 경제/NNG;활동/NNG;침체/NNG,20,0.48400906917975023,Dovish
9,18, 취약계층/NNG;지원/NNG;강화/NNG,27,0.7260136037696254,Dovish
4,14, 크리스털/NNG,18,0.41486491643978596,Dovish
12,27, 자금세탁/NNG,39,0.6453454255730003,Dovish
5,20,분양면적/NNG,25,0.3630068018848127,Dovish
20,43,보호무역/NNG,63,0.6753614918787213,Dovish
5,19, cds/NNG;프리미엄/NNG;내리/VV,24,0.38211242303664494,Dovish
10,31, 연회장/NNG,41,0.46839587339975836,Dovish
5,35, 우월주의/NNG,40,0.20743245821989298,Dovish
12,34,강송/NNG,46,0.5124801908962061,Dovish
10,35, 義/NNG,45,0.41486491643978596,Dovish
4,17, 경기/NNG;회복/NNG;줄/VV,21,0.3416534605974707,Dovish
5,11, 커도/VV,16,0.6600123670632958,Dovish
5,13,클/NNG,18,0.5584720028997119,Dovish
6,24, 환은/NNG,30,0.3630068018848127,Dovish
8,25, 세계/NNG;교역/NNG;감소/NNG,33,0.46464870641256023,Dovish
9,26, 낮/VA;수익률/NNG;오르/VV,35,0.5026248026097407,Dovish
4,13, 지급여력비율/NNG;떨어/VV,17,0.44677760231976943,Dovish
5,12, 전망/NNG;안정/NNG;부정적/VAX;내리/VV,17,0.6050113364746877,Dovish
6,15, 은행/NNG;예금/NNG;금리/NNG;내리/VV,21,0.5808108830157004,Dovish
4,23, 상환/NNG;조건/NNG;완화/NNG,27,0.2525264708763914,Dovish
3,23,리마/NNG,26,0.1893948531572936,Dovish
5,38, 세계/NNG;경기/NNG;우려/NNG,43,0.19105621151832247,Dovish
2,25,채권안정펀드/NNG,27,0.11616217660314006,Dovish
8,113,채안펀드/NNG,121,0.10279838637446023,Dovish
6,13, 도화/NNG,19,0.6701664034796543,Dovish
2,16,캠퍼스/NNG,18,0.18150340094240633,Dovish
6,18, 원유/NNG;생산/NNG;감축/NNG,24,0.4840090691797503,Dovish
11,23, 꾸렸/VV,34,0.6944477949100765,Dovish
17,40, 디레버리징/NNG;부채/NNG;축소/NNG,57,0.6171115632041816,Dovish
5,18, 세계/NNG;경기/NNG;부양/NNG,23,0.4033408909831252,Dovish
21,85, 코뮈니케/NNG,106,0.3587361336273443,Dovish
4,12, 우려/NNG;위험자산/NNG;회피/NNG,16,0.4840090691797502,Dovish
5,13, 은행/NNG;지준율/NNG;내리/VV,18,0.5584720028997119,Dovish
11,41, 구민/NNG,52,0.38956827519345755,Dovish
2,15,옥석/NNG,17,0.1936036276719001,Dovish
4,13, 산업/NNG;불황/NNG,17,0.44677760231976943,Dovish
8,17, 올겨울/NNG,25,0.6833069211949414,Dovish
3,24,미네르바/NNG,27,0.18150340094240636,Dovish
95,315, 그림자금융/NNG,410,0.4379129673531074,Dovish
46,89, 외환시장/NNG;원달러/NNG;내리/VV,135,0.7504859724360172,Dovish
38,79, 국채/NNG;금리/NNG;뛰/VV,117,0.6984434669176144,Dovish
4,13, 장문/NNG,17,0.44677760231976943,Dovish
7,15, 디플레이션/NNG;위험/NNG;크/VV,22,0.6776126968516504,Dovish
10,31, ecb/NNG;디플레이션/NNG;우려/NNG,41,0.46839587339975836,Dovish
6,12, 외환시장/NNG;원달러/NNG;급등/NNG,18,0.7260136037696254,Dovish
7,20, 마이너스/NNG;낮/VV,27,0.5082095226387378,Dovish
2,16,비소비지출/NNG,18,0.18150340094240633,Dovish
7,21, 총궐기/NNG,28,0.4840090691797503,Dovish
5,11, 가려서/VV,16,0.6600123670632958,Dovish
2,27, 은행/NNG;지준율/NNG;낮/VV,29,0.10755757092883338,Dovish
7,21, crs/NNG;금리/NNG;소폭/MAG;상승/NNG,28,0.4840090691797503,Dovish
15,30,자이/NNG,45,0.7260136037696253,Dovish
3,13,집무실/NNG,16,0.33508320173982714,Dovish
14,31, 신뉴딜정책/NNG,45,0.6557542227596617,Dovish
22,65,대차대조표/NNG,87,0.49145536255174643,Dovish
7,14, 雅/NNG,21,0.7260136037696254,Dovish
2,17,상용근로자/NNG,19,0.17082673029873535,Dovish
2,15, 금리/NNG;제로/NNG;내리/VV,17,0.1936036276719001,Dovish
4,19,경화/NNG,23,0.30568993842931597,Dovish
9,22, 원/NNG;환율/NNG;오르/VV,31,0.5940111303569663,Dovish
12,32, 중견/NNG;기업/NNG;성장/NNG,44,0.5445102028272191,Dovish
4,14, 인공호흡기/NNG,18,0.41486491643978596,Dovish
5,27, 재투표/NNG,32,0.26889392732208345,Dovish
5,18,조약/NNG,23,0.4033408909831252,Dovish
2,16, rp/NNG;금리/NNG;낮/VV,18,0.18150340094240633,Dovish
3,28,전대미문/NNG,31,0.15557434366491976,Dovish
8,22, 담사/NNG,30,0.5280098936506367,Dovish
1,16, 실세/NNG;금리/NNG;인하/NNG,17,0.09075170047120316,Dovish
25,60, 낙찰/NNG;금리/NNG;최저/NNG,85,0.6050113364746879,Dovish
1,20, 경제/NNG;지표/NNG;부진/NNG;우려/NNG,21,0.07260136037696253,Dovish
17,54,지준부리/NNG,71,0.4571196764475419,Dovish
7,20, 디플레이션/NNG;압력/NNG;높/VA,27,0.5082095226387378,Dovish
4,12, 투자/NNG;소비/NNG;늘/VV;않/VX,16,0.4840090691797502,Dovish
8,25,관심주/NNG,33,0.46464870641256023,Dovish
4,15, 끌어모아/VV,19,0.3872072553438002,Dovish
3,13, 펀드오브헤지펀드/NNG,16,0.33508320173982714,Dovish
4,12,밴/NNG,16,0.4840090691797502,Dovish
8,17, 국채/NNG;불안/NNG,25,0.6833069211949414,Dovish
1,15, 탐지기/NNG,16,0.09680181383595005,Dovish
9,37, 빌더/NNG,46,0.35319580723927724,Dovish
4,33, 유동성함정/NNG;우려/NNG,37,0.17600329788354555,Dovish
4,16, 깡통계좌/NNG,20,0.36300680188481266,Dovish
2,19,다룰/VV,21,0.15284496921465798,Dovish
8,17,역학/NNG,25,0.6833069211949414,Dovish
5,16, 선금/NNG,21,0.4537585023560159,Dovish
4,16, 재무/NNG;건전성/NNG;나쁘/VA,20,0.36300680188481266,Dovish
23,67,전통시장/NNG,90,0.4984571010955637,Dovish
130,261,黑/NNG,391,0.7232319424525003,Dovish
6,15, 솟구쳤/VV,21,0.5808108830157004,Dovish
5,14, 퇴출기업/NNG,19,0.5185811455497324,Dovish
8,17, 미/NNG;국채/NNG;금리/NNG;떨어/VV,25,0.6833069211949414,Dovish
8,26, 국채/NNG;거품/NNG,34,0.44677760231976943,Dovish
13,39,누리/NNG,52,0.4840090691797503,Dovish
4,14, 경기/NNG;과도/NNG;위축/NNG;방지/NNG,18,0.41486491643978596,Dovish
6,16, 시중/NNG;유동성/NNG;공급/NNG;확대/NNG,22,0.5445102028272191,Dovish
4,12, 신규/NNG;고용/NNG;늘/VV,16,0.4840090691797502,Dovish
6,13,기타금융기관/NNG,19,0.6701664034796543,Dovish
4,16, 뇌혈관/NNG,20,0.36300680188481266,Dovish
5,17, 마라톤협상/NNG,22,0.42706682574683846,Dovish
4,24, 고용/NNG;한파/NNG,28,0.2420045345898751,Dovish
9,27, 관리운영권/NNG,36,0.4840090691797503,Dovish
1,15,적자성/NNG,16,0.09680181383595005,Dovish
4,12, 더하기/NNG,16,0.4840090691797502,Dovish
2,15, 폰지사기/NNG,17,0.1936036276719001,Dovish
4,13, 천세/NNG,17,0.44677760231976943,Dovish
35,78, 강소기업/NNG,113,0.6515506700496638,Dovish
13,32, 대로변/NNG,45,0.5898860530628207,Dovish
8,26, 중심상업지구/NNG,34,0.44677760231976943,Dovish
5,11, 글로벌/NNG;금융위기/NNG;최악/NNG,16,0.6600123670632958,Dovish
15,41,녹색성장/NNG,56,0.5312294661728967,Dovish
7,15, 유가/NNG;하락/NNG;멈추/VV,22,0.6776126968516504,Dovish
8,17, 돈/NNG;푸/VV;양적완화/NNG,25,0.6833069211949414,Dovish
12,32, 역대/NNG;최저/NNG;떨어/VV,44,0.5445102028272191,Dovish
7,22,외통/NNG,29,0.4620086569443071,Dovish
5,11,분단/NNG,16,0.6600123670632958,Dovish
11,54, 달러인덱스/NNG;내리/VV,65,0.2957833200542918,Dovish
1,31, 녹색뉴딜/NNG,32,0.046839587339975834,Dovish
7,21,은행자본확충펀드/NNG,28,0.4840090691797503,Dovish
3,15, 반주/NNG,18,0.2904054415078502,Dovish
4,12, 미칩니다/VV,16,0.4840090691797502,Dovish
7,20, 부양책/NNG;지지/NNG,27,0.5082095226387378,Dovish
6,20, 도운/VV,26,0.43560816226177523,Dovish
6,29,뇌물/NNG,35,0.3004194222495002,Dovish
3,13,저층/NNG,16,0.33508320173982714,Dovish
3,13, 삭소/NNG,16,0.33508320173982714,Dovish
4,14, 금리/NNG;떨어/VV;최저/NNG,18,0.41486491643978596,Dovish
1,16, 해포/NNG,17,0.09075170047120316,Dovish
5,29,급진/NNG,34,0.25034951854125015,Dovish
4,15,건설채/NNG,19,0.3872072553438002,Dovish
21,73,후정/NNG,94,0.41770645696334613,Dovish
3,26,조합장/NNG,29,0.16754160086991357,Dovish
5,11, 시저스/NNG,16,0.6600123670632958,Dovish
9,29,fx마진거래/NNG,38,0.45062913337425026,Dovish
25,112, 위험/NNG;회피/NNG;완화/NNG,137,0.3241132159685828,Dovish
3,16, irs/NNG;국채선물/NNG;강세/NNG,19,0.27225510141360953,Dovish
14,31,가자지구/NNG,45,0.6557542227596617,Dovish
3,16,버거/NNG,19,0.27225510141360953,Dovish
17,50, 친애/NNG,67,0.49368925056334534,Dovish
5,19, 인플레이션/NNG;내리/VV,24,0.38211242303664494,Dovish
4,12, 경제/NNG;대공황/NNG;최악/NNG,16,0.4840090691797502,Dovish
3,25,어르신/NNG,28,0.17424326490471012,Dovish
7,14, gdp/NNG;성장률/NNG;플러스/NNG,21,0.7260136037696254,Dovish
23,63,남구/NNG,86,0.5301051710063931,Dovish
23,55,임진/NNG,78,0.6072113776982321,Dovish
3,19, 위험/NNG;회피/NNG;위험/NNG,22,0.229267453821987,Dovish
4,14, 기대/NNG;글로벌/NNG;증시/NNG;상승/NNG,18,0.41486491643978596,Dovish
6,16, 유가/NNG;지정학/NNG;불안정/NNG,22,0.5445102028272191,Dovish
6,14, 결손액/NNG,20,0.622297374659679,Dovish
13,28,비상경제대책회의/NNG,41,0.6741554892146522,Dovish
11,35,프리워크아웃/NNG,46,0.4563514080837645,Dovish
6,12, 재무구조/NNG;나쁘/VA,18,0.7260136037696254,Dovish
4,27, 다녀가/VV,31,0.21511514185766675,Dovish
2,17,사무처/NNG,19,0.17082673029873535,Dovish
22,47, 국가정책조정회의/NNG,69,0.6796723099119898,Dovish
14,29, 광공업/NNG;생산/NNG;줄/VV,43,0.7009786519155004,Dovish
8,19, 아실/VV,27,0.6113798768586319,Dovish
13,63,위례/NNG,76,0.2996246618731787,Dovish
2,15,자본력/NNG,17,0.1936036276719001,Dovish
15,59,국채교환/NNG,74,0.36915945954387736,Dovish
4,17, 편다는/VV,21,0.3416534605974707,Dovish
8,18, 역외시장/NNG;상승/NNG,26,0.6453454255730003,Dovish
15,39, 디폴트/NNG;우려/NNG;크/VV,54,0.5584720028997118,Dovish
5,11, 고점/NNG;인식/NNG;강하/VA,16,0.6600123670632958,Dovish
3,15, 금융위기/NNG;재발/NNG;우려/NNG,18,0.2904054415078502,Dovish
10,28, 천석/NNG,38,0.5185811455497324,Dovish
7,28, 잡셰어링/NNG,35,0.3630068018848127,Dovish
5,15,준비금/NNG,20,0.48400906917975023,Dovish
12,41, 매크로펀드/NNG,53,0.42498357293831734,Dovish
10,40, 관객수/NNG,50,0.3630068018848127,Dovish
3,17,유족/NNG,20,0.25624009544810306,Dovish
5,54,크림/NNG,59,0.13444696366104172,Dovish
4,15, 최저/NNG;마이너스/NNG,19,0.3872072553438002,Dovish
10,22, 음력설/NNG,32,0.6600123670632958,Dovish
11,23,고래/NNG,34,0.6944477949100765,Dovish
5,26,문수/NNG,31,0.27923600144985594,Dovish
20,59,광교/NNG,79,0.4922126127251698,Dovish
5,12, 임대/NNG;수익률/NNG;낮/VA,17,0.6050113364746877,Dovish
3,14, 구조조정/NNG;부정적/VAX,17,0.3111486873298395,Dovish
31,73,절대수익추구형/NNG,104,0.6166142936125586,Dovish
4,19,신채/NNG,23,0.30568993842931597,Dovish
3,13, 집합투자업/NNG,16,0.33508320173982714,Dovish
17,60, 레버리지etf/NNG,77,0.41140770880278776,Dovish
6,12, 전망/NNG;마이너스/NNG;하향/NNG,18,0.7260136037696254,Dovish
5,13, 장기물/NNG;줄/VV,18,0.5584720028997119,Dovish
6,16, 안모/NNG,22,0.5445102028272191,Dovish
8,19, 전강/NNG,27,0.6113798768586319,Dovish
9,24, 녹색성장기업/NNG,33,0.5445102028272191,Dovish
8,20, 흉악범/NNG,28,0.5808108830157003,Dovish
6,14, 수출입/NNG;감소/NNG,20,0.622297374659679,Dovish
6,22, 청결/NNG,28,0.3960074202379775,Dovish
20,53,롱포지션/NNG,73,0.5479347952978305,Dovish
6,12, 경기/NNG;부진/NNG;금리/NNG;인하/NNG,18,0.7260136037696254,Dovish
5,11,녹색산업/NNG,16,0.6600123670632958,Dovish
6,14, 금리/NNG;인하/NNG;가능성/NNG;제한적/VAX,20,0.622297374659679,Dovish
8,29, 경로당/NNG,37,0.4005592296660002,Dovish
4,12, 돈/NNG;풀/VV;금리/NNG;내리/VV,16,0.4840090691797502,Dovish
5,11, 다닌/VV,16,0.6600123670632958,Dovish
1,21, 국채/NNG;금리/NNG;혼조/NNG,22,0.06914415273996431,Dovish
33,68,자본시장법/NNG,101,0.7046602624822833,Dovish
14,64, 만기평가일/NNG,78,0.3176309516492111,Dovish
5,13, 민병/NNG,18,0.5584720028997119,Dovish
1,20, 악단/NNG,21,0.07260136037696253,Dovish
3,17, 기업/NNG;환경지수/NNG;하락/NNG,20,0.25624009544810306,Dovish
7,32, 마이크로파이낸스/NNG,39,0.3176309516492111,Dovish
3,25,정부채/NNG,28,0.17424326490471012,Dovish
16,41, 금리/NNG;내리/VV;채권/NNG;가격/NNG;오르/VV,57,0.5666447639177564,Dovish
5,11,결제일/NNG,16,0.6600123670632958,Dovish
2,22, 철도망/NNG,24,0.13200247341265917,Dovish
4,14, 표창장/NNG,18,0.41486491643978596,Dovish
5,14, 인하/NNG;양적완화/NNG,19,0.5185811455497324,Dovish
5,11, 가격/NNG;내리/VV;않/VX,16,0.6600123670632958,Dovish
2,24, 자차/NNG,26,0.12100226729493754,Dovish
16,44, 무직자/NNG,60,0.5280098936506367,Dovish
15,38, 양적완화/NNG;우려/NNG,53,0.5731686345549674,Dovish
37,78, 국고채/NNG;지표물/NNG;내리/VV,115,0.6887821369096446,Dovish
16,49,확진/NNG,65,0.47413133307404104,Dovish
5,12, 총격전/NNG,17,0.6050113364746877,Dovish
5,12, 트로이온스/NNG,17,0.6050113364746877,Dovish
3,16, 기업/NNG;부채/NNG;늘/VV,19,0.27225510141360953,Dovish
4,15, 회사채/NNG;발행/NNG;쉽/VA;않/VX,19,0.3872072553438002,Dovish
1,17,회사채신속인수제/NNG,18,0.08541336514936768,Dovish
9,18, 되돌림국면/NNG,27,0.7260136037696254,Dovish
5,11, 주변인/NNG,16,0.6600123670632958,Dovish
5,15, 세계/NNG;성장률/NNG;전망/NNG;하향/NNG,20,0.48400906917975023,Dovish
11,25, 수출/NNG;감소/NNG;줄/VV,36,0.6388919713172704,Dovish
5,18, 위기/NNG;대응/NNG;능력/NNG;강화/NNG,23,0.4033408909831252,Dovish
7,23, 다달이/MAG,30,0.441921324033685,Dovish
6,19, 채권평가이익/NNG;증가/NNG,25,0.458534907643974,Dovish
22,49, 오토매틱데이터프로세싱/NNG,71,0.6519305829768064,Dovish
5,14, 디플레이션/NNG;압력/NNG;크/VV,19,0.5185811455497324,Dovish
3,16, 정치/NNG;인하/NNG,19,0.27225510141360953,Dovish
11,24,용선료/NNG,35,0.6655124701221565,Dovish
7,29, 농인/NNG,36,0.3504893259577502,Dovish
3,20, 스페이스/NNG,23,0.21780408113088762,Dovish
3,19, 가계/NNG;부채/NNG;경감/NNG,22,0.229267453821987,Dovish
6,14, 대출/NNG;금리/NNG;고금리/NNG,20,0.622297374659679,Dovish
6,12, 부채/NNG;최대/NNG,18,0.7260136037696254,Dovish
2,15, 전망/NNG;증가/NNG;웃돌/VV,17,0.1936036276719001,Dovish
7,19, 비틀스/NNG,26,0.5349573922513029,Dovish
2,40,로켓/NNG,42,0.07260136037696253,Dovish
9,50, 장거리로켓발사/NNG,59,0.2613648973570652,Dovish
2,19, 중계무역/NNG,21,0.15284496921465798,Dovish
8,16, 북빌딩/NNG,24,0.7260136037696253,Dovish
9,21, 세계/NNG;경기/NNG;회복/NNG;지연/NNG,30,0.6222973746596789,Dovish
4,12, 롱포지션/NNG;많/VA,16,0.4840090691797502,Dovish
13,29, 현장점검반/NNG,42,0.6509087482072504,Dovish
4,14, 가격/NNG;입찰/NNG;호조/NNG,18,0.41486491643978596,Dovish
6,13, 경제주체/NNG;과도/NNG,19,0.6701664034796543,Dovish
14,39,유효수요/NNG,53,0.5212405360397311,Dovish
10,20, 하락/NNG;채권/NNG;가격/NNG;강세/NNG,30,0.7260136037696254,Dovish
7,15, 통화당국수장/NNG,22,0.6776126968516504,Dovish
22,52, 지표물/NNG;하락/NNG,74,0.614319203189683,Dovish
4,31, 장상/NNG,35,0.18735834935990334,Dovish
7,20, 개별주체/NNG,27,0.5082095226387378,Dovish
5,14, 국채/NNG;매각/NNG;성공/NNG,19,0.5185811455497324,Dovish
2,18, 이화/NNG,20,0.16133635639325009,Dovish
6,26, 소폭/MAG;오르/VV;끝/NNG,32,0.33508320173982714,Dovish
3,16, 이자/NNG;작/VV,19,0.27225510141360953,Dovish
5,15, 어닝파워/NNG,20,0.48400906917975023,Dovish
3,18,적십자사/NNG,21,0.24200453458987514,Dovish
10,20,공실/NNG,30,0.7260136037696254,Dovish
4,17, 마이너스/NNG;상향/NNG,21,0.3416534605974707,Dovish
1,23, 기업/NNG;실적/NNG;시장/NNG;예상/NNG;상회/NNG,24,0.06313161771909785,Dovish
3,13, 사우나/NNG,16,0.33508320173982714,Dovish
17,46,정부군/NNG,63,0.5366187506123319,Dovish
4,15, 고용시장/NNG;취약/NNG,19,0.3872072553438002,Dovish
38,81, 주택/NNG;지표/NNG;실망/NNG,119,0.6811979492159449,Dovish
35,75,장민/NNG,110,0.6776126968516504,Dovish
5,17, 역마진/NNG;확대/NNG,22,0.42706682574683846,Dovish
3,30, 고금리/NNG;전환/NNG,33,0.1452027207539251,Dovish
4,15, 글로벌/NNG;금융시장/NNG;위험자산/NNG;회피/NNG,19,0.3872072553438002,Dovish
5,11, 긴장/NNG;끈/NNG;늦/VV;않/VX,16,0.6600123670632958,Dovish
18,40,icbm/NNG,58,0.6534122433926629,Dovish
12,39, 물가/NNG;상승률/NNG;전망/NNG;낮/VV,51,0.4467776023197695,Dovish
20,73, 국채/NNG;가격/NNG;낙폭/NNG;확대/NNG,93,0.3978156732984249,Dovish
4,12, 생산자/NNG;물가/NNG;내리/VV,16,0.4840090691797502,Dovish
18,38, 국채/NNG;가격/NNG;약세/NNG,56,0.687802361465961,Dovish
13,27, 발사장/NNG,40,0.6991242110374171,Dovish
12,39, 강신/NNG,51,0.4467776023197695,Dovish
8,29, 정책/NNG;공조/NNG;강화/NNG,37,0.4005592296660002,Dovish
5,19, 맥북/NNG,24,0.38211242303664494,Dovish
4,12, 당분간/MAG;통화정책/NNG;완화/NNG,16,0.4840090691797502,Dovish
12,24, 부채비율/NNG;오르/VV,36,0.7260136037696254,Dovish
7,19,레인/NNG,26,0.5349573922513029,Dovish
5,11, 은행/NNG;모기지/NNG;금리/NNG;인상/NNG,16,0.6600123670632958,Dovish
5,15, 캐피탈콜/NNG,20,0.48400906917975023,Dovish
3,15, 회복/NNG;해치/VV,18,0.2904054415078502,Dovish
5,19, 내상/NNG,24,0.38211242303664494,Dovish
3,13,고객수/NNG,16,0.33508320173982714,Dovish
5,13,상조/NNG,18,0.5584720028997119,Dovish
11,31, 채권펀드/NNG;오르/VV,42,0.5152354607397341,Dovish
2,14, 부정적/VAX;충격/NNG;줄/VV,16,0.20743245821989298,Dovish
3,13, 세계/NNG;경제/NNG;전망/NNG;하향/NNG,16,0.33508320173982714,Dovish
4,25, 정찰/NNG,29,0.23232435320628012,Dovish
2,15, 구급차/NNG,17,0.1936036276719001,Dovish
4,16, 출구전략/NNG;위험/NNG,20,0.36300680188481266,Dovish
3,14, 맞부딪치/VV,17,0.3111486873298395,Dovish
6,14, 글로벌/NNG;금융시장/NNG;금리/NNG;인상/NNG,20,0.622297374659679,Dovish
12,24, 역외/NNG;환율/NNG;상승/NNG;반영/NNG;오르/VV,36,0.7260136037696254,Dovish
3,20, 코덱스/NNG,23,0.21780408113088762,Dovish
14,35, 목표전환형펀드/NNG,49,0.5808108830157003,Dovish
7,14, 유가/NNG;강세/NNG;상승/NNG,21,0.7260136037696254,Dovish
10,38, 국채/NNG;금리/NNG;밑돌/VV,48,0.38211242303664494,Dovish
5,14,울주군/NNG,19,0.5185811455497324,Dovish
8,16, 금리/NNG;보합권/NNG;혼조/NNG,24,0.7260136037696253,Dovish
4,13, 서비스업/NNG;약세/NNG,17,0.44677760231976943,Dovish
9,21, 입법조사처/NNG,30,0.6222973746596789,Dovish
5,11, 예상/NNG;깨/VV;양적완화/NNG,16,0.6600123670632958,Dovish
2,15, 진솔/NNG,17,0.1936036276719001,Dovish
6,19,스카/NNG,25,0.458534907643974,Dovish
5,12, 달러원/NNG;넘/VV;오르/VV,17,0.6050113364746877,Dovish
6,12, 하락/NNG;빠지/VV,18,0.7260136037696254,Dovish
4,13, 모하마드/NNG,17,0.44677760231976943,Dovish
4,13, 타수/NNG,17,0.44677760231976943,Dovish
13,30, 온누리상품권/NNG,43,0.6292117899336753,Dovish
20,67, 미/NNG;국채/NNG;가격/NNG;하락/NNG,87,0.43344095747440325,Dovish
4,14, 총액/NNG;한도/NNG;대출/NNG;한도/NNG;확대/NNG,18,0.41486491643978596,Dovish
28,59, 금/NNG;가격/NNG;하락/NNG;압력/NNG,87,0.6890976578152377,Dovish
5,16, 일찍/MAG;금리/NNG;오르/VV,21,0.4537585023560159,Dovish
11,29, 국채선물/NNG;하락/NNG;압력/NNG,40,0.5507689407907503,Dovish
9,35,전구간/NNG,44,0.3733784247958074,Dovish
5,11,저소득국/NNG,16,0.6600123670632958,Dovish
5,27, 순이자마진/NNG;금리/NNG;인하/NNG,32,0.26889392732208345,Dovish
12,23, irs/NNG;금리/NNG;채권시장/NNG;약세/NNG,35,0.7575794126291744,Dovish
9,28, fed/NNG;예상/NNG;빨리/MAG;금리/NNG;인상/NNG,37,0.46672303099475926,Dovish
27,66, 서부텍사스산원유/NNG;가격/NNG;하락/NNG,93,0.5940111303569662,Dovish
8,32, 금리/NNG;언제/MAG;인상/NNG,40,0.36300680188481266,Dovish
28,64, 금리/NNG;내리/VV;하락/NNG,92,0.6352619032984222,Dovish
10,22, 고용/NNG;지표/NNG;회복/NNG,32,0.6600123670632958,Dovish
5,12, 부대사업/NNG,17,0.6050113364746877,Dovish
5,12, 출구전략/NNG;가속/NNG,17,0.6050113364746877,Dovish
12,28, 금리/NNG;인상/NNG;기대/NNG;후퇴/NNG,40,0.622297374659679,Dovish
8,18, 강점기/NNG,26,0.6453454255730003,Dovish
4,21,블랙스완/NNG,25,0.27657661095985725,Dovish
3,14, 을지훈련/NNG,17,0.3111486873298395,Dovish
3,15, 밭작물/NNG,18,0.2904054415078502,Dovish
7,31, 은상/NNG,38,0.32787711137983083,Dovish
55,135,형민/NNG,190,0.5915666401085836,Dovish
7,14, 세계/NNG;완화/NNG,21,0.7260136037696254,Dovish
5,13, 단기물/NNG;금리/NNG;내리/VV,18,0.5584720028997119,Dovish
63,216, irs/NNG;내리/VV,279,0.4235079355322815,Dovish
8,18, 경제/NNG;이중침체/NNG;경기/NNG;상승/NNG;하락/NNG,26,0.6453454255730003,Dovish
32,102, 대포통장/NNG,134,0.4555379474632943,Dovish
15,29,개표/NNG,44,0.7510485556237504,Dovish
3,14, 유로존/NNG;소비자/NNG;물가/NNG;오르/VV,17,0.3111486873298395,Dovish
5,25, 완치/NNG,30,0.2904054415078502,Dovish
5,12, 위험/NNG;위험관리/NNG;강화/NNG,17,0.6050113364746877,Dovish
6,19,지하경제/NNG,25,0.458534907643974,Dovish
5,13, 고용률/NNG;높/VV,18,0.5584720028997119,Dovish
7,17, 원화채권/NNG;금리/NNG;하락/NNG,24,0.5978935560455738,Dovish
2,16,빚내/VV,18,0.18150340094240633,Dovish
4,13, 타격/NNG;크/VV,17,0.44677760231976943,Dovish
3,17, 원리금/NNG;상환/NNG;부담/NNG;줄/VV,20,0.25624009544810306,Dovish
3,14, 금융위기/NNG;늘/VV,17,0.3111486873298395,Dovish
8,17, 종시/NNG,25,0.6833069211949414,Dovish
75,175, 스왑베이시스/NNG;역전폭/NNG;줄/VV,250,0.6222973746596789,Dovish
11,36, 장민/NNG,47,0.44367498008143774,Dovish
7,22, 하락/NNG;압력/NNG;받/VV;없/VA,29,0.4620086569443071,Dovish
3,16,미소금융사업/NNG,19,0.27225510141360953,Dovish
4,20, 전자화폐/NNG,24,0.29040544150785014,Dovish
39,111,역레포/NNG,150,0.5101717215678448,Dovish
6,12, 주택시장/NNG;활력/NNG,18,0.7260136037696254,Dovish
5,11, 屈/NNG,16,0.6600123670632958,Dovish
12,27, 병무청/NNG,39,0.6453454255730003,Dovish
7,15, 미곡/NNG,22,0.6776126968516504,Dovish
13,25, irs/NNG;금리/NNG;채권시장/NNG;강세/NNG,38,0.7550541479204105,Dovish
4,16, 세계/NNG;경제/NNG;취약/NNG,20,0.36300680188481266,Dovish
4,16,농기계/NNG,20,0.36300680188481266,Dovish
4,35, 경상/NNG;무역/NNG;흑자/NNG,39,0.16594596657591437,Dovish
8,26,가이던스/NNG,34,0.44677760231976943,Dovish
5,15, 살인죄/NNG,20,0.48400906917975023,Dovish
5,13, 가계/NNG;소득/NNG;부진/NNG,18,0.5584720028997119,Dovish
10,21, 스타킹/NNG,31,0.6914415273996433,Dovish
9,22, 전환자/NNG,31,0.5940111303569663,Dovish
4,12, 출구전략/NNG;시행/NNG;늦/VV,16,0.4840090691797502,Dovish
6,16, 키나/NNG,22,0.5445102028272191,Dovish
8,23, 외국인/NNG;수급/NNG;부정적/VAX,31,0.5050529417527828,Dovish
14,37,오픈/NNG,51,0.5494157001499868,Dovish
56,122,전기차/NNG,178,0.6665042919852299,Dovish
5,11, 국제/NNG;금융시장/NNG;금리/NNG;인상/NNG,16,0.6600123670632958,Dovish
5,12, 홍덕/NNG,17,0.6050113364746877,Dovish
1,22, 장기물/NNG;약하/VA,23,0.06600123670632958,Dovish
13,47, 지표물/NNG;상승/NNG,60,0.40162454676617576,Dovish
7,19, 안서/NNG,26,0.5349573922513029,Dovish
4,13, 금리/NNG;인상/NNG;더디/VA,17,0.44677760231976943,Dovish
13,35,내전/NNG,48,0.5393243913717217,Dovish
8,29,바르/VA,37,0.4005592296660002,Dovish
5,18, 열립니다/VV,23,0.4033408909831252,Dovish
10,25, 호주달러/NNG;급등/NNG,35,0.5808108830157004,Dovish
4,16, 예상/NNG;늘/VV;않/VX,20,0.36300680188481266,Dovish
17,56,영종/NNG,73,0.44079397371727264,Dovish
4,15,테일리스크/NNG,19,0.3872072553438002,Dovish
9,32,만기평가일/NNG,41,0.4083826521204143,Dovish
9,19,중장기영역/NNG,28,0.687802361465961,Dovish
7,15, 대차대조표/NNG;불황/NNG,22,0.6776126968516504,Dovish
5,13, 투표자/NNG,18,0.5584720028997119,Dovish
5,13, gdp/NNG;성장률/NNG;개선/NNG,18,0.5584720028997119,Dovish
6,21,쿼크/NNG,27,0.41486491643978596,Dovish
13,44, 부양책/NNG;축소/NNG,57,0.42900803859114234,Dovish
11,23,증권신고서/NNG,34,0.6944477949100765,Dovish
0,20, crs/NNG;금리/NNG;달러원/NNG;상승/NNG,20,0.0,Dovish
2,14, fed/NNG;이전/NNG;매파/NNG,16,0.20743245821989298,Dovish
9,19, 국격/NNG,28,0.687802361465961,Dovish
3,16, 롱세력/NNG,19,0.27225510141360953,Dovish
12,30, 역외/NNG;환율/NNG;소폭/MAG;하락/NNG,42,0.5808108830157004,Dovish
6,13, 민간고용조사/NNG,19,0.6701664034796543,Dovish
9,19, 인바운드/NNG,28,0.687802361465961,Dovish
5,15, 아웃바운드/NNG,20,0.48400906917975023,Dovish
22,56, 수입업체/NNG;저점/NNG,78,0.5704392601047057,Dovish
19,44,무역지수/NNG,63,0.6270117487101311,Dovish
6,15, 성장/NNG;부정적/VAX;영향/NNG;줄/VV,21,0.5808108830157004,Dovish
5,22,기잡니다/NNG,27,0.3300061835316479,Dovish
4,16, 안정국/NNG,20,0.36300680188481266,Dovish
2,16, 최대/NNG;고용/NNG;물가/NNG;안정/NNG,18,0.18150340094240633,Dovish
2,24, 심사관/NNG,26,0.12100226729493754,Dovish
3,15, fed/NNG;금리/NNG;인상/NNG;예상/NNG;늦/VA,18,0.2904054415078502,Dovish
12,35, 채권시장/NNG;강보합/NNG;채권/NNG;금리/NNG;하락/NNG,47,0.49783789972774317,Dovish
9,21, 경제/NNG;지표/NNG;호조/NNG;힘입/VV;상승/NNG,30,0.6222973746596789,Dovish
11,29, 글로벌/NNG;금융위기/NNG;최대/NNG,40,0.5507689407907503,Dovish
4,12, 바비큐/NNG,16,0.4840090691797502,Dovish
3,17, 유병률/NNG,20,0.25624009544810306,Dovish
1,16, 위기/NNG;재발/NNG;우려/NNG,17,0.09075170047120316,Dovish
5,21,재무관/NNG,26,0.34572076369982163,Dovish
6,14, 불확실성/NNG;크/VV;금리/NNG;인상/NNG,20,0.622297374659679,Dovish
1,16,칸막이/NNG,17,0.09075170047120316,Dovish
11,24,애플리케이션/NNG,35,0.6655124701221565,Dovish
10,20, 위험자산/NNG;투자심리/NNG;살/VV,30,0.7260136037696254,Dovish
1,15, 경기/NNG;회복/NNG;미흡/NNG,16,0.09680181383595005,Dovish
1,17, 고용/NNG;약화/NNG,18,0.08541336514936768,Dovish
4,14, 카페테리아/NNG,18,0.41486491643978596,Dovish
30,63,호가집중시스템/NNG,93,0.6914415273996432,Dovish
4,19,기상악화/NNG,23,0.30568993842931597,Dovish
4,13, 경기/NNG;회복/NNG;금리/NNG;인하/NNG,17,0.44677760231976943,Dovish
17,39, fed/NNG;완전고용/NNG;물가/NNG;안정/NNG,56,0.6329349366196735,Dovish
6,19, 회계기간/NNG,25,0.458534907643974,Dovish
10,38, 희망키움통장/NNG,48,0.38211242303664494,Dovish
20,76, 서부텍사스산원유/NNG;가격/NNG;상승/NNG,96,0.38211242303664494,Dovish
10,46, fed/NNG;고용시장/NNG;개선/NNG,56,0.3156580885954893,Dovish
23,107, fed/NNG;금리/NNG;인상/NNG;서둘/VV;않/VX,130,0.31211799788226885,Dovish
19,46, 국채선물/NNG;금리/NNG;상승/NNG,65,0.5997503683314297,Dovish
3,16, fed/NNG;고용/NNG;개선/NNG,19,0.27225510141360953,Dovish
18,37, 컬처/NNG,55,0.7063916144785545,Dovish
5,14,미소/NNG,19,0.5185811455497324,Dovish
2,14, 금융위기/NNG;성장/NNG,16,0.20743245821989298,Dovish
3,17, 가계/NNG;부채/NNG;높/VA;증가/NNG,20,0.25624009544810306,Dovish
13,39, 농지연금/NNG,52,0.4840090691797503,Dovish
10,27, 합니다만/XSV,37,0.5377878546441669,Dovish
4,27, 경기민감주/NNG;상승/NNG,31,0.21511514185766675,Dovish
19,53, 제조업/NNG;pmi/NNG;상승/NNG,72,0.520538055532939,Dovish
3,13, pmi/NNG;높/VA,16,0.33508320173982714,Dovish
6,44,신운/NNG,50,0.19800371011898876,Dovish
10,31, 이익/NNG;실현/NNG;매물/NNG;하락/NNG,41,0.46839587339975836,Dovish
6,16, 역외/NNG;환율/NNG;반영/NNG;상승/NNG,22,0.5445102028272191,Dovish
9,34,입찰액/NNG,43,0.3843601431721546,Dovish
6,22, 예비전력/NNG,28,0.3960074202379775,Dovish
22,47, 인버스etf/NNG,69,0.6796723099119898,Dovish
7,14,교/NNG,21,0.7260136037696254,Dovish
3,15,혹한/NNG,18,0.2904054415078502,Dovish
33,150, etn/NNG,183,0.31944598565863513,Dovish
6,13, 경기/NNG;부양책/NNG;종료/NNG,19,0.6701664034796543,Dovish
9,24, 달러원/NNG;하단/NNG;지지/NNG,33,0.5445102028272191,Dovish
12,35,플랫/NNG,47,0.49783789972774317,Dovish
6,20, 출구전략/NNG;충격/NNG,26,0.43560816226177523,Dovish
6,12, 포캐스터/NNG,18,0.7260136037696254,Dovish
6,12, 고성장주/NNG,18,0.7260136037696254,Dovish
25,80,혜리/NNG,105,0.4537585023560159,Dovish
7,15, 태문/NNG,22,0.6776126968516504,Dovish
3,15, 흑색/NNG,18,0.2904054415078502,Dovish
467,1134,금융투자업계/NNG,1601,0.5979688764733951,Dovish
4,15, 원/NNG;환율/NNG;떨어/VV,19,0.3872072553438002,Dovish
5,11, 전세자금/NNG;대출/NNG;증가/NNG,16,0.6600123670632958,Dovish
31,79,그림자금융/NNG,110,0.5697828282748959,Dovish
4,12,박물관/NNG,16,0.4840090691797502,Dovish
5,15, 순이익/NNG;떨어/VV,20,0.48400906917975023,Dovish
4,17, 공분/NNG,21,0.3416534605974707,Dovish
4,16, 글로벌/NNG;자금/NNG;위험자산/NNG;선호/NNG,20,0.36300680188481266,Dovish
5,11, 묘역/NNG,16,0.6600123670632958,Dovish
9,19, 티핑포인트/NNG,28,0.687802361465961,Dovish
12,33,춘/VA,45,0.5280098936506367,Dovish
6,23, 운지/NNG,29,0.3787897063145872,Dovish
3,14, 전일제/NNG,17,0.3111486873298395,Dovish
5,16, 저성/NNG,21,0.4537585023560159,Dovish
48,246,그리스사태/NNG,294,0.2833223819588782,Dovish
3,16, 앙청/NNG,19,0.27225510141360953,Dovish
6,19,볼커룰/NNG,25,0.458534907643974,Dovish
6,23, 통안채/NNG;수익률/NNG;내리/VV,29,0.3787897063145872,Dovish
5,16, 긴축/NNG;선호/NNG,21,0.4537585023560159,Dovish
16,50, 가계/NNG;부채/NNG;문제/NNG;심각/NNG,66,0.46464870641256023,Dovish
5,12,레인지장세/NNG,17,0.6050113364746877,Dovish
5,11, 앙재/NNG,16,0.6600123670632958,Dovish
3,17,잇/VV,20,0.25624009544810306,Dovish
5,13, 채권/NNG;약하/VA,18,0.5584720028997119,Dovish
6,16, 신흥국/NNG;경제/NNG;회복/NNG,22,0.5445102028272191,Dovish
13,25,아테네/NNG,38,0.7550541479204105,Dovish
5,19, 경제/NNG;지표/NNG;취약/NNG,24,0.38211242303664494,Dovish
6,28,롱심리/NNG,34,0.3111486873298395,Dovish
21,72, 국고채/NNG;지표물/NNG;하락/NNG,93,0.42350793553228144,Dovish
7,16, 여중/NNG,23,0.6352619032984222,Dovish
0,29, 호법/NNG,29,0.0,Dovish
6,12, 대장암/NNG,18,0.7260136037696254,Dovish
17,60, 알아봅니다/VV,77,0.41140770880278776,Dovish
4,19, 그리스도/NNG,23,0.30568993842931597,Dovish
27,55, 글로벌/NNG;금융위기/NNG;최저/NNG,82,0.7128133564283595,Dovish
22,76, 결제물/NNG,98,0.42032366534030946,Dovish
8,16, 민감/NNG;금리/NNG;하락/NNG,24,0.7260136037696253,Dovish
5,20, 코픽스/NNG;금리/NNG;하락/NNG,25,0.3630068018848127,Dovish
6,13, 문고리/NNG,19,0.6701664034796543,Dovish
3,14,권리/NNG,17,0.3111486873298395,Dovish
6,17, 가계/NNG;부채/NNG;부작용/NNG,23,0.5124801908962061,Dovish
8,19, 대내외/NNG;불확실성/NNG;크/VV,27,0.6113798768586319,Dovish
1,19, 동호/NNG,20,0.07642248460732899,Dovish
6,12, 하락/NNG;압력/NNG;약화/NNG,18,0.7260136037696254,Dovish
4,14, 살펴봅니다/VV,18,0.41486491643978596,Dovish
3,13, 외국환중개회사/NNG,16,0.33508320173982714,Dovish
3,13, 요람/NNG,16,0.33508320173982714,Dovish
12,69,잔류/NNG,81,0.25252647087639146,Dovish
13,50, 재정위기/NNG;확산/NNG;우려/NNG,63,0.37752707396020524,Dovish
8,19, 낮/VA;인플레이션/NNG;금리/NNG;인상/NNG,27,0.6113798768586319,Dovish
5,21, 경제/NNG;성장/NNG;좋/VA,26,0.34572076369982163,Dovish
7,18, 위험/NNG;약하/VA,25,0.5646772473763753,Dovish
7,17, 고정/NNG;금리/NNG;대출비중/NNG;높/VV,24,0.5978935560455738,Dovish
5,22, 국고채/NNG;지표물/NNG;수익률/NNG;하락/NNG,27,0.3300061835316479,Dovish
6,18, 국고채/NNG;지표물/NNG;수익률/NNG;상승/NNG,24,0.4840090691797503,Dovish
2,29, 초계함/NNG,31,0.10013980741650005,Dovish
5,17, 시금치/NNG,22,0.42706682574683846,Dovish
0,50, 함미/NNG,50,0.0,Dovish
12,26, 함대/NNG,38,0.6701664034796543,Dovish
5,24, 가계/NNG;부채/NNG;부실/NNG;위험/NNG,29,0.30250566823734387,Dovish
6,14, irs/NNG;금리/NNG;만기구간/NNG;상승/NNG,20,0.622297374659679,Dovish
5,17, crs/NNG;금리/NNG;만기구간/NNG;상승/NNG,22,0.42706682574683846,Dovish
4,19, 스왑베이시스/NNG;역전폭/NNG;소폭/MAG;축소/NNG,23,0.30568993842931597,Dovish
4,14, 최전방/NNG,18,0.41486491643978596,Dovish
6,15, irs/NNG;금리/NNG;만기구간/NNG;하락/NNG,21,0.5808108830157004,Dovish
3,14,준상/NNG,17,0.3111486873298395,Dovish
7,14, crs/NNG;금리/NNG;만기구간/NNG;하락/NNG,21,0.7260136037696254,Dovish
1,19, 비공개회의/NNG,20,0.07642248460732899,Dovish
5,11, 지표/NNG;호조/NNG;오르/VV,16,0.6600123670632958,Dovish
6,16, 배사/NNG,22,0.5445102028272191,Dovish
3,15, 미제/NNG,18,0.2904054415078502,Dovish
4,12, 얼마나/MAG;매파/NNG,16,0.4840090691797502,Dovish
47,130,기재/NNG,177,0.5249636827257291,Dovish
4,19,종잣돈/NNG,23,0.30568993842931597,Dovish
0,45, 핵안보정상회의/NNG,45,0.0,Dovish
21,49, 월복/NNG,70,0.6222973746596789,Dovish
4,12, 금리/NNG;하락/NNG;국채/NNG;가격/NNG;상승/NNG,16,0.4840090691797502,Dovish
6,22, 금리/NNG;인상/NNG;힌트/NNG;줄/VV,28,0.3960074202379775,Dovish
5,11, 자치주/NNG,16,0.6600123670632958,Dovish
4,13, 미/NNG;국채/NNG;가격/NNG;강세/NNG,17,0.44677760231976943,Dovish
10,48,자율협약/NNG,58,0.30250566823734387,Dovish
2,18, 국채/NNG;금리/NNG;경제/NNG;지표/NNG;부진/NNG,20,0.16133635639325009,Dovish
11,22, 예상/NNG;밑돌/VV;증가/NNG,33,0.7260136037696254,Dovish
6,18, 반고/NNG,24,0.4840090691797503,Dovish
7,16, 정책/NNG;목표/NNG;물가/NNG;안정/NNG,23,0.6352619032984222,Dovish
4,14, 보관함/NNG,18,0.41486491643978596,Dovish
5,13, 제작소/NNG,18,0.5584720028997119,Dovish
6,13, 樂/NNG,19,0.6701664034796543,Dovish
5,13, 위험/NNG;지표/NNG;안정/NNG,18,0.5584720028997119,Dovish
19,56, 트램/NNG,75,0.4926520882722459,Dovish
3,24, 주택/NNG;착공/NNG;실적/NNG;증가/NNG,27,0.18150340094240636,Dovish
3,17, fed/NNG;노동시장/NNG;개선/NNG,20,0.25624009544810306,Dovish
9,22, 인상/NNG;가능성/NNG;낮/VV,31,0.5940111303569663,Dovish
6,12, 헤알/NNG;환율/NNG;방어/NNG,18,0.7260136037696254,Dovish
7,16, 유로존/NNG;확산/NNG,23,0.6352619032984222,Dovish
9,24, 펀더멘털/NNG;기초/NNG;여건/NNG;개선/NNG,33,0.5445102028272191,Dovish
3,18, 공포지수/NNG;급등/NNG,21,0.24200453458987514,Dovish
17,33, 은행상장지수/NNG,50,0.7480140160050687,Dovish
11,27, 접해/VV,38,0.5915666401085836,Dovish
1,15, 그리스사태/NNG;금리/NNG;인상/NNG,16,0.09680181383595005,Dovish
9,18, 글로벌/NNG;금융시장/NNG;불확실성/NNG;확대/NNG,27,0.7260136037696254,Dovish
0,16, 열사병/NNG,16,0.0,Dovish
7,36, 민박/NNG,43,0.28233862368818763,Dovish
5,13, 재정위기/NNG;금리/NNG;인상/NNG,18,0.5584720028997119,Dovish
2,26,공동선언문/NNG,28,0.11169440057994236,Dovish
4,12, 가계/NNG;대출/NNG;안정/NNG,16,0.4840090691797502,Dovish
4,23, 양우/NNG,27,0.2525264708763914,Dovish
7,17, 코픽스/NNG;시장/NNG;금리/NNG;변동/NNG;작/VA,24,0.5978935560455738,Dovish
7,14, 재정위기/NNG;경기/NNG;침체/NNG,21,0.7260136037696254,Dovish
10,21, fed/NNG;금리/NNG;인상/NNG;늦/VA,31,0.6914415273996433,Dovish
16,38, 유네스코/NNG,54,0.6113798768586319,Dovish
4,12, 경제/NNG;외부충격/NNG,16,0.4840090691797502,Dovish
14,39, 베이시스/NNG;역전폭/NNG;확대/NNG,53,0.5212405360397311,Dovish
5,12, 지수/NNG;넘/VV;오르/VV,17,0.6050113364746877,Dovish
6,18,군대/NNG,24,0.4840090691797503,Dovish
11,25, 인플레이션/NNG;목표/NNG;오르/VV,36,0.6388919713172704,Dovish
3,18, 대출/NNG;철회/NNG,21,0.24200453458987514,Dovish
45,103, 파킹/NNG,148,0.634380818827828,Dovish
1,20, 경제/NNG;서서히/MAG;살/VV,21,0.07260136037696253,Dovish
5,16, 수목원/NNG,21,0.4537585023560159,Dovish
4,13, 어려워하/VV,17,0.44677760231976943,Dovish
14,31,보이스피싱/NNG,45,0.6557542227596617,Dovish
12,23, 금리/NNG;대출/NNG;확대/NNG,35,0.7575794126291744,Dovish
6,20,권세/NNG,26,0.43560816226177523,Dovish
5,11, 구매/NNG;감소/NNG,16,0.6600123670632958,Dovish
10,24, 코픽스/NNG;하락/NNG,34,0.6050113364746877,Dovish
5,11, 뵐/VV,16,0.6600123670632958,Dovish
0,18, 모유/NNG,18,0.0,Dovish
4,13, 국채/NNG;가격/NNG;내림/NNG,17,0.44677760231976943,Dovish
11,31, irs/NNG;금리/NNG;소폭/MAG;하락/NNG,42,0.5152354607397341,Dovish
5,19,온렌딩/NNG,24,0.38211242303664494,Dovish
4,21, 가계/NNG;소득/NNG;확충/NNG,25,0.27657661095985725,Dovish
10,24, 서원/NNG,34,0.6050113364746877,Dovish
3,18, 임형/NNG,21,0.24200453458987514,Dovish
4,12, 토사/NNG,16,0.4840090691797502,Dovish
12,31, 부진/NNG;내리/VV,43,0.5620750480797101,Dovish
13,30, 신용조회회사/NNG,43,0.6292117899336753,Dovish
10,28, 보행/NNG,38,0.5185811455497324,Dovish
4,13, crs/NNG;거래/NNG;많/VA;않/VX,17,0.44677760231976943,Dovish
7,14, 구조조정/NNG;금리/NNG;인상/NNG,21,0.7260136037696254,Dovish
17,46, 위험/NNG;거래/NNG;회피/NNG,63,0.5366187506123319,Dovish
6,19, 수익형/NNG;부동산/NNG;관심/NNG;높/VA,25,0.458534907643974,Dovish
1,15, 원격의료/NNG,16,0.09680181383595005,Dovish
6,13, 금리/NNG;인상/NNG;신호/NNG;강화/NNG,19,0.6701664034796543,Dovish
5,13,한미연합훈련/NNG,18,0.5584720028997119,Dovish
10,21,기준시/NNG,31,0.6914415273996433,Dovish
6,13, 아이핀/NNG,19,0.6701664034796543,Dovish
2,16, 곰탕/NNG,18,0.18150340094240633,Dovish
8,16, 코픽스/NNG;상승/NNG,24,0.7260136037696253,Dovish
5,14, fed/NNG;경제/NNG;전망/NNG;하향/NNG,19,0.5185811455497324,Dovish
41,100,출처/NNG,141,0.5953311550910929,Dovish
7,18, 변동성/NNG;확대/NNG;경계/NNG,25,0.5646772473763753,Dovish
4,14,배후/NNG,18,0.41486491643978596,Dovish
6,13,현장방문/NNG,19,0.6701664034796543,Dovish
7,24, 국채/NNG;금리/NNG;소폭/MAG;오르/VV,31,0.42350793553228144,Dovish
11,24, 긴급생계자금/NNG,35,0.6655124701221565,Dovish
7,18,원창/NNG,25,0.5646772473763753,Dovish
6,12, 토지리턴제/NNG,18,0.7260136037696254,Dovish
4,37, 경징계/NNG,41,0.15697591432856764,Dovish
13,44, 완화/NNG;보류/NNG,57,0.42900803859114234,Dovish
19,42, 안전자산/NNG;선호/NNG;오르/VV,61,0.6568694510296611,Dovish
4,16,통방문구/NNG,20,0.36300680188481266,Dovish
16,41,통화정책방향문/NNG,57,0.5666447639177564,Dovish
3,26, 경기/NNG;부양/NNG;기대/NNG;크/VV,29,0.16754160086991357,Dovish
6,15,별관/NNG,21,0.5808108830157004,Dovish
33,108,하우스푸어/NNG,141,0.4436749800814377,Dovish
7,27,최저보증이율/NNG,34,0.37645149825091684,Dovish
8,20, 국고채/NNG;지표물/NNG;떨어/VV,28,0.5808108830157003,Dovish
3,18,회차/NNG,21,0.24200453458987514,Dovish
5,14, 채권/NNG;투자/NNG;늘/VV,19,0.5185811455497324,Dovish
6,16,유럽통계청/NNG,22,0.5445102028272191,Dovish
6,25, 사통팔달/NNG,31,0.34848652980942024,Dovish
15,48,통안계정/NNG,63,0.45375850235601584,Dovish
6,31,재정위험국/NNG,37,0.28103752403985505,Dovish
4,12, 금리/NNG;약하/VA,16,0.4840090691797502,Dovish
5,11, 고용/NNG;지표/NNG;예상/NNG;양호/NNG,16,0.6600123670632958,Dovish
3,19, 금리/NNG;인상/NNG;기대/NNG;강세/NNG,22,0.229267453821987,Dovish
7,32, 하단/NNG;견고/NNG,39,0.3176309516492111,Dovish
3,13, 투모/NNG,16,0.33508320173982714,Dovish
3,17, 원달러/NNG;하락/NNG;원화/NNG;강세/NNG,20,0.25624009544810306,Dovish
5,22,사회기반시설/NNG,27,0.3300061835316479,Dovish
15,35, 바젤iii/NNG,50,0.6222973746596789,Dovish
1,25, 시형/NNG,26,0.05808108830157003,Dovish
4,16, 금리/NNG;위험자산/NNG;선호/NNG,20,0.36300680188481266,Dovish
5,17, 와일드카드/NNG,22,0.42706682574683846,Dovish
5,28, 좌회전/NNG,33,0.2592905727748662,Dovish
89,207,트위터/NNG,296,0.6243015529999677,Dovish
5,11, 소방대원/NNG,16,0.6600123670632958,Dovish
8,33, 자국/NNG;통화/NNG;떨어/VV,41,0.3520065957670911,Dovish
9,20, 증강현실/NNG,29,0.6534122433926629,Dovish
5,11, 위험/NNG;회피/NNG;확대/NNG,16,0.6600123670632958,Dovish
19,43, 부동산/NNG;내리/VV,62,0.6415934172847853,Dovish
2,17,염동/NNG,19,0.17082673029873535,Dovish
13,32, 통화/NNG;내리/VV,45,0.5898860530628207,Dovish
2,14,외교통/NNG,16,0.20743245821989298,Dovish
5,21, 복합재료/NNG,26,0.34572076369982163,Dovish
12,25,심교/NNG,37,0.6969730596188405,Dovish
3,15, 자가보유율/NNG,18,0.2904054415078502,Dovish
50,150, 새희망홀씨대출/NNG,200,0.4840090691797503,Dovish
6,25, 경기/NNG;부양/NNG;실패/NNG,31,0.34848652980942024,Dovish
8,23, 양적완화/NNG;부작용/NNG,31,0.5050529417527828,Dovish
18,40, 주혼/NNG,58,0.6534122433926629,Dovish
7,22, 서부텍사스산원유/NNG;상승/NNG,29,0.4620086569443071,Dovish
20,46,유암/NNG,66,0.6313161771909785,Dovish
2,20, 시중/NNG;자금/NNG;풀/VV,22,0.14520272075392507,Dovish
4,13, 지표/NNG;부진/NNG;fed/NNG;양적완화/NNG,17,0.44677760231976943,Dovish
9,19, 대차대조표/NNG;확대/NNG,28,0.687802361465961,Dovish
7,25,중도파/NNG,32,0.40656761811099024,Dovish
10,25, 양적완화/NNG;풀/VV,35,0.5808108830157004,Dovish
5,11, 양적완화/NNG;경기/NNG;회복/NNG,16,0.6600123670632958,Dovish
5,11, 경제/NNG;금융안정/NNG;부정적/VAX,16,0.6600123670632958,Dovish
4,23, bei/NNG;상승/NNG,27,0.2525264708763914,Dovish
7,16, 누리집/NNG,23,0.6352619032984222,Dovish
2,19,통화전쟁/NNG,21,0.15284496921465798,Dovish
2,23, 구분등기/NNG,25,0.1262632354381957,Dovish
8,18, 통화/NNG;낮/VV,26,0.6453454255730003,Dovish
5,11, 하단/NNG;개입/NNG;경계/NNG,16,0.6600123670632958,Dovish
4,12, 금리/NNG;역대/NNG;최저/NNG;떨어/VV,16,0.4840090691797502,Dovish
16,31, 달러위안/NNG;환율/NNG;상승/NNG,47,0.7494333974396133,Dovish
7,21, 매출/NNG;예상/NNG;상회/NNG,28,0.4840090691797503,Dovish
2,16, 양적완화/NNG;금리/NNG;인상/NNG,18,0.18150340094240633,Dovish
2,14, 관상/NNG,16,0.20743245821989298,Dovish
29,59,알파벳/NNG,88,0.7137082884514961,Dovish
5,14,교직원/NNG,19,0.5185811455497324,Dovish
6,14, 집단/NNG;대출/NNG;관리/NNG;강화/NNG,20,0.622297374659679,Dovish
3,16,정량/NNG,19,0.27225510141360953,Dovish
3,19,노란우산공제/NNG,22,0.229267453821987,Dovish
6,24, 단교/NNG,30,0.3630068018848127,Dovish
28,69,동반성/NNG,97,0.5892284320449134,Dovish
4,13, 물가채/NNG;강세/NNG,17,0.44677760231976943,Dovish
4,14, 감산/NNG;없/VA,18,0.41486491643978596,Dovish
20,52,새희망홀씨대출/NNG,72,0.5584720028997119,Dovish
3,13, 유출/NNG;위험/NNG,16,0.33508320173982714,Dovish
5,14, 고용/NNG;지표/NNG;상승/NNG,19,0.5185811455497324,Dovish
5,12,외대/NNG,17,0.6050113364746877,Dovish
0,17, 고용/NNG;지표/NNG;호조/NNG;약세/NNG,17,0.0,Dovish
6,27, 국채/NNG;금리/NNG;하락/NNG;압력/NNG,33,0.32267271278650017,Dovish
9,18, 세계/NNG;경제/NNG;불확실성/NNG;크/VV,27,0.7260136037696254,Dovish
5,14,발행사별/NNG,19,0.5185811455497324,Dovish
6,13, 창봉/NNG,19,0.6701664034796543,Dovish
5,15, 하락/NNG;압력/NNG;상쇄/NNG,20,0.48400906917975023,Dovish
5,13, 인상/NNG;가능성/NNG;인상/NNG,18,0.5584720028997119,Dovish
6,19, 불확실성/NNG;투자심리/NNG;위축/NNG,25,0.458534907643974,Dovish
8,16, 위험자산/NNG;투자심리/NNG;위축/NNG,24,0.7260136037696253,Dovish
8,24, 롱심리/NNG;강화/NNG,32,0.4840090691797502,Dovish
16,47,특임/NNG,63,0.4943071344814471,Dovish
4,14, 자국/NNG;경기/NNG;회복/NNG,18,0.41486491643978596,Dovish
6,15, 전세/NNG;상승/NNG,21,0.5808108830157004,Dovish
2,17, 우려/NNG;fed/NNG;양적완화/NNG,19,0.17082673029873535,Dovish
5,15, 금/NNG;수요/NNG;줄/VV,20,0.48400906917975023,Dovish
20,43, 견준/VV,63,0.6753614918787213,Dovish
13,32,딤섬본드/NNG,45,0.5898860530628207,Dovish
6,16, 북한리스크/NNG;크/VV,22,0.5445102028272191,Dovish
6,13, ecb/NNG;국채/NNG;매입/NNG;확대/NNG,19,0.6701664034796543,Dovish
6,17,連/NNG,23,0.5124801908962061,Dovish
7,17, 카바/NNG,24,0.5978935560455738,Dovish
5,21, 롱플레이/NNG;제한/NNG,26,0.34572076369982163,Dovish
11,28, 현물/NNG;채권/NNG;가격/NNG;상승/NNG,39,0.5704392601047057,Dovish
5,11, 管/NNG,16,0.6600123670632958,Dovish
10,22, 불확실성/NNG;없애/VV,32,0.6600123670632958,Dovish
11,23, 현물/NNG;채권/NNG;가격/NNG;하락/NNG,34,0.6944477949100765,Dovish
6,21, fed/NNG;실업률/NNG;내리/VV,27,0.41486491643978596,Dovish
4,14,중위소득/NNG,18,0.41486491643978596,Dovish
4,25, 해상사격훈련/NNG,29,0.23232435320628012,Dovish
3,17,조던/NNG,20,0.25624009544810306,Dovish
2,20, 폭침/NNG,22,0.14520272075392507,Dovish
5,11, 사유서/NNG,16,0.6600123670632958,Dovish
17,40,국금/NNG,57,0.6171115632041816,Dovish
7,23, 중소기업적합업종/NNG,30,0.441921324033685,Dovish
3,15,실물량/NNG,18,0.2904054415078502,Dovish
1,16, 묘년/NNG,17,0.09075170047120316,Dovish
8,16, 상일/NNG,24,0.7260136037696253,Dovish
5,11, 變/NNG,16,0.6600123670632958,Dovish
4,16,이남/NNG,20,0.36300680188481266,Dovish
11,30, 미/NNG;지표/NNG;호조/NNG,41,0.5324099760977252,Dovish
6,22, 실적/NNG;시장/NNG;예상/NNG;밑돌/VV,28,0.3960074202379775,Dovish
9,21, 세난/NNG,30,0.6222973746596789,Dovish
8,16, 주문/NNG;밀려들/VV,24,0.7260136037696253,Dovish
20,40,선성/NNG,60,0.7260136037696254,Dovish
4,18, 가계/NNG;부채/NNG;급증/NNG;우려/NNG,22,0.32267271278650017,Dovish
97,256, 선매출/NNG,353,0.5501821841066693,Dovish
16,36, 가대/NNG,52,0.6453454255730003,Dovish
4,16, 평야/NNG,20,0.36300680188481266,Dovish
6,14, 솔벤/NNG,20,0.622297374659679,Dovish
15,61, 고용/NNG;실망/NNG,76,0.3570558707063731,Dovish
5,15, 인플레이션/NNG;바닥/NNG,20,0.48400906917975023,Dovish
5,13, 특별계획구역/NNG,18,0.5584720028997119,Dovish
9,31, 전용률/NNG,40,0.42155628605978257,Dovish
4,14, 재정정책/NNG;경기/NNG;회복/NNG,18,0.41486491643978596,Dovish
14,34, 금/NNG;가격/NNG;낙폭/NNG;제한/NNG,48,0.5978935560455738,Dovish
7,28, 인플레이션/NNG;fed/NNG;목표/NNG;밑돌/VV,35,0.3630068018848127,Dovish
9,31, 우려/NNG;하락/NNG;압력/NNG,40,0.42155628605978257,Dovish
7,18, 숏플레이/NNG;부담/NNG,25,0.5646772473763753,Dovish
7,14, 전세가격/NNG;많이/MAG;오르/VV,21,0.7260136037696254,Dovish
20,43,뱅크론/NNG,63,0.6753614918787213,Dovish
5,12,빙/MAG,17,0.6050113364746877,Dovish
7,21,골드바/NNG,28,0.4840090691797503,Dovish
6,17,가구수/NNG,23,0.5124801908962061,Dovish
377,922, 혜신/NNG,1299,0.5937247909352469,Dovish
6,25, 가계/NNG;부채/NNG;문제/NNG;우려/NNG,31,0.34848652980942024,Dovish
10,20,연합자산관리/NNG,30,0.7260136037696254,Dovish
10,23,스크린/NNG,33,0.6313161771909785,Dovish
7,15,인유/NNG,22,0.6776126968516504,Dovish
6,12,마두/NNG,18,0.7260136037696254,Dovish
5,37, 유가/NNG;낙폭/NNG;제한/NNG,42,0.19621989291070957,Dovish
4,28, 가계/NNG;부채/NNG;총량/NNG;줄/VV,32,0.20743245821989298,Dovish
1,46, 에스프리/NNG,47,0.031565808859548926,Dovish
6,74, 산토/NNG,80,0.11773193574642574,Dovish
3,16, 달러원/NNG;상승/NNG;크/VV,19,0.27225510141360953,Dovish
7,25, 아동학/NNG,32,0.40656761811099024,Dovish
5,28, 감찰관/NNG,33,0.2592905727748662,Dovish
9,35, 실업률/NNG;밑돌/VV,44,0.3733784247958074,Dovish
6,15,의사봉/NNG,21,0.5808108830157004,Dovish
6,12, 소비자/NNG;심리/NNG;지수/NNG;떨어/VV,18,0.7260136037696254,Dovish
6,22, 절전/NNG,28,0.3960074202379775,Dovish
5,16, 가동/NNG;전면/NNG;중단/NNG,21,0.4537585023560159,Dovish
13,40, 금/NNG;가격/NNG;상승/NNG;제한/NNG,53,0.4719088424502565,Dovish
5,12, 불확실성/NNG;크/VV;안전자산/NNG;선호/NNG,17,0.6050113364746877,Dovish
8,20, 저라/VV,28,0.5808108830157003,Dovish
14,32,수니파/NNG,46,0.6352619032984222,Dovish
4,13, 대출보증보험/NNG,17,0.44677760231976943,Dovish
5,13, 안전자산/NNG;선호/NNG;줄/VV,18,0.5584720028997119,Dovish
5,14, 부채/NNG;증가/NNG;막/VV,19,0.5185811455497324,Dovish
23,60, 가계/NNG;부채/NNG;질적/VAX;구조/NNG;개선/NNG,83,0.5566104295567127,Dovish
19,48,착한/VA,67,0.5747607696509535,Dovish
9,23,반전세/NNG,32,0.5681845594718807,Dovish
6,27,주택임대차보호법/NNG,33,0.32267271278650017,Dovish
2,21,수출경합도/NNG,23,0.13828830547992862,Dovish
4,12, 경제/NNG;지표/NNG;개선/NNG;상승/NNG,16,0.4840090691797502,Dovish
5,11, fed/NNG;채권/NNG;매입/NNG;종료/NNG,16,0.6600123670632958,Dovish
12,38,새희망홀씨/NNG,50,0.458534907643974,Dovish
5,14, 비농업/NNG;고용/NNG;개선/NNG,19,0.5185811455497324,Dovish
19,43, 스마트금융/NNG,62,0.6415934172847853,Dovish
4,14,스파크/NNG,18,0.41486491643978596,Dovish
7,19, 전세/NNG;월세/NNG;전환/NNG;가속/NNG,26,0.5349573922513029,Dovish
7,15, 염수/NNG,22,0.6776126968516504,Dovish
9,30,임수/NNG,39,0.43560816226177523,Dovish
4,12, 오벨리스크/NNG,16,0.4840090691797502,Dovish
2,14,춘계/NNG,16,0.20743245821989298,Dovish
8,30,견본주택/NNG,38,0.3872072553438002,Dovish
7,15, opec/NNG;최대/NNG,22,0.6776126968516504,Dovish
8,16,딸/NNG,24,0.7260136037696253,Dovish
4,12,써니/NNG,16,0.4840090691797502,Dovish
18,51, 국채/NNG;가격/NNG;소폭/MAG;상승/NNG,69,0.5124801908962061,Dovish
4,20,성금요일/NNG,24,0.29040544150785014,Dovish
8,16, 양적완화/NNG;프로그램/NNG;종료/NNG,24,0.7260136037696253,Dovish
15,32, 변동성지수/NNG;내리/VV,47,0.6806377535340238,Dovish
3,15, 국채선물/NNG;상승/NNG;제한/NNG,18,0.2904054415078502,Dovish
4,13,외자운용원/NNG,17,0.44677760231976943,Dovish
5,18, 소비자/NNG;물가/NNG;상승률/NNG;전망/NNG;하향/NNG,23,0.4033408909831252,Dovish
5,16, 고용/NNG;예상/NNG;부진/NNG,21,0.4537585023560159,Dovish
6,21,우투/NNG,27,0.41486491643978596,Dovish
16,77,금소/NNG,93,0.3017199392289352,Dovish
5,16, 성장/NNG;우려/NNG;크/VV,21,0.4537585023560159,Dovish
5,11, 공공건설임대주택/NNG,16,0.6600123670632958,Dovish
5,13, 경제/NNG;성장/NNG;전망/NNG;악화/NNG,18,0.5584720028997119,Dovish
0,40, 그린리모델링/NNG,40,0.0,Dovish
6,13, 광공업/NNG;생산/NNG;예상/NNG;부진/NNG,19,0.6701664034796543,Dovish
6,15, 금융위기/NNG;저점/NNG,21,0.5808108830157004,Dovish
26,51,통방문/NNG,77,0.7402491646278533,Dovish
12,31, 고용/NNG;지표/NNG;시장/NNG;예상/NNG;밑돌/VV,43,0.5620750480797101,Dovish
5,12, 자당/NNG,17,0.6050113364746877,Dovish
12,31, 지수/NNG;마이너스/NNG;상승/NNG,43,0.5620750480797101,Dovish
2,15, 그리스사태/NNG;불확실성/NNG,17,0.1936036276719001,Dovish
5,13, 양적완화/NNG;종료/NNG;우려/NNG,18,0.5584720028997119,Dovish
2,17, 최적지/NNG,19,0.17082673029873535,Dovish
5,12,감정/NNG,17,0.6050113364746877,Dovish
3,21,은성/NNG,24,0.20743245821989298,Dovish
5,13, 초단타매매/NNG,18,0.5584720028997119,Dovish
9,29,변양/NNG,38,0.45062913337425026,Dovish
3,15, 레포/NNG;금리/NNG;인하/NNG,18,0.2904054415078502,Dovish
4,17, 글로벌/NNG;경제/NNG;저성장/NNG,21,0.3416534605974707,Dovish
4,19,미즈/NNG,23,0.30568993842931597,Dovish
8,16,성과연봉제/NNG,24,0.7260136037696253,Dovish
4,12, 불안/NNG;대외/NNG;위험/NNG,16,0.4840090691797502,Dovish
4,24, 야영장/NNG,28,0.2420045345898751,Dovish
4,14, 경기/NNG;회복/NNG;부양/NNG,18,0.41486491643978596,Dovish
6,14, 비식/NNG,20,0.622297374659679,Dovish
7,15, 글로벌/NNG;성장/NNG;우려/NNG,22,0.6776126968516504,Dovish
56,145, 승표/NNG,201,0.5607829215324003,Dovish
8,25,민간고용조사/NNG,33,0.46464870641256023,Dovish
39,96, ecb/NNG;통화/NNG;완화/NNG,135,0.5898860530628206,Dovish
3,14, 제조업/NNG;pmi/NNG;떨어/VV,17,0.3111486873298395,Dovish
4,12, 폴락/MAG,16,0.4840090691797502,Dovish
16,47, 국채선물/NNG;금리/NNG;하락/NNG,63,0.4943071344814471,Dovish
9,21,통화금융대책반회의/NNG,30,0.6222973746596789,Dovish
5,27, 소기업낙관지수/NNG;하락/NNG,32,0.26889392732208345,Dovish
5,12, 국제사법재판소/NNG,17,0.6050113364746877,Dovish
5,13, 전망/NNG;하방/NNG;위험/NNG;크/VV,18,0.5584720028997119,Dovish
10,58, 주거비/NNG;부담/NNG;완화/NNG,68,0.25034951854125015,Dovish
2,14, 국채/NNG;많/VA,16,0.20743245821989298,Dovish
2,14, 자본/NNG;유출/NNG;가능성/NNG;낮/VA,16,0.20743245821989298,Dovish
9,19, 잭슨홀콘퍼런스/NNG,28,0.687802361465961,Dovish
2,18, 노출액/NNG,20,0.16133635639325009,Dovish
10,20,소셜미디어/NNG,30,0.7260136037696254,Dovish
5,45, 응찰비율/NNG,50,0.16133635639325009,Dovish
2,19, 가계/NNG;부채/NNG;소비/NNG;제약/NNG,21,0.15284496921465798,Dovish
4,16, 국채/NNG;금리/NNG;오르/VV;그치/VV,20,0.36300680188481266,Dovish
20,48, 동산담보대출/NNG,68,0.6050113364746877,Dovish
5,15, 서대문/NNG,20,0.48400906917975023,Dovish
5,11, 대외/NNG;건전성/NNG;안정/NNG,16,0.6600123670632958,Dovish
8,16, 고용/NNG;예상/NNG;밑돌/VV,24,0.7260136037696253,Dovish
5,13, 국채선물/NNG;거래/NNG;계약/NNG;줄/VV,18,0.5584720028997119,Dovish
5,12, 엔젤투자/NNG,17,0.6050113364746877,Dovish
7,30, 고용/NNG;지표/NNG;약화/NNG,37,0.3388063484258252,Dovish
7,21, 연체/NNG;이자율/NNG;인하/NNG,28,0.4840090691797503,Dovish
9,22, 양적완화/NNG;지지/NNG,31,0.5940111303569663,Dovish
3,14, 수도권광역급행철도/NNG,17,0.3111486873298395,Dovish
4,12, 차입청산/NNG,16,0.4840090691797502,Dovish
7,14,임대인/NNG,21,0.7260136037696254,Dovish
9,26, 지수/NNG;cac40/NNG;오르/VV,35,0.5026248026097407,Dovish
7,22,당수/NNG,29,0.4620086569443071,Dovish
5,13, 테르/NNG,18,0.5584720028997119,Dovish
4,12, 추분/NNG,16,0.4840090691797502,Dovish
28,65, 국고채/NNG;금리/NNG;혼조/NNG,93,0.6254886432476773,Dovish
10,22, 위험자산/NNG;우호적/VAX,32,0.6600123670632958,Dovish
3,16, 링크트인/NNG,19,0.27225510141360953,Dovish
0,17,동반성장위원회/NNG,17,0.0,Dovish
7,14, 나인/NNG,21,0.7260136037696254,Dovish
4,30, 비둘기/NNG;쏟/VV,34,0.1936036276719001,Dovish
6,22, 범유럽권/NNG,28,0.3960074202379775,Dovish
12,28, 국채/NNG;금리/NNG;경제/NNG;지표/NNG;호조/NNG,40,0.622297374659679,Dovish
3,15, 공동선/NNG,18,0.2904054415078502,Dovish
2,20, 인플레이션/NNG;하방/NNG;위험/NNG,22,0.14520272075392507,Dovish
3,14,신뢰수준/NNG,17,0.3111486873298395,Dovish
10,22, 고용/NNG;지표/NNG;호조/NNG;하락/NNG,32,0.6600123670632958,Dovish
3,18,정각/NNG,21,0.24200453458987514,Dovish
8,43, 리니언시/NNG,51,0.2701445967514885,Dovish
13,26, 노동시장/NNG;구조/NNG;개선/NNG,39,0.7260136037696254,Dovish
9,20, crs/NNG;떨어/VV,29,0.6534122433926629,Dovish
3,13, 펀더멘털/NNG;기초/NNG;여건/NNG;양호/NNG,16,0.33508320173982714,Dovish
9,28, 글로벌/NNG;위험자산/NNG;선호/NNG;강화/NNG,37,0.46672303099475926,Dovish
0,21, 가계/NNG;부채/NNG;총량/NNG;늘/VV,21,0.0,Dovish
15,30,전세가율/NNG,45,0.7260136037696253,Dovish
2,17, 부채/NNG;개선/NNG,19,0.17082673029873535,Dovish
6,13, 경기/NNG;좀처럼/MAG;살/VV;않/VX,19,0.6701664034796543,Dovish
6,14, ecb/NNG;예상밖/NNG;금리/NNG;인하/NNG,20,0.622297374659679,Dovish
1,16, 디폴트/NNG;우려/NNG;증폭/NNG,17,0.09075170047120316,Dovish
76,203,범유럽권/NNG,279,0.5436160974038575,Dovish
4,12,가결/NNG,16,0.4840090691797502,Dovish
8,27, ftse/NNG;지수/NNG;하락/NNG,35,0.4302302837153335,Dovish
5,16, ftse/NNG;지수/NNG;떨어/VV,21,0.4537585023560159,Dovish
2,18, 유로존/NNG;국채/NNG;금리/NNG;상승/NNG,20,0.16133635639325009,Dovish
5,16, 대외변수/NNG;많/VA,21,0.4537585023560159,Dovish
6,14,기한이익상실/NNG,20,0.622297374659679,Dovish
5,12,밴/VV,17,0.6050113364746877,Dovish
14,30, 금융안정/NNG;우려/NNG,44,0.6776126968516504,Dovish
4,17, 단기/NNG;지표/NNG;금리/NNG;개선/NNG,21,0.3416534605974707,Dovish
4,15, 워크아웃/NNG;기업/NNG;재무구조/NNG;개선/NNG,19,0.3872072553438002,Dovish
5,13, 유로존/NNG;경제/NNG;하방/NNG;위험/NNG,18,0.5584720028997119,Dovish
2,15, 가계/NNG;부채/NNG;증가/NNG;꺾/VV,17,0.1936036276719001,Dovish
1,22, 유로존/NNG;지표/NNG;부진/NNG,23,0.06600123670632958,Dovish
5,47, 특별계정채권/NNG,52,0.15447097952545222,Dovish
9,30, 서비스업/NNG;pmi/NNG;낮/VA,39,0.43560816226177523,Dovish
7,23, ftse/NNG;지수/NNG;오르/VV,30,0.441921324033685,Dovish
7,25,누리과정/NNG,32,0.40656761811099024,Dovish
0,23,유로안정화기구/NNG,23,0.0,Dovish
2,18, 유로존/NNG;국채입찰/NNG;호조/NNG,20,0.16133635639325009,Dovish
3,16, 금리/NNG;인하/NNG;재정/NNG;확대/NNG,19,0.27225510141360953,Dovish
12,37, 산천/NNG,49,0.47092774298570295,Dovish
2,17, 달라집니다/VV,19,0.17082673029873535,Dovish
3,13, ftse/NNG;지수/NNG;내리/VV,16,0.33508320173982714,Dovish
0,18, 제조업/NNG;지표/NNG;좋/VA,18,0.0,Dovish
1,24, 페이팔/NNG,25,0.06050113364746877,Dovish
10,29, 경제/NNG;지표/NNG;호조/NNG;하락/NNG,39,0.5006990370825003,Dovish
5,25, 오픈프라이머리/NNG,30,0.2904054415078502,Dovish
5,14, 고용/NNG;추세/NNG;지수/NNG;상승/NNG,19,0.5185811455497324,Dovish
5,18, 지표/NNG;취약/NNG,23,0.4033408909831252,Dovish
10,28, 국채입찰/NNG;긍정적/VAX,38,0.5185811455497324,Dovish
2,17, ecb/NNG;위험/NNG,19,0.17082673029873535,Dovish
2,21, 매번/NNG,23,0.13828830547992862,Dovish
11,30, 유가/NNG;경제/NNG;지표/NNG;호조/NNG,41,0.5324099760977252,Dovish
4,13,태백/NNG,17,0.44677760231976943,Dovish
5,11, 수요/NNG;최저/NNG,16,0.6600123670632958,Dovish
8,16, 유로존/NNG;경제/NNG;지표/NNG;개선/NNG,24,0.7260136037696253,Dovish
1,21, 통화/NNG;완화정책/NNG;선호/NNG,22,0.06914415273996431,Dovish
8,57, 짬짜미/NNG,65,0.2037932922862106,Dovish
3,14, 부진/NNG;경기/NNG;우려/NNG,17,0.3111486873298395,Dovish
7,24, 취업규칙/NNG,31,0.42350793553228144,Dovish
3,15,스파이/NNG,18,0.2904054415078502,Dovish
3,18, 금리/NNG;인하/NNG;순이자마진/NNG;하락/NNG,21,0.24200453458987514,Dovish
2,15, cd/NNG;민평/NNG;금리/NNG;낮/VA,17,0.1936036276719001,Dovish
2,25, fed/NNG;금리/NNG;오르/VV;인상/NNG,27,0.11616217660314006,Dovish
4,13, 아문/VV,17,0.44677760231976943,Dovish
12,25, 무인기/NNG,37,0.6969730596188405,Dovish
18,36, 저성장/NNG;늪/NNG;빠지/VV,54,0.7260136037696254,Dovish
4,19, 대출/NNG;조건/NNG;충족/NNG,23,0.30568993842931597,Dovish
2,15, 의장도/NNG,17,0.1936036276719001,Dovish
234,846,새누리당/NNG,1080,0.4016245467661757,Dovish
14,56, 유커/NNG,70,0.3630068018848127,Dovish
7,20, 전미공급관리자협회/NNG,27,0.5082095226387378,Dovish
73,241, 현덕/NNG,314,0.43982566867371503,Dovish
3,14, 구조개혁/NNG;강화/NNG,17,0.3111486873298395,Dovish
4,18, 전망/NNG;상승/NNG;밑돌/VV,22,0.32267271278650017,Dovish
18,46,예진/NNG,64,0.5681845594718807,Dovish
23,77, 파생결합사채/NNG,100,0.43372241264159433,Dovish
4,13, 예진/NNG,17,0.44677760231976943,Dovish
6,12, 아바/NNG,18,0.7260136037696254,Dovish
10,41, 장거리로켓/NNG,51,0.35415297744859775,Dovish
6,14, 수용률/NNG,20,0.622297374659679,Dovish
9,18, 글로벌/NNG;국채/NNG;금리/NNG;급등/NNG,27,0.7260136037696254,Dovish
5,11, 미/NNG;국채/NNG;금리/NNG;넘/VV,16,0.6600123670632958,Dovish
5,17,스마트금융/NNG,22,0.42706682574683846,Dovish
4,12,장거리로켓/NNG,16,0.4840090691797502,Dovish
10,25, 사회관계망/NNG,35,0.5808108830157004,Dovish
2,16,쿠싱/NNG,18,0.18150340094240633,Dovish
9,50, 수출/NNG;지표/NNG;부진/NNG,59,0.2613648973570652,Dovish
4,17, 하락/NNG;경제/NNG;지표/NNG;부진/NNG,21,0.3416534605974707,Dovish
3,13, 부진/NNG;정치/NNG;불확실성/NNG,16,0.33508320173982714,Dovish
418,1076,계영/NNG,1494,0.5640774839697089,Dovish
2,14, 모독/NNG,16,0.20743245821989298,Dovish
18,60,헬리콥터머니/NNG,78,0.43560816226177523,Dovish
5,13, 채권펀드/NNG;수익률/NNG;상승/NNG,18,0.5584720028997119,Dovish
4,16, 소비자/NNG;태도/NNG;지수/NNG;상승/NNG,20,0.36300680188481266,Dovish
2,21, 월드클래스300/NNG,23,0.13828830547992862,Dovish
29,85,시리/NNG,114,0.4953975178663326,Dovish
18,132,그렉시트/NNG,150,0.19800371011898876,Dovish
2,21, 그렉시트/NNG;유로존/NNG;이탈/NNG,23,0.13828830547992862,Dovish
5,19, 상저하저/NNG,24,0.38211242303664494,Dovish
50,99, 역외/NNG;차액결제선물환/NNG;환율/NNG;하락/NNG,149,0.7333470745147731,Dovish
5,12, 데자뷔/NNG,17,0.6050113364746877,Dovish
5,54, 그렉시트/NNG;유로존/NNG;탈퇴/NNG;우려/NNG,59,0.13444696366104172,Dovish
4,21,출구조사/NNG,25,0.27657661095985725,Dovish
14,55,전단채/NNG,69,0.36960692555544566,Dovish
4,14, 지표/NNG;호조/NNG;지수/NNG;상승/NNG,18,0.41486491643978596,Dovish
55,151, 거시경제금융회의/NNG,206,0.5288840822162834,Dovish
3,13, ecb/NNG;금리/NNG;인하/NNG;양적완화/NNG,16,0.33508320173982714,Dovish
5,13, ecb/NNG;예금/NNG;금리/NNG;낮/VV,18,0.5584720028997119,Dovish
2,18, 리보조작사건/NNG,20,0.16133635639325009,Dovish
7,17, 정부3.0/NNG,24,0.5978935560455738,Dovish
5,20, 本/NNG,25,0.3630068018848127,Dovish
0,16, 감세/NNG;구매/NNG;확대/NNG,16,0.0,Dovish
7,15,북대서양/NNG,22,0.6776126968516504,Dovish
5,22, 육법/NNG,27,0.3300061835316479,Dovish
4,12, 통진/NNG,16,0.4840090691797502,Dovish
7,20,현윤/NNG,27,0.5082095226387378,Dovish
7,20, 인보험/NNG,27,0.5082095226387378,Dovish
2,35, 매출/NNG;시장/NNG;예상/NNG;밑돌/VV,37,0.08297298328795719,Dovish
9,20,불황형/NNG,29,0.6534122433926629,Dovish
3,18, 통제력/NNG;강화/NNG,21,0.24200453458987514,Dovish
6,38, 개인형퇴직연금/NNG,44,0.229267453821987,Dovish
5,18, 국채선물시장/NNG;국채/NNG;금리/NNG;하락/NNG,23,0.4033408909831252,Dovish
4,15,인텔리전스/NNG,19,0.3872072553438002,Dovish
14,37,중위험중수익/NNG,51,0.5494157001499868,Dovish
7,15, 금리/NNG;인하/NNG;양적완화/NNG;확대/NNG,22,0.6776126968516504,Dovish
7,17, 패브릭/NNG,24,0.5978935560455738,Dovish
0,19, 윤년/NNG,19,0.0,Dovish
5,12, 이모작/NNG,17,0.6050113364746877,Dovish
12,25, 국고채/NNG;금리/NNG;약세/NNG,37,0.6969730596188405,Dovish
94,189,오희/NNG,283,0.7221722619507384,Dovish
5,17, 혜란/NNG,22,0.42706682574683846,Dovish
11,29, 脈/NNG,40,0.5507689407907503,Dovish
5,14, 노중/NNG,19,0.5185811455497324,Dovish
5,11,통화정책방향결정회의/NNG,16,0.6600123670632958,Dovish
5,15, 기초/NNG;여건/NNG;좋/VA,20,0.48400906917975023,Dovish
23,57, 렌트푸어/NNG,80,0.5859057153228555,Dovish
4,13,미어/NNG,17,0.44677760231976943,Dovish
9,21, 임차가구/NNG,30,0.6222973746596789,Dovish
7,14, 부진/NNG;길/VA,21,0.7260136037696254,Dovish
48,114,염지/NNG,162,0.6113798768586319,Dovish
9,39,마이너스gdp/NNG,48,0.33508320173982714,Dovish
1,15, 장순/NNG,16,0.09680181383595005,Dovish
6,20,예림/NNG,26,0.43560816226177523,Dovish
7,14,렌트푸어/NNG,21,0.7260136037696254,Dovish
6,20, 금리/NNG;도입/NNG;최저/NNG,26,0.43560816226177523,Dovish
4,16, 교통편/NNG,20,0.36300680188481266,Dovish
44,94, 채권시장/NNG;국고채/NNG;지표/NNG;금리/NNG;내리/VV,138,0.6796723099119898,Dovish
3,16, 활력/NNG;저하/NNG,19,0.27225510141360953,Dovish
3,27, 제조업/NNG;pmi/NNG;오르/VV,30,0.16133635639325009,Dovish
1,37, 구제금융협상안/NNG,38,0.03924397858214191,Dovish
15,76,미결제량/NNG,91,0.2865843172774837,Dovish
14,42, 수출업체/NNG;네고/NNG;상단/NNG;제한/NNG,56,0.4840090691797503,Dovish
2,18, 제조업/NNG;pmi/NNG;소폭/MAG;상승/NNG,20,0.16133635639325009,Dovish
23,93, 패리티/NNG,116,0.35910350293981463,Dovish
5,12, 카페인/NNG,17,0.6050113364746877,Dovish
12,35,리스크오프/NNG,47,0.49783789972774317,Dovish
5,12, 전세가격/NNG;비율/NNG;넘/VV,17,0.6050113364746877,Dovish
4,14, 자금/NNG;수급/NNG;양호/NNG,18,0.41486491643978596,Dovish
6,18,앞쪽/NNG,24,0.4840090691797503,Dovish
2,14, 하락/NNG;여파/NNG;하락/NNG,16,0.20743245821989298,Dovish
10,20, 약하/VA;커브/NNG;스티프닝/NNG,30,0.7260136037696254,Dovish
5,11, 가계/NNG;부채/NNG;총량/NNG;증가/NNG,16,0.6600123670632958,Dovish
2,17,넥타이/NNG,19,0.17082673029873535,Dovish
3,32, 보타/NNG,35,0.13612755070680477,Dovish
3,13, 엇갈린다고/VV,16,0.33508320173982714,Dovish
6,37,거시건전성3종세트/NNG,43,0.23546387149285147,Dovish
1,20, 과감/NNG;금융/NNG;완화/NNG,21,0.07260136037696253,Dovish
5,15, 중수익/NNG;중위험/NNG,20,0.48400906917975023,Dovish
17,34, 포용적성장/NNG,51,0.7260136037696254,Dovish
73,150, irs/NNG;오르/VV,223,0.7066532410024354,Dovish
3,25, 국고채/NNG;지표물/NNG;높/VA,28,0.17424326490471012,Dovish
6,27, 금리/NNG;역마진/NNG;위험/NNG,33,0.32267271278650017,Dovish
5,20, 고용/NNG;지표/NNG;시장/NNG;예상/NNG;웃돌/VV,25,0.3630068018848127,Dovish
26,62,국민행복기금/NNG,88,0.6089146354196858,Dovish
3,26, 혁신안/NNG,29,0.16754160086991357,Dovish
4,16, 코픽스/NNG;도입/NNG;최저/NNG,20,0.36300680188481266,Dovish
6,23, 가계/NNG;부채/NNG;질/NNG;악화/NNG,29,0.3787897063145872,Dovish
12,38,리스크온/NNG,50,0.458534907643974,Dovish
4,26, 강제저축/NNG,30,0.22338880115988471,Dovish
9,18,뒤쪽/NNG,27,0.7260136037696254,Dovish
27,96, 채권시장/NNG;국고채/NNG;지표/NNG;금리/NNG;상승/NNG,123,0.40838265212041425,Dovish
5,13,긴급거시경제금융회의/NNG,18,0.5584720028997119,Dovish
5,11, irs/NNG;채권시장/NNG;강세/NNG,16,0.6600123670632958,Dovish
123,538,아베노믹스/NNG,661,0.3319690455898287,Dovish
5,11, 세계/NNG;수요/NNG;부진/NNG,16,0.6600123670632958,Dovish
11,24, 청해진/NNG,35,0.6655124701221565,Dovish
31,112, 채권시장/NNG;국고채/NNG;지표/NNG;금리/NNG;하락/NNG,143,0.4019003878010427,Dovish
49,108, 국고채/NNG;지표/NNG;금리/NNG;하락/NNG,157,0.6587901219391046,Dovish
34,81, 후장가격/NNG,115,0.6094929019300559,Dovish
70,167, 시중/NNG;자금/NNG;많/VA;의미/NNG;반대/NNG,237,0.6086341588487878,Dovish
70,167, 자금/NNG;시중/NNG;자금/NNG;많/VA,237,0.6086341588487878,Dovish
68,167, 많/VA;필요/NNG;자금/NNG;작/VA,235,0.5912446114531082,Dovish
5,15, 인하/NNG;기대/NNG;살/VV,20,0.48400906917975023,Dovish
118,330,황병/NNG,448,0.5192097287564593,Dovish
91,207,태문/NNG,298,0.6383308013819894,Dovish
6,15, 롱심리/NNG;위축/NNG,21,0.5808108830157004,Dovish
0,19, 캡레이트/NNG,19,0.0,Dovish
1144,2697, 뉴욕후장가격/NNG,3841,0.6159136542176132,Dovish
47,107, 국채/NNG;가격/NNG;상승/NNG;견인/NNG,154,0.6378063434985494,Dovish
20,58, 국채/NNG;가격/NNG;상승/NNG;제한/NNG,78,0.5006990370825003,Dovish
29,71,현물인도/NNG,100,0.5930815354737784,Dovish
42,91, 국고채/NNG;지표/NNG;금리/NNG;상승/NNG,133,0.6701664034796543,Dovish
9,26, 지준변동요인/NNG,35,0.5026248026097407,Dovish
8,24, 국고채/NNG;금리/NNG;역대/NNG;최저/NNG,32,0.4840090691797502,Dovish
18,50,유승/NNG,68,0.5227297947141304,Dovish
16,37, 강규/NNG,53,0.6279036573142706,Dovish
8,16, 전망/NNG;국채/NNG;가격/NNG;하락/NNG,24,0.7260136037696253,Dovish
15,34, 국채/NNG;가격/NNG;하락/NNG;제한/NNG,49,0.6406002386202576,Dovish
47,137, 국채/NNG;가격/NNG;하락/NNG;압력/NNG,184,0.49814072083463345,Dovish
28,61, 국채/NNG;가격/NNG;낙폭/NNG;제한/NNG,89,0.6665042919852299,Dovish
57,179, 스왑베이시스/NNG;역전폭/NNG;늘/VV,236,0.46237737893707986,Dovish
4,24, 국채입찰/NNG;호조/NNG;상승/NNG,28,0.2420045345898751,Dovish
18,37, fed/NNG;실업률/NNG;떨어/VV,55,0.7063916144785545,Dovish
10,21, 경제활동참가율/NNG;낮/VA,31,0.6914415273996433,Dovish
10,42, 국채/NNG;가격/NNG;상승/NNG;축소/NNG,52,0.34572076369982163,Dovish
28,65,포워드가이던스/NNG,93,0.6254886432476773,Dovish
5,19,甘/NNG,24,0.38211242303664494,Dovish
3,17, irs/NNG;금리/NNG;인하/NNG,20,0.25624009544810306,Dovish
7,15, crs/NNG;irs/NNG;갭/NNG;스왑베이시스/NNG;축소/NNG,22,0.6776126968516504,Dovish
5,12, 인플레이션/NNG;목표/NNG;달성/NNG;어렵/VA,17,0.6050113364746877,Dovish
487,935,은실/NNG,1422,0.7562965241407649,Dovish
11,29, 지표/NNG;호조/NNG;하락/NNG,40,0.5507689407907503,Dovish
36,87, 경제매체/NNG,123,0.6008388444990004,Dovish
14,68, 국채/NNG;수익률/NNG;빠지/VV,82,0.2989467780227869,Dovish
9,19, 국채/NNG;매입세/NNG;강화/NNG,28,0.687802361465961,Dovish
5,18, 국채/NNG;금리/NNG;fed/NNG;양적완화/NNG,23,0.4033408909831252,Dovish
13,43, 국채/NNG;수익률/NNG;밀리/VV;최저/NNG,56,0.43898496972116885,Dovish
5,11, 가격/NNG;상방/NNG;경직/NNG,16,0.6600123670632958,Dovish
2,15, 금리/NNG;방향/NNG;불확실성/NNG,17,0.1936036276719001,Dovish
6,24, 높/VA;거래/NNG;마치/VV;오르/VV,30,0.3630068018848127,Dovish
3,17, 지표/NNG;실망/NNG;상승/NNG,20,0.25624009544810306,Dovish
2,15, 약화/NNG;국채/NNG;가격/NNG;상승/NNG,17,0.1936036276719001,Dovish
6,14, 임대료/NNG;인상/NNG;제한/NNG,20,0.622297374659679,Dovish
4,16, 국채선물시장/NNG;안전자산/NNG;선호/NNG,20,0.36300680188481266,Dovish
4,27, crs/NNG;달러원/NNG;상승/NNG,31,0.21511514185766675,Dovish
5,14, 완화정책/NNG;아니/VCN,19,0.5185811455497324,Dovish
12,52, 순이익/NNG;매출/NNG;시장/NNG;예상/NNG;웃돌/VV,64,0.33508320173982714,Dovish
4,15, 예상/NNG;웃돌/VV;넘/VV,19,0.3872072553438002,Dovish
7,14, 지표/NNG;호조/NNG;유가/NNG;상승/NNG,21,0.7260136037696254,Dovish
30,90,창조경제/NNG,120,0.48400906917975023,Dovish
7,21, 통안채/NNG;금리/NNG;오르/VV;통안채/NNG;높/VA,28,0.4840090691797503,Dovish
8,19, 국채선물시장/NNG;국채/NNG;금리/NNG;상승/NNG,27,0.6113798768586319,Dovish
12,29, 국채/NNG;매력/NNG;높/VV,41,0.6008388444990004,Dovish
4,12, 내구재/NNG;수주/NNG;실적/NNG;호조/NNG,16,0.4840090691797502,Dovish
3,14, 호조/NNG;국채/NNG;수익률/NNG;상승/NNG,17,0.3111486873298395,Dovish
7,20, irs/NNG;채권시장/NNG;약세/NNG,27,0.5082095226387378,Dovish
2,15, 채권/NNG;약세/NNG;압력/NNG,17,0.1936036276719001,Dovish
18,37, 황병/NNG,55,0.7063916144785545,Dovish
4,13, 실업률/NNG;떨어/VV;금리/NNG;인상/NNG,17,0.44677760231976943,Dovish
4,16, 우려/NNG;국채/NNG;가격/NNG;하락/NNG,20,0.36300680188481266,Dovish
79,154, 대차대조표/NNG;축소/NNG,233,0.7448710999714339,Dovish
5,12, 고용/NNG;극대/NNG;물가/NNG;안정/NNG,17,0.6050113364746877,Dovish
6,12, 금리/NNG;하락/NNG;압박/NNG,18,0.7260136037696254,Dovish
1,15, 과도/NNG;완화/NNG,16,0.09680181383595005,Dovish
6,13,사회적경제/NNG,19,0.6701664034796543,Dovish
28,85, 제조업/NNG;활동/NNG;호조/NNG,113,0.4783148448364591,Dovish
3,15, 인하/NNG;신호/NNG;없/VA,18,0.2904054415078502,Dovish
6,18,픽스/NNG,24,0.4840090691797503,Dovish
15,42, 국채/NNG;가격/NNG;긍정적/VAX,57,0.5185811455497324,Dovish
10,25, 위험/NNG;거래/NNG;약화/NNG,35,0.5808108830157004,Dovish
2,16, crs/NNG;irs/NNG;갭/NNG;스왑베이시스/NNG;확대/NNG,18,0.18150340094240633,Dovish
6,26, 통안채/NNG;금리/NNG;내리/VV;통안채/NNG;낮/VA,32,0.33508320173982714,Dovish
12,47, 안전자산/NNG;매입세/NNG;강화/NNG,59,0.37073035086108536,Dovish
33,79, 가격/NNG;강세/NNG;지지/NNG,112,0.606543010744244,Dovish
11,46, 높/VA;수익률/NNG;내리/VV,57,0.34722389745503823,Dovish
3,15, 국채입찰/NNG;견조/NNG,18,0.2904054415078502,Dovish
5,34, 달러엔/NNG;하락/NNG;압력/NNG,39,0.21353341287341923,Dovish
6,16, crs/NNG;달러원/NNG;하락/NNG,22,0.5445102028272191,Dovish
9,21, 긴급거시경제금융회의/NNG,30,0.6222973746596789,Dovish
8,22, 국채/NNG;수익률/NNG;근처/NNG;상승/NNG,30,0.5280098936506367,Dovish
7,23, 높/VA;수익률/NNG;밀리/VV,30,0.441921324033685,Dovish
6,23, 유로존/NNG;경제/NNG;지표/NNG;실망/NNG,29,0.3787897063145872,Dovish
31,69, rbc비율/NNG;하락/NNG,100,0.6523600497640113,Dovish
13,35, 베이시스/NNG;역전폭/NNG;축소/NNG,48,0.5393243913717217,Dovish
6,29,그레이트로테이션/NNG,35,0.3004194222495002,Dovish
3,13, 법외노조/NNG,16,0.33508320173982714,Dovish
7,14, 規/NNG,21,0.7260136037696254,Dovish
21,42,보험부채/NNG,63,0.7260136037696254,Dovish
15,33, fed/NNG;전미/NNG;활동/NNG;지수/NNG;마이너스/NNG,48,0.6600123670632958,Dovish
5,15, 지표/NNG;시장/NNG;예상/NNG;양호/NNG,20,0.48400906917975023,Dovish
5,36, 합성etf/NNG,41,0.2016704454915626,Dovish
11,29, 낙관/NNG;작/VA;비관/NNG,40,0.5507689407907503,Dovish
5,17, 국채입찰/NNG;수요/NNG;강하/VA,22,0.42706682574683846,Dovish
5,20, 유가/NNG;강세/NNG;견인/NNG,25,0.3630068018848127,Dovish
11,35, 미/NNG;경제/NNG;지표/NNG;긍정적/VAX,46,0.4563514080837645,Dovish
18,51, 안전자산/NNG;매입/NNG;세로/NNG;상승/NNG,69,0.5124801908962061,Dovish
4,12, 호조/NNG;국채/NNG;가격/NNG;상승/NNG,16,0.4840090691797502,Dovish
7,15, 역내포괄적경제동반자협정/NNG,22,0.6776126968516504,Dovish
3,23,허광/NNG,26,0.1893948531572936,Dovish
435,1260,이호/NNG,1695,0.5012951073647414,Dovish
43,90, 역외/NNG;차액결제선물환/NNG;환율/NNG;상승/NNG,133,0.6937463324909754,Dovish
8,19, 국채/NNG;금리/NNG;고용/NNG;지표/NNG;호조/NNG,27,0.6113798768586319,Dovish
10,24,배승/NNG,34,0.6050113364746877,Dovish
14,54, 국채/NNG;가격/NNG;고용/NNG;지표/NNG;호조/NNG,68,0.37645149825091684,Dovish
6,12, 실업률/NNG;최저/NNG;내리/VV,18,0.7260136037696254,Dovish
4,15, 지표/NNG;호조/NNG;fed/NNG;양적완화/NNG,19,0.3872072553438002,Dovish
48,115, 비농업/NNG;고용/NNG;지표/NNG;호조/NNG,163,0.6060635301033396,Dovish
5,15, irs/NNG;채권시장/NNG;강세/NNG;연동/NNG;하락/NNG,20,0.48400906917975023,Dovish
2,14, 국채/NNG;가격/NNG;증시/NNG;약세/NNG,16,0.20743245821989298,Dovish
3,33,교황/NNG,36,0.13200247341265917,Dovish
7,16,담뱃세/NNG,23,0.6352619032984222,Dovish
0,16, 소매/NNG;판매/NNG;경제/NNG;지표/NNG;호조/NNG,16,0.0,Dovish
229,526,국토교통부/NNG,755,0.6321563317994077,Dovish
7,27, crs/NNG;금리/NNG;소폭/MAG;하락/NNG,34,0.37645149825091684,Dovish
3,22, 원화채권/NNG;시장/NNG;강세/NNG,25,0.19800371011898876,Dovish
1,41, 키프로스사태/NNG,42,0.035415297744859776,Dovish
0,21,키프로스사태/NNG,21,0.0,Dovish
9,40, 국채/NNG;가격/NNG;낙폭/NNG;축소/NNG,49,0.32670612169633145,Dovish
2,105,국제채권단/NNG,107,0.027657661095985726,Dovish
6,15, 례모/NNG,21,0.5808108830157004,Dovish
5,35, 자산/NNG;매입/NNG;속도/NNG;늦/VV,40,0.20743245821989298,Dovish
13,45, 임대주택리츠/NNG,58,0.41947452662245027,Dovish
11,46, 원유/NNG;재고/NNG;예상/NNG;웃돌/VV,57,0.34722389745503823,Dovish
33,80, 국고채/NNG;지표/NNG;금리/NNG;내리/VV;하락/NNG,113,0.5989612231099408,Dovish
4,12, 경제/NNG;전망/NNG;영향/NNG;줄/VV,16,0.4840090691797502,Dovish
11,25, 국고채/NNG;지표/NNG;금리/NNG;오르/VV;높/VA,36,0.6388919713172704,Dovish
9,36,준공공임대주택/NNG,45,0.3630068018848127,Dovish
34,75, 준공공임대주택/NNG,109,0.6582523340844604,Dovish
2,14, 부동산/NNG;대책/NNG;금리/NNG;인하/NNG,16,0.20743245821989298,Dovish
3,13, 장기물/NNG;물량/NNG;부담/NNG,16,0.33508320173982714,Dovish
4,14, 매입/NNG;속도/NNG;늦/VV,18,0.41486491643978596,Dovish
130,392,코넥스/NNG,522,0.48153963515332293,Dovish
7,15, 성장사다리펀드/NNG,22,0.6776126968516504,Dovish
5,11,안행부/NNG,16,0.6600123670632958,Dovish
7,24, fed/NNG;채권/NNG;매입/NNG;축소/NNG,31,0.42350793553228144,Dovish
2,19, 국채/NNG;가격/NNG;낮/VA,21,0.15284496921465798,Dovish
8,26, 국고채/NNG;지표/NNG;금리/NNG;내리/VV;낮/VA,34,0.44677760231976943,Dovish
14,37, 베이시스/NNG;역전폭/NNG;줄/VV,51,0.5494157001499868,Dovish
7,15, 비농업/NNG;고용/NNG;지표/NNG;실망/NNG,22,0.6776126968516504,Dovish
6,20, 국채/NNG;금리/NNG;밀리/VV,26,0.43560816226177523,Dovish
6,15, 원달러/NNG;상승/NNG;원화/NNG;약세/NNG,21,0.5808108830157004,Dovish
5,15, 통안채/NNG;금리/NNG;오르/VV;통안채/NNG;상승/NNG,20,0.48400906917975023,Dovish
4,12, 매출/NNG;영업이익/NNG;감소/NNG,16,0.4840090691797502,Dovish
17,64, 국채선물/NNG;가격/NNG;상승/NNG;압력/NNG,81,0.38569472700261354,Dovish
4,13, 외부/NNG;금리/NNG;인하/NNG;압박/NNG,17,0.44677760231976943,Dovish
21,57,입법조사처/NNG,78,0.5349573922513029,Dovish
10,23, 예주/NNG,33,0.6313161771909785,Dovish
4,13, 토신/NNG,17,0.44677760231976943,Dovish
2,16,롱포지션청산/NNG,18,0.18150340094240633,Dovish
6,13, 안전자산/NNG;매수/NNG;강화/NNG,19,0.6701664034796543,Dovish
3,21, 창조기업/NNG,24,0.20743245821989298,Dovish
4,18,녹인/NNG,22,0.32267271278650017,Dovish
8,19,전미주택중개인협회/NNG,27,0.6113798768586319,Dovish
5,17, 예상/NNG;증폭/NNG,22,0.42706682574683846,Dovish
7,16, 국채입찰/NNG;강하/VA,23,0.6352619032984222,Dovish
10,20, 유병/NNG,30,0.7260136037696254,Dovish
34,83, 국채/NNG;가격/NNG;영향/NNG;상승/NNG,117,0.5948063259799341,Dovish
2,20,차병/NNG,22,0.14520272075392507,Dovish
9,23, 미/NNG;fed/NNG;비둘기/NNG,32,0.5681845594718807,Dovish
6,14, 호주달러/NNG;하락/NNG;압력/NNG,20,0.622297374659679,Dovish
4,13, 국채/NNG;금리/NNG;밀리/VV;최저/NNG,17,0.44677760231976943,Dovish
6,22, 단기/NNG;예금/NNG;금리/NNG;마이너스/NNG,28,0.3960074202379775,Dovish
10,22, 국채/NNG;금리/NNG;마이너스/NNG;떨어/VV,32,0.6600123670632958,Dovish
6,17, 가격/NNG;고용/NNG;지표/NNG;호조/NNG,23,0.5124801908962061,Dovish
6,12, 금리/NNG;고용/NNG;지표/NNG;호조/NNG,18,0.7260136037696254,Dovish
9,19, 미/NNG;고용/NNG;호조/NNG,28,0.687802361465961,Dovish
6,14, 국채/NNG;가격/NNG;단기/NNG;급락/NNG,20,0.622297374659679,Dovish
3,13, 서든스톱/NNG,16,0.33508320173982714,Dovish
15,38, 미일/NNG;금리갭/NNG;확대/NNG,53,0.5731686345549674,Dovish
10,24, opec/NNG;산유량/NNG;증가/NNG,34,0.6050113364746877,Dovish
22,44, 미/NNG;fed/NNG;양적완화/NNG;축소/NNG,66,0.7260136037696254,Dovish
5,15, 호조/NNG;fed/NNG;양적완화/NNG;축소/NNG,20,0.48400906917975023,Dovish
12,24, 양적완화/NNG;축소/NNG;우려/NNG;완화/NNG,36,0.7260136037696254,Dovish
12,34, 원화채권/NNG;환차손/NNG;우려/NNG,46,0.5124801908962061,Dovish
3,21, 예신/NNG,24,0.20743245821989298,Dovish
17,37, fed/NNG;테이퍼링/NNG;양적완화/NNG,54,0.6671476358964126,Dovish
7,19, 롱플레이/NNG;우위/NNG,26,0.5349573922513029,Dovish
4,14, 불안/NNG;양적완화/NNG;축소/NNG,18,0.41486491643978596,Dovish
3,14,화살/NNG,17,0.3111486873298395,Dovish
31,65, 국채/NNG;가격/NNG;영향/NNG;하락/NNG,96,0.6925052835956428,Dovish
6,15, 엔원/NNG;재정환율/NNG;상승/NNG,21,0.5808108830157004,Dovish
5,16, 지표/NNG;fed/NNG;양적완화/NNG;축소/NNG,21,0.4537585023560159,Dovish
2,14, 재정환율/NNG;하락/NNG,16,0.20743245821989298,Dovish
2,15, 제조업/NNG;지표/NNG;양호/NNG,17,0.1936036276719001,Dovish
9,27,귀띔/NNG,36,0.4840090691797503,Dovish
6,28,미래부/NNG,34,0.3111486873298395,Dovish
3,25,홍국/NNG,28,0.17424326490471012,Dovish
3,15, 지표/NNG;경제/NNG;개선/NNG,18,0.2904054415078502,Dovish
4,29, ecb/NNG;예금/NNG;금리/NNG;마이너스/NNG;인하/NNG,33,0.2002796148330001,Dovish
11,22, 비농업/NNG;고용/NNG;지표/NNG;경계/NNG,33,0.7260136037696254,Dovish
3,24, 예상/NNG;웃/VV,27,0.18150340094240636,Dovish
15,71, 전망/NNG;증폭/NNG,86,0.3067663114519544,Dovish
7,33, 고용/NNG;지표/NNG;혼조/NNG,40,0.3080057712962047,Dovish
3,18, 구하/NNG,21,0.24200453458987514,Dovish
3,14, 우려/NNG;부각/NNG;하락/NNG,17,0.3111486873298395,Dovish
3,41,중국a주/NNG,44,0.10624589323457934,Dovish
5,16, 채권파킹거래/NNG,21,0.4537585023560159,Dovish
4,14, 신흥국/NNG;경제/NNG;충격/NNG,18,0.41486491643978596,Dovish
8,25, 고용/NNG;증가/NNG;시장/NNG;예상/NNG;웃돌/VV,33,0.46464870641256023,Dovish
4,14, 리스크리버설/NNG,18,0.41486491643978596,Dovish
5,11, 역외/NNG;환율/NNG;반영/NNG;하락/NNG,16,0.6600123670632958,Dovish
5,12, 금리/NNG;양적완화/NNG;축소/NNG;우려/NNG,17,0.6050113364746877,Dovish
22,71, 거시건전성3종세트/NNG,93,0.4499239234628664,Dovish
5,12, 달러엔/NNG;하단/NNG,17,0.6050113364746877,Dovish
5,14, 금융시장/NNG;양적완화/NNG;축소/NNG,19,0.5185811455497324,Dovish
5,17, 금융시장/NNG;금리/NNG;오르/VV,22,0.42706682574683846,Dovish
3,19, 금리/NNG;인하/NNG;가계/NNG;부채/NNG;늘/VV,22,0.229267453821987,Dovish
5,12, 금리/NNG;지표/NNG;부진/NNG,17,0.6050113364746877,Dovish
5,12,파킹/NNG,17,0.6050113364746877,Dovish
41,131, 테이퍼링/NNG;자산/NNG;매입/NNG;축소/NNG,172,0.45445126342831516,Dovish
0,18, 매입/NNG;축소/NNG;긴축/NNG,18,0.0,Dovish
2,15, 가격/NNG;기준가격/NNG;위안/NNG;오르/VV,17,0.1936036276719001,Dovish
4,58, fed/NNG;테이퍼링/NNG;자산/NNG;매입/NNG;축소/NNG,62,0.10013980741650005,Dovish
4,14, 두호/NNG,18,0.41486491643978596,Dovish
5,21, 국채/NNG;수익률/NNG;상승/NNG;견인/NNG,26,0.34572076369982163,Dovish
19,62, 현물인도/NNG,81,0.44497607972977044,Dovish
0,16, 가한다고/VV,16,0.0,Dovish
5,13,실투자금/NNG,18,0.5584720028997119,Dovish
13,31, 많이/MAG;내리/VV;커브/NNG;플래트닝/NNG,44,0.6089146354196858,Dovish
52,175, 테이퍼링/NNG;양적완화/NNG;축소/NNG,227,0.4314595130973774,Dovish
5,25, 제조업/NNG;활동/NNG;약화/NNG,30,0.2904054415078502,Dovish
7,16, 역외/NNG;차액결제선물환/NNG;환율/NNG;오르/VV,23,0.6352619032984222,Dovish
7,16, crs/NNG;낮/VA,23,0.6352619032984222,Dovish
4,24, 취약계층/NNG;부담/NNG,28,0.2420045345898751,Dovish
7,16, 국채선물/NNG;국채/NNG;금리/NNG;하락/NNG,23,0.6352619032984222,Dovish
3,14, 신흥국/NNG;경기/NNG;위축/NNG,17,0.3111486873298395,Dovish
8,23, fed/NNG;테이퍼링/NNG;우려/NNG,31,0.5050529417527828,Dovish
4,15, 금리/NNG;하락/NNG;연동/NNG;강세/NNG,19,0.3872072553438002,Dovish
1,17, 지준월/NNG,18,0.08541336514936768,Dovish
5,11, gdp/NNG;갭/NNG;마이너스/NNG;축소/NNG,16,0.6600123670632958,Dovish
27,83, fed/NNG;테이퍼링/NNG;양적완화/NNG;축소/NNG,110,0.4723462000428888,Dovish
9,27, 많이/MAG;오르/VV;커브/NNG;스티프닝/NNG,36,0.4840090691797503,Dovish
8,18, 소비성향/NNG;하락/NNG,26,0.6453454255730003,Dovish
8,16, 투자/NNG;정석/NNG;주식시장/NNG;많/VA,24,0.7260136037696253,Dovish
6,13,에디터/NNG,19,0.6701664034796543,Dovish
2,14, 포워드가이던스/NNG;금리/NNG;인상/NNG,16,0.20743245821989298,Dovish
7,14,사모채/NNG,21,0.7260136037696254,Dovish
7,14, 양적완화/NNG;축소/NNG;없/VA,21,0.7260136037696254,Dovish
5,16,정열/NNG,21,0.4537585023560159,Dovish
5,15, 청천/NNG,20,0.48400906917975023,Dovish
9,20, 국채/NNG;가격/NNG;상승/NNG;줄/VV,29,0.6534122433926629,Dovish
2,22, 지정학/NNG;불안정/NNG;우려/NNG,24,0.13200247341265917,Dovish
11,38, fed/NNG;예상/NNG;비둘기/NNG,49,0.42032366534030946,Dovish
5,15, 테이퍼링/NNG;늦/VV,20,0.48400906917975023,Dovish
44,125, 지정학/NNG;불안정/NNG;완화/NNG,169,0.5111135770538162,Dovish
14,38,선제안내/NNG,52,0.5349573922513029,Dovish
10,33,안전통화/NNG,43,0.44000824470886385,Dovish
5,16, 전망/NNG;국채/NNG;가격/NNG;상승/NNG,21,0.4537585023560159,Dovish
4,16, 국채/NNG;가격/NNG;움직임/NNG;제한/NNG,20,0.36300680188481266,Dovish
5,13, 롱심리/NNG;살/VV,18,0.5584720028997119,Dovish
11,25, 국채/NNG;수익률/NNG;하락/NNG;압력/NNG,36,0.6388919713172704,Dovish
5,11, 국채선물/NNG;비둘기/NNG,16,0.6600123670632958,Dovish
8,96, 익공/NNG,104,0.12100226729493754,Dovish
63,296, 공유형모기지/NNG,359,0.30904633133436754,Dovish
0,18, 총채권연체율/NNG,18,0.0,Dovish
5,13, 신흥국/NNG;통화/NNG;약세/NNG;압력/NNG,18,0.5584720028997119,Dovish
9,66,공유형모기지/NNG,75,0.19800371011898876,Dovish
8,18, 물가/NNG;목표/NNG;달성/NNG;어렵/VA,26,0.6453454255730003,Dovish
4,15, 기대/NNG;인플레이션/NNG;넘/VV;않/VX,19,0.3872072553438002,Dovish
6,19, 수출업체/NNG;네고/NNG;강화/NNG,25,0.458534907643974,Dovish
2,25, 판매가격/NNG;긍정적/VAX,27,0.11616217660314006,Dovish
7,17,인테르/NNG,24,0.5978935560455738,Dovish
8,20,테이퍼/NNG,28,0.5808108830157003,Dovish
5,15, 근원/NNG;소비자/NNG;물가/NNG;높/VA,20,0.48400906917975023,Dovish
4,13, 실업률/NNG;웃돌/VV;기대/NNG;인플레이션/NNG;넘/VV,17,0.44677760231976943,Dovish
3,17, 국채입찰/NNG;상승/NNG,20,0.25624009544810306,Dovish
15,40,오바마케어/NNG,55,0.544510202827219,Dovish
2,16, 단기/NNG;국채/NNG;수익률/NNG;상승/NNG,18,0.18150340094240633,Dovish
10,42, 상하이자유무역구/NNG,52,0.34572076369982163,Dovish
5,14,상하이자유무역구/NNG,19,0.5185811455497324,Dovish
9,19, 국채선물/NNG;상승/NNG;압력/NNG,28,0.687802361465961,Dovish
1,18, 디플레이션/NNG;마이너스/NNG,19,0.08066817819662504,Dovish
2,18, 척/NNG,20,0.16133635639325009,Dovish
13,25, gdp/NNG;갭/NNG;축소/NNG,38,0.7550541479204105,Dovish
11,42, 디펜던트/NNG,53,0.3802928400698038,Dovish
4,13, 거주자/NNG;외화예금/NNG;증가/NNG,17,0.44677760231976943,Dovish
5,16, 테이퍼링/NNG;양적완화/NNG;축소/NNG;우려/NNG,21,0.4537585023560159,Dovish
5,12, 유가/NNG;원유/NNG;생산/NNG;증가/NNG,17,0.6050113364746877,Dovish
9,20, 차이넥스트/NNG,29,0.6534122433926629,Dovish
3,41, 무역이득공유제/NNG,44,0.10624589323457934,Dovish
5,11, 역내/NNG;공급우위/NNG,16,0.6600123670632958,Dovish
0,19, 대출/NNG;청약/NNG;철회/NNG,19,0.0,Dovish
5,17, 금리/NNG;대출/NNG;늘/VV,22,0.42706682574683846,Dovish
9,33, 마님/NNG,42,0.3960074202379775,Dovish
7,36,한금/NNG,43,0.28233862368818763,Dovish
4,28, 시간선택제일자리/NNG,32,0.20743245821989298,Dovish
13,28, 국채/NNG;매수/NNG;견인/NNG,41,0.6741554892146522,Dovish
6,13, 제조업/NNG;약세/NNG,19,0.6701664034796543,Dovish
3,21, fed/NNG;양적완화/NNG;종료/NNG;금리/NNG;인상/NNG,24,0.20743245821989298,Dovish
7,21, 상회/NNG;최대/NNG,28,0.4840090691797503,Dovish
3,14, 방공식별구역/NNG,17,0.3111486873298395,Dovish
7,16, 배당/NNG;성장/NNG,23,0.6352619032984222,Dovish
9,18, 물가/NNG;상승률/NNG;목표/NNG;오르/VV,27,0.7260136037696254,Dovish
4,18, pmi/NNG;내리/VV,22,0.32267271278650017,Dovish
4,20, 하단/NNG;지지력/NNG;강화/NNG,24,0.29040544150785014,Dovish
6,14, 롱포지션/NNG;줄/VV,20,0.622297374659679,Dovish
24,52, 물가/NNG;하방/NNG;압력/NNG,76,0.6701664034796543,Dovish
1,19,관계형금융/NNG,20,0.07642248460732899,Dovish
3,24, 테이퍼링/NNG;중단/NNG,27,0.18150340094240636,Dovish
8,25,대유/NNG,33,0.46464870641256023,Dovish
6,18, fed/NNG;엠파이어스테이트/NNG;제조업/NNG;지수/NNG;마이너스/NNG,24,0.4840090691797503,Dovish
17,50, 시장상황점검회의/NNG,67,0.49368925056334534,Dovish
6,13, 볼린저밴드/NNG,19,0.6701664034796543,Dovish
6,14,한농연/NNG,20,0.622297374659679,Dovish
5,17,내집마련디딤돌대출/NNG,22,0.42706682574683846,Dovish
14,73, 내집마련디딤돌대출/NNG,87,0.2784709713088974,Dovish
38,99,디딤돌/NNG,137,0.5573437766312276,Dovish
4,24, 소득공제장기펀드/NNG,28,0.2420045345898751,Dovish
5,18, 위험/NNG;회피/NNG;거래/NNG;강화/NNG,23,0.4033408909831252,Dovish
96,233, 매파/NNG;통화/NNG;긴축/NNG;선호/NNG,329,0.5982601370118802,Dovish
2,16, 고용/NNG;지표/NNG;부진/NNG;일시적/VAX,18,0.18150340094240633,Dovish
37,115,금융중개지원대출/NNG,152,0.46717397112132425,Dovish
4,16, 양적완화/NNG;마이너스/NNG,20,0.36300680188481266,Dovish
4,19, 엔원/NNG;재정환율/NNG;경계/NNG,23,0.30568993842931597,Dovish
3,18, 부양책/NNG;기대/NNG;약화/NNG,21,0.24200453458987514,Dovish
2,19, 국채/NNG;매수/NNG;강화/NNG,21,0.15284496921465798,Dovish
1,16, 테이퍼링/NNG;양적완화/NNG;축소/NNG;종료/NNG,17,0.09075170047120316,Dovish
2,17, 둔화/NNG;우려/NNG;약화/NNG,19,0.17082673029873535,Dovish
6,24, 달러원/NNG;역외/NNG;환율/NNG;반영/NNG;하락/NNG,30,0.3630068018848127,Dovish
1,20, 수출입/NNG;지표/NNG;부진/NNG,21,0.07260136037696253,Dovish
1,27,위어바오/NNG,28,0.05377878546441669,Dovish
2,21, 국채/NNG;가격/NNG;등락폭/NNG;제한/NNG,23,0.13828830547992862,Dovish
13,30,정의당/NNG,43,0.6292117899336753,Dovish
5,23,아바/NNG,28,0.3156580885954893,Dovish
6,18, 식분/NNG,24,0.4840090691797503,Dovish
4,15, 금리/NNG;하락/NNG;반영/NNG;강세/NNG,19,0.3872072553438002,Dovish
1,17, 롱심리/NNG;우위/NNG,18,0.08541336514936768,Dovish
5,15,홍매/NNG,20,0.48400906917975023,Dovish
7,26,렌치/NNG,33,0.3909304020297983,Dovish
0,16, 야주/NNG,16,0.0,Dovish
8,21, 소추/NNG,29,0.5531532219197145,Dovish
2,27,이직률/NNG,29,0.10755757092883338,Dovish
3,16, fed/NNG;경제/NNG;지표/NNG;부진/NNG,19,0.27225510141360953,Dovish
496,980, 점도표/NNG,1476,0.7349035662647637,Dovish
72,188,점도표/NNG,260,0.5560955262916281,Dovish
5,21, 롱플레이/NNG;강화/NNG,26,0.34572076369982163,Dovish
7,15, fed/NNG;이르/VV;금리/NNG;오르/VV,22,0.6776126968516504,Dovish
13,27, 자본재/NNG;수주/NNG;감소/NNG,40,0.6991242110374171,Dovish
6,12, 위험/NNG;투자심리/NNG;살/VV,18,0.7260136037696254,Dovish
4,24, 원자재/NNG;통화/NNG;강세/NNG,28,0.2420045345898751,Dovish
6,18, 수요측면/NNG;하방/NNG;압력/NNG,24,0.4840090691797503,Dovish
7,15, fed/NNG;비둘기/NNG;금리/NNG;인상/NNG,22,0.6776126968516504,Dovish
6,21, 물가/NNG;상승률/NNG;회복/NNG,27,0.41486491643978596,Dovish
11,33, 리스크온/NNG;위험/NNG;선호/NNG,44,0.48400906917975023,Dovish
5,12, 비농업/NNG;고용/NNG;지표/NNG;개선/NNG,17,0.6050113364746877,Dovish
59,227,세월호참사/NNG,286,0.3773991420476467,Dovish
42,151, 분양형호텔/NNG,193,0.4038751173287982,Dovish
7,16, 민간/NNG;고용/NNG;예상/NNG;웃돌/VV;증가/NNG,23,0.6352619032984222,Dovish
3,20,휘정/NNG,23,0.21780408113088762,Dovish
2,17, 마이너스금리/NNG;떨어/VV,19,0.17082673029873535,Dovish
11,28, 뉴뉴트럴/NNG,39,0.5704392601047057,Dovish
3,14,뉴뉴트럴/NNG,17,0.3111486873298395,Dovish
7,26, 상주인구/NNG,33,0.3909304020297983,Dovish
3,14, 예상/NNG;웃돌/VV;급등/NNG,17,0.3111486873298395,Dovish
8,23, 위험/NNG;투자심리/NNG;강화/NNG,31,0.5050529417527828,Dovish
5,16, 유로존/NNG;국채/NNG;수익률/NNG;하락/NNG,21,0.4537585023560159,Dovish
11,26, 스무딩오퍼레이션/NNG;미세조정/NNG;부담/NNG,37,0.614319203189683,Dovish
3,20, 달러부채/NNG;부담/NNG,23,0.21780408113088762,Dovish
3,51,이라크사태/NNG,54,0.08541336514936769,Dovish
31,73, fed/NNG;매파/NNG;통화/NNG;긴축/NNG;선호/NNG,104,0.6166142936125586,Dovish
4,18,etn/NNG,22,0.32267271278650017,Dovish
68,140, 비둘기/NNG;통화/NNG;완화/NNG;선호/NNG,208,0.7052703579476362,Dovish
1,17, 비즈니스/NNG;금리/NNG;인상/NNG,18,0.08541336514936768,Dovish
7,17, 데인/NNG,24,0.5978935560455738,Dovish
10,24, fed/NNG;금리/NNG;인상/NNG;반대/NNG,34,0.6050113364746877,Dovish
7,53, 금리/NNG;한계/NNG;대출/NNG;금리/NNG;마이너스/NNG,60,0.19177717835424068,Dovish
4,14, 채권/NNG;금리/NNG;영향/NNG;강세/NNG,18,0.41486491643978596,Dovish
9,25, 위험/NNG;거래/NNG;증가/NNG;하락/NNG,34,0.5227297947141304,Dovish
2,18, 주택매매/NNG;거래/NNG;증가/NNG,20,0.16133635639325009,Dovish
11,28,뱅크론펀드/NNG,39,0.5704392601047057,Dovish
27,67, 뱅크론펀드/NNG,94,0.5851452925904443,Dovish
1,38,단종/NNG,39,0.038211242303664496,Dovish
28,78, 박스피/NNG,106,0.5212405360397311,Dovish
7,15, 금리/NNG;인상/NNG;대외/NNG;위험/NNG,22,0.6776126968516504,Dovish
2,21,재정보강/NNG,23,0.13828830547992862,Dovish
4,13, 싱크홀/NNG,17,0.44677760231976943,Dovish
3,15, 소비자/NNG;물가/NNG;지표/NNG;부진/NNG,18,0.2904054415078502,Dovish
26,131,분양형호텔/NNG,157,0.28818860607649255,Dovish
15,48, 에볼라바이러스/NNG,63,0.45375850235601584,Dovish
7,34,아람/NNG,41,0.2989467780227869,Dovish
10,28, 디플레이션/NNG;물가/NNG;하락/NNG;우려/NNG,38,0.5185811455497324,Dovish
11,26, 고용시장/NNG;강세/NNG,37,0.614319203189683,Dovish
35,105,후강퉁/NNG,140,0.4840090691797503,Dovish
3,15,에볼라바이러스/NNG,18,0.2904054415078502,Dovish
5,18, 금리/NNG;채권시장/NNG;강세/NNG;연동/NNG;하락/NNG,23,0.4033408909831252,Dovish
5,24, 遊客/NNG,29,0.30250566823734387,Dovish
5,11, 글로벌/NNG;채권/NNG;금리/NNG;오르/VV,16,0.6600123670632958,Dovish
5,14, 독서실/NNG,19,0.5185811455497324,Dovish
8,16, ecb/NNG;자산/NNG;매입/NNG;확대/NNG,24,0.7260136037696253,Dovish
5,11, 예상/NNG;비둘기/NNG;통화/NNG;완화/NNG;선호/NNG,16,0.6600123670632958,Dovish
10,27, 예상/NNG;상회/NNG;오르/VV,37,0.5377878546441669,Dovish
0,17, 정보통/NNG,17,0.0,Dovish
2,17, 금리/NNG;인상/NNG;금융/NNG;불안/NNG,19,0.17082673029873535,Dovish
5,45, 척하면/MAG,50,0.16133635639325009,Dovish
7,24,척하면/MAG,31,0.42350793553228144,Dovish
11,49, fed/NNG;비둘기/NNG;통화/NNG;완화/NNG;선호/NNG,60,0.3259652914884032,Dovish
11,29, 차환/NNG;자금/NNG;확보/NNG,40,0.5507689407907503,Dovish
4,21, 지헌/NNG,25,0.27657661095985725,Dovish
3,13, 국제채/NNG,16,0.33508320173982714,Dovish
7,28, 금리/NNG;인상/NNG;대외/NNG;불확실성/NNG,35,0.3630068018848127,Dovish
6,14, 강달러/NNG;우려/NNG,20,0.622297374659679,Dovish
10,31, 국제/NNG;유가/NNG;공급/NNG;과잉/NNG;우려/NNG,41,0.46839587339975836,Dovish
4,19, 국채선물/NNG;채권/NNG;금리/NNG;하락/NNG;강세/NNG,23,0.30568993842931597,Dovish
5,13, 달러인덱스/NNG;소폭/MAG;하락/NNG,18,0.5584720028997119,Dovish
0,17, 거시건전성3종세트/NNG;완화/NNG,17,0.0,Dovish
22,48, ecb/NNG;양적완화/NNG;확대/NNG,70,0.6655124701221565,Dovish
2,19,사업지/NNG,21,0.15284496921465798,Dovish
4,15, 수납공간/NNG,19,0.3872072553438002,Dovish
7,24, 국채선물/NNG;채권/NNG;금리/NNG;상승/NNG,31,0.42350793553228144,Dovish
5,17,아시아인프라투자은행/NNG,22,0.42706682574683846,Dovish
5,15, 금리/NNG;역대/NNG;최저/NNG;인하/NNG,20,0.48400906917975023,Dovish
3,13, 금리/NNG;인하/NNG;피해/NNG,16,0.33508320173982714,Dovish
3,13, 국고채/NNG;입찰/NNG;예상/NNG;부진/NNG,16,0.33508320173982714,Dovish
9,20, 경제/NNG;활력/NNG;강화/NNG,29,0.6534122433926629,Dovish
21,64,마곡/NNG,85,0.47644642747381666,Dovish
6,15, 안전자산/NNG;선호/NNG;분위기/NNG;강하/VA,21,0.5808108830157004,Dovish
5,12, 완화/NNG;선호/NNG,17,0.6050113364746877,Dovish
0,16,무역이득공유제/NNG,16,0.0,Dovish
3,13, opec/NNG;생산/NNG;감축/NNG,16,0.33508320173982714,Dovish
2,15, 카드복합할부/NNG,17,0.1936036276719001,Dovish
24,47, 세계/NNG;공급/NNG;과잉/NNG;우려/NNG,71,0.7414607017221707,Dovish
7,19, 국채선물/NNG;fed/NNG;금리/NNG;인상/NNG,26,0.5349573922513029,Dovish
5,12,화태/NNG,17,0.6050113364746877,Dovish
2,41, opec/NNG;감산/NNG;합의/NNG;실패/NNG,43,0.07083059548971955,Dovish
32,70,자산관리회사/NNG,102,0.6637838663036575,Dovish
6,12,국정농단/NNG,18,0.7260136037696254,Dovish
3,13, 유가/NNG;하락/NNG;충격/NNG,16,0.33508320173982714,Dovish
8,18, 일반해고/NNG,26,0.6453454255730003,Dovish
4,12, 금리/NNG;인상/NNG;경기/NNG;부진/NNG,16,0.4840090691797502,Dovish
4,13, 달러원/NNG;역외/NNG;환율/NNG;반영/NNG;상승/NNG,17,0.44677760231976943,Dovish
2,14, 저유가/NNG;충격/NNG,16,0.20743245821989298,Dovish
9,26,동휴/NNG,35,0.5026248026097407,Dovish
5,11, 예상/NNG;느리/VA;금리/NNG;인상/NNG,16,0.6600123670632958,Dovish
6,12, 금리/NNG;인상/NNG;불확실성/NNG;완화/NNG,18,0.7260136037696254,Dovish
1,17, 변동성완화장치/NNG,18,0.08541336514936768,Dovish
1,31,우버/NNG,32,0.046839587339975834,Dovish
6,16, 바오치/NNG,22,0.5445102028272191,Dovish
1,15, 스마트베타/NNG,16,0.09680181383595005,Dovish
5,34, 유로존/NNG;탈퇴/NNG;그렉시트/NNG;우려/NNG,39,0.21353341287341923,Dovish
3,17, fed/NNG;금리/NNG;ff/NNG;금리/NNG;오르/VV,20,0.25624009544810306,Dovish
7,36,일대일로/NNG,43,0.28233862368818763,Dovish
21,48,선강퉁/NNG,69,0.6352619032984221,Dovish
10,35, 불확실성/NNG;fed/NNG;금리/NNG;인상/NNG,45,0.41486491643978596,Dovish
7,15, 금리/NNG;오르/VV;매파/NNG,22,0.6776126968516504,Dovish
0,17, 금리/NNG;인상/NNG;비둘기/NNG,17,0.0,Dovish
14,39, 지수/NNG;하방/NNG;압력/NNG,53,0.5212405360397311,Dovish
5,20, 지표/NNG;부진/NNG;금리/NNG;인상/NNG;지연/NNG,25,0.3630068018848127,Dovish
2,15, 안전자산/NNG;선호/NNG;내리/VV,17,0.1936036276719001,Dovish
9,26,생활권/NNG,35,0.5026248026097407,Dovish
3,13, 스튜어디스/NNG,16,0.33508320173982714,Dovish
3,14, 위험/NNG;투자심리/NNG;회복/NNG,17,0.3111486873298395,Dovish
5,19, 달러원/NNG;fed/NNG;금리/NNG;인상/NNG,24,0.38211242303664494,Dovish
6,14, 채굴장치/NNG,20,0.622297374659679,Dovish
6,27, 금융개혁회의/NNG,33,0.32267271278650017,Dovish
3,13, 강달러/NNG;경계/NNG,16,0.33508320173982714,Dovish
7,14, 국채선물시장/NNG;채권/NNG;금리/NNG;상승/NNG;약세/NNG,21,0.7260136037696254,Dovish
6,12, 국채선물/NNG;채권/NNG;금리/NNG;상승/NNG;약세/NNG,18,0.7260136037696254,Dovish
10,22, 비농업/NNG;고용/NNG;지표/NNG;금리/NNG;인상/NNG,32,0.6600123670632958,Dovish
7,16, 특조/NNG,23,0.6352619032984222,Dovish
4,13, 국고채/NNG;금리/NNG;채권/NNG;금리/NNG;하락/NNG,17,0.44677760231976943,Dovish
5,11, 금리/NNG;인상/NNG;가능성/NNG;대외/NNG;불확실성/NNG,16,0.6600123670632958,Dovish
9,23, fed/NNG;거의/MAG;금리/NNG;인상/NNG,32,0.5681845594718807,Dovish
6,19, 정책/NNG;fed/NNG;금리/NNG;인상/NNG,25,0.458534907643974,Dovish
3,14,사란/NNG,17,0.3111486873298395,Dovish
8,22, 사란/NNG,30,0.5280098936506367,Dovish
14,40, 통합지원센터/NNG,54,0.5082095226387378,Dovish
0,17,튤립/NNG,17,0.0,Dovish
4,18, 원화채권/NNG;금리/NNG;커브/NNG;스티프닝/NNG,22,0.32267271278650017,Dovish
1,18, 자녀장려금/NNG,19,0.08066817819662504,Dovish
1,17, 엽우/NNG,18,0.08541336514936768,Dovish
7,14, 경제/NNG;성장/NNG;둔화/NNG;금리/NNG;인상/NNG,21,0.7260136037696254,Dovish
6,14, 엘시티/NNG,20,0.622297374659679,Dovish
1,23, 주택저당증권/NNG;입찰/NNG;호조/NNG,24,0.06313161771909785,Dovish
1,35, ff/NNG;금리/NNG;목표/NNG;높/VV,36,0.04148649164397859,Dovish
6,14, 역세권/NNG;개발/NNG;가능성/NNG;미래가격/NNG;높/VA,20,0.622297374659679,Dovish
38,80,위비/NNG,118,0.6897129235811441,Dovish
11,22, fed/NNG;금리/NNG;인상/NNG;가능성/NNG;강하/VA,33,0.7260136037696254,Dovish
2,17, fed/NNG;금리/NNG;인상/NNG;전망/NNG;강화/NNG,19,0.17082673029873535,Dovish
5,12, 마부/NNG,17,0.6050113364746877,Dovish
7,17, ecb/NNG;양적완화/NNG;종료/NNG,24,0.5978935560455738,Dovish
5,15, ecb/NNG;채권/NNG;매입/NNG;축소/NNG,20,0.48400906917975023,Dovish
6,12, 고용시장/NNG;호조/NNG;부진/NNG,18,0.7260136037696254,Dovish
2,14, 물가/NNG;경제/NNG;지표/NNG;부진/NNG,16,0.20743245821989298,Dovish
8,20,테이퍼텐트럼/NNG,28,0.5808108830157003,Dovish
6,22,개관/NNG,28,0.3960074202379775,Dovish
5,24, 국채선물시장/NNG;미/NNG;금리/NNG;하락/NNG,29,0.30250566823734387,Dovish
2,32, 금융안정/NNG;훼손/NNG,34,0.09075170047120316,Dovish
17,56, 소득/NNG;심사/NNG;강화/NNG,73,0.44079397371727264,Dovish
6,14, 망월/NNG,20,0.622297374659679,Dovish
3,18, 위험자산/NNG;회피/NNG;강하/VA,21,0.24200453458987514,Dovish
5,12, 연명의료/NNG,17,0.6050113364746877,Dovish
1,20, 임치/NNG,21,0.07260136037696253,Dovish
5,17, 안전자산/NNG;선호/NNG;부각/NNG;상승/NNG,22,0.42706682574683846,Dovish
3,16, 총부채/NNG;상환/NNG;비율/NNG;강화/NNG,19,0.27225510141360953,Dovish
6,25,스트레스금리/NNG,31,0.34848652980942024,Dovish
22,55, 스트레스금리/NNG,77,0.5808108830157003,Dovish
5,35, 스트레스dti/NNG,40,0.20743245821989298,Dovish
25,54, 아파텔/NNG,79,0.6722348183052087,Dovish
3,13, 금리/NNG;인상/NNG;입주/NNG;물량/NNG;증가/NNG,16,0.33508320173982714,Dovish
9,20, 달러위안/NNG;기준환율/NNG;위안/NNG;오르/VV,29,0.6534122433926629,Dovish
5,13, 달러위안/NNG;환율/NNG;오르/VV,18,0.5584720028997119,Dovish
4,15,전승절/NNG,19,0.3872072553438002,Dovish
7,16, 인상/NNG;불씨/NNG;살/VV,23,0.6352619032984222,Dovish
5,12, 불안/NNG;금리/NNG;인상/NNG;불확실성/NNG,17,0.6050113364746877,Dovish
5,14, 기업활력법/NNG,19,0.5185811455497324,Dovish
18,40, 탄핵소추안/NNG,58,0.6534122433926629,Dovish
5,11, 노동개혁5대법안/NNG,16,0.6600123670632958,Dovish
6,15,클리퍼/NNG,21,0.5808108830157004,Dovish
6,19,원샷법/NNG,25,0.458534907643974,Dovish
4,14, 국채선물시장/NNG;채권/NNG;금리/NNG;하락/NNG,18,0.41486491643978596,Dovish
14,37, 규제프리존/NNG,51,0.5494157001499868,Dovish
14,29, 초장기물/NNG;금리/NNG;오르/VV,43,0.7009786519155004,Dovish
3,14,지급률/NNG,17,0.3111486873298395,Dovish
4,15, 젠트리피케이션/NNG,19,0.3872072553438002,Dovish
2,15, 완전고용/NNG;물가/NNG;상승/NNG,17,0.1936036276719001,Dovish
5,13, 물가/NNG;부진/NNG;우려/NNG,18,0.5584720028997119,Dovish
4,24,강구퉁/NNG,28,0.2420045345898751,Dovish
15,40,성서/NNG,55,0.544510202827219,Dovish
5,11, 오일머니/NNG;이탈/NNG,16,0.6600123670632958,Dovish
5,15, 국채선물시장/NNG;채권/NNG;금리/NNG;상승/NNG,20,0.48400906917975023,Dovish
4,17, 안정성/NNG;갖추/VV;관심/NNG;높/VA,21,0.3416534605974707,Dovish
30,110, 경포/NNG,140,0.39600742023797747,Dovish
4,18, 부동산신탁전문기업/NNG,22,0.32267271278650017,Dovish
3,18, 은행/NNG;이자/NNG;높/VA;수익/NNG;오르/VV,21,0.24200453458987514,Dovish
4,12, 원달러/NNG;하단/NNG,16,0.4840090691797502,Dovish
5,12,견문/NNG,17,0.6050113364746877,Dovish
5,11, 활법/NNG,16,0.6600123670632958,Dovish
11,29, 신용정보원/NNG,40,0.5507689407907503,Dovish
9,36,신용정보원/NNG,45,0.3630068018848127,Dovish
26,57, 금리/NNG;인상/NNG;자산/NNG;축소/NNG,83,0.6623281999301845,Dovish
3,13, 밀레니얼세대/NNG,16,0.33508320173982714,Dovish
9,21,로보어드바이저/NNG,30,0.6222973746596789,Dovish
9,31, 내집연금3종세트/NNG,40,0.42155628605978257,Dovish
6,21, 주택담보대출/NNG;소득/NNG;심사/NNG;강화/NNG,27,0.41486491643978596,Dovish
5,19, 집단/NNG;대출/NNG;규제/NNG;강화/NNG,24,0.38211242303664494,Dovish
2,106, 브렉시트/NNG;우려/NNG;완화/NNG,108,0.027396739764891525,Dovish
5,20, 하락/NNG;전환/NNG;내림/NNG,25,0.3630068018848127,Dovish
5,17, 유럽연합/NNG;탈퇴/NNG;브렉시트/NNG;불확실성/NNG,22,0.42706682574683846,Dovish
8,34, 브렉시트/NNG;유럽연합/NNG;탈퇴/NNG;불확실성/NNG,42,0.3416534605974707,Dovish
26,70, 차액결제선물환/NNG;시장/NNG;원화/NNG;강세/NNG,96,0.5393243913717217,Dovish
4,19,관찰대상국/NNG,23,0.30568993842931597,Dovish
2,15, 고우/VA,17,0.1936036276719001,Dovish
11,33,고우/VA,44,0.48400906917975023,Dovish
6,17, 브렉시트/NNG;유럽연합/NNG;탈퇴/NNG;금리/NNG;인상/NNG,23,0.5124801908962061,Dovish
4,19,썸/NNG,23,0.30568993842931597,Dovish
1,19, 고용/NNG;증가/NNG;물가/NNG;상승/NNG,20,0.07642248460732899,Dovish
2,23, 대출/NNG;계약/NNG;철회/NNG,25,0.1262632354381957,Dovish
101,217, 사잇돌대출/NNG,318,0.6758283316196513,Dovish
1,20, 브렉시트/NNG;충격/NNG;완화/NNG,21,0.07260136037696253,Dovish
3,18, 경제/NNG;전망/NNG;단기/NNG;위험/NNG;감소/NNG,21,0.24200453458987514,Dovish
10,25, 스왑베이시스/NNG;역전폭/NNG;소폭/MAG;줄/VV,35,0.5808108830157004,Dovish
4,16, irs/NNG;갭/NNG;스왑베이시스/NNG;역전폭/NNG;줄/VV,20,0.36300680188481266,Dovish
14,70,탄핵안/NNG,84,0.29040544150785014,Dovish
4,12, ecb/NNG;테이퍼링/NNG;자산/NNG;매입/NNG;축소/NNG,16,0.4840090691797502,Dovish
7,19, ecb/NNG;테이퍼링/NNG;양적완화/NNG;축소/NNG,26,0.5349573922513029,Dovish
8,36,트럼프리스크/NNG,44,0.32267271278650017,Dovish
4,19,경제현안점검회의/NNG,23,0.30568993842931597,Dovish
5,13,조정대상지역/NNG,18,0.5584720028997119,Dovish
3,19, 트럼프발작/NNG,22,0.229267453821987,Dovish
17,36,트럼프노믹스/NNG,53,0.6856795146713129,Dovish
3,29,대통령탄핵소추안/NNG,32,0.1502097111247501,Dovish
4,13, 차주/NNG;연체/NNG;부담/NNG;완화/NNG,17,0.44677760231976943,Dovish
4,13, 피터나바로/NNG,17,0.44677760231976943,Dovish
7,26,탄핵소추안/NNG,33,0.3909304020297983,Dovish
4,13, 국가무역위원회/NNG,17,0.44677760231976943,Dovish
7,18, 국제/NNG;유가/NNG;원유/NNG;생산/NNG;증가/NNG,25,0.5646772473763753,Dovish
11,30, 유가/NNG;원유/NNG;생산/NNG;증가/NNG;우려/NNG,41,0.5324099760977252,Dovish
6,35, 폐업/NNG;위험/NNG,41,0.24891894986387159,Dovish
5,20, 물가/NNG;상승률/NNG;넘/VV;않/VX;억제/NNG,25,0.3630068018848127,Dovish
3,49, 세금개편안/NNG,52,0.0888996249513827,Dovish
5,21,내통/NNG,26,0.34572076369982163,Dovish
4,25, 고용/NNG;물가/NNG;기대/NNG;개선/NNG,29,0.23232435320628012,Dovish
7,110,트럼프케어/NNG,117,0.09240173138886142,Dovish
14,35, 경제/NNG;역사적/VAX;성장/NNG;추세/NNG;확장/NNG,49,0.5808108830157003,Dovish
14,35, 지수/NNG;경제/NNG;역사적/VAX;성장/NNG,49,0.5808108830157003,Dovish
4,14, 데몬/NNG,18,0.41486491643978596,Dovish
