up_count,down_count,ngram,total_count,polar_score,polarity
3170,122, 로/NNG,3292,37.72890367130677,Hawkish
47950,28834, 국고채/NNG,76784,2.414673808750332,Hawkish
477,434, 바이백/NNG,911,1.5958916543691766,Hawkish
2310,150, 의/NNG,2460,22.361218996104462,Hawkish
21450,23370, 인플레이션/NNG,44820,1.3327335730302496,Hawkish
733,654, 리라/NNG,1387,1.6274249894897108,Hawkish
4221,4419, 단기물/NNG,8640,1.386966925327716,Hawkish
42831,44765, 채권/NNG,87596,1.3892947018008186,Hawkish
440,464, 재정거래/NNG,904,1.3769223519768758,Hawkish
6694,7086, 매력/NNG,13780,1.3717005542291483,Hawkish
148,127, 펀/NNG,275,1.6921261946126704,Hawkish
151,128, 텔/NNG,279,1.7129383463939598,Hawkish
1441,1498, 고유가/NNG,2939,1.3967765060507744,Hawkish
14502,6462, 다/MAG,20964,3.2586348752296836,Hawkish
419,310, 만일/NNG,729,1.9625787095449876,Hawkish
617,360, 그러/NNG,977,2.4886132973658825,Hawkish
3681,3579, 이러/NNG,7260,1.4934093743928423,Hawkish
366,262, 수요측면/NNG,628,2.0284044196922357,Hawkish
116,83, 기우/NNG,199,2.0293392298138926,Hawkish
5459,5260, 보다/MAG,10719,1.5069613167218194,Hawkish
9352,10205, 감안/NNG,19557,1.3306573684377339,Hawkish
172,21, 윤여/NNG,193,11.892794271273864,Hawkish
8319,3087, 추이/NNG,11406,3.912994603018797,Hawkish
36,0, 일통/NNG,36,inf,Hawkish
302,31, 채/VV,333,14.145555376672702,Hawkish
14610,5192, 통안채/NNG,19802,4.085924018133369,Hawkish
46017,4854, 자료/NNG,50871,13.76554099903867,Hawkish
6731,60, 좌/NNG,6791,162.89325223244495,Hawkish
7565,383, 우/NNG,7948,28.680380744215228,Hawkish
20493,21146, 판단/NNG,41639,1.4071878163294176,Hawkish
18756,16586, 주/NNG,35342,1.6420006212833829,Hawkish
14631,15292, 변화/NNG,29923,1.3892630181471868,Hawkish
146,161, 될수록/XSV,307,1.3167451695697556,Hawkish
4015,483, 목/NNG,4498,12.070164054389425,Hawkish
129,104, 다행히/MAG,233,1.8010722093515708,Hawkish
14295,15955, 소비자/NNG,30250,1.3009544927466994,Hawkish
249,260, 오일쇼크/NNG,509,1.3905952872202825,Hawkish
383,386, 고물가/NNG,769,1.4407420219884275,Hawkish
18302,17622, 채권시장/NNG,35924,1.5080582199740873,Hawkish
100,95, 비대칭/NNG,195,1.5284496921465798,Hawkish
16,11, 불행히/MAG,27,2.1120395746025467,Hawkish
1473,1108, 대/NNG,2581,1.9303574699506465,Hawkish
72,23, 만/VV,95,4.545476475775046,Hawkish
300,323, 모른다/VV,623,1.3486320813058057,Hawkish
454,177, 게다가/MAG,631,3.7244087696204513,Hawkish
197,194, 분명/NNG,391,1.4744812365218165,Hawkish
784,786, 시차/NNG,1570,1.4483324818203214,Hawkish
2187,2210, 존재/NNG,4397,1.4369156121666702,Hawkish
1282,465, 요약/NNG,1747,4.0032233979899345,Hawkish
180,174, 생산능력/NNG,354,1.5020971112475008,Hawkish
1406,1546, 생산성/NNG,2952,1.320537033505942,Hawkish
33,22, 외생/NNG,55,2.1780408113088763,Hawkish
610,479, 자/NNG,1089,1.8491369448829706,Hawkish
13,8, 종속변수/NNG,21,2.359544212251283,Hawkish
343,317, 가격변수/NNG,660,1.5711209217222808,Hawkish
228,78, 현/NNG,306,4.24438722203781,Hawkish
2590,505, 어떠/NNG,3095,7.447030628765663,Hawkish
384,411, 상관/NNG,795,1.356638558868789,Hawkish
120,28, 공히/MAG,148,6.222973746596789,Hawkish
93,90, 불능/NNG,183,1.5004281144572258,Hawkish
520,443, 유가상승/NNG,963,1.7044111691205652,Hawkish
146,117, 다소간/MAG,263,1.8119313871857319,Hawkish
19000,20390, 순매수/NNG,39390,1.353041537187139,Hawkish
3523,2671, 누적/NNG,6194,1.915197249030618,Hawkish
1590,666, 장단기/NNG,2256,3.466551441422536,Hawkish
2020,2182, 역전/NNG,4202,1.344223171049169,Hawkish
3287,219, 조원/NNG,3506,21.79366863553204,Hawkish
2932,2268, 일드커브/NNG,5200,1.877135702162735,Hawkish
13,10, 지켜진/VV,23,1.887635369801026,Hawkish
74,74, 기채/NNG,148,1.4520272075392509,Hawkish
2515,481, 지/NNG,2996,7.5922004718528395,Hawkish
1480,1433, 횡보/NNG,2913,1.499651268079617,Hawkish
751,776, 연방/NNG,1527,1.4052479804922389,Hawkish
1790,1711, 하이일드/NNG,3501,1.5190699599621618,Hawkish
301,200, 부도율/NNG,501,2.1853009473465725,Hawkish
1075,1163, 지/VV,2238,1.342157565008336,Hawkish
696,468, 축/NNG,1164,2.1594250778788857,Hawkish
31197,17595, 회사채/NNG,48792,2.5745321280819553,Hawkish
842,285, 용지/NNG,1127,4.289848802624734,Hawkish
6068,6213, 선진국/NNG,12281,1.4181395614595482,Hawkish
274,274, 단기자금/NNG,548,1.4520272075392509,Hawkish
216,79, 우/VV,295,3.9700997066895973,Hawkish
4254,4715, 점검/NNG,8969,1.3100580574489868,Hawkish
57261,54946, 투자/NNG,112207,1.5132044176264885,Hawkish
3877,3496, 목적/NNG,7373,1.6102715914272527,Hawkish
717,379, 제작/NNG,1096,2.7469749546323032,Hawkish
3844,4251, 신뢰/NNG,8095,1.3130069597226255,Hawkish
2415,564, 정확/NNG,2979,6.217456925899452,Hawkish
1867,777, 완전/NNG,2644,3.4889765720409027,Hawkish
4013,4240, 보장/NNG,8253,1.3742889584563711,Hawkish
4237,2872, 책임/NNG,7109,2.142144595523609,Hawkish
10162,11042, 종목/NNG,21204,1.3363068722164342,Hawkish
3388,2710, 최종/NNG,6098,1.8153019111228716,Hawkish
1791,515, 바랍니다/VV,2306,5.049671317869511,Hawkish
25319,13511, 증권/NNG,38830,2.72103300034685,Hawkish
4092,4196, 법/NNG,8288,1.4160379726526726,Hawkish
1549,455, 증빙/NNG,2004,4.943275042809449,Hawkish
219,66, 지적재산권/NNG,285,4.8180902795620595,Hawkish
246,104, 허락/NNG,350,3.434602817833228,Hawkish
1836,543, 배포/NNG,2379,4.909616856431058,Hawkish
64,57, 유가/NNG;원자재/NNG;가격/NNG;상승/NNG,121,1.6303463382896848,Hawkish
64,52, 인플레이션/NNG;금리/NNG;인상/NNG,116,1.7871104092790777,Hawkish
48,27, 인플레이션/NNG;기대/NNG;확산/NNG,75,2.5813817022920014,Hawkish
30,16, 인플레이션/NNG;경기/NNG;둔화/NNG,46,2.722551014136095,Hawkish
74,75, 인플레이션/NNG;우려/NNG;크/VV,149,1.4326668447720607,Hawkish
21,18, 경제/NNG;성장/NNG;위축/NNG,39,1.6940317421291258,Hawkish
146,132, 인플레이션/NNG;부담/NNG,278,1.6060300931873532,Hawkish
954,965, 인플레이션/NNG;압력/NNG,1919,1.4354756020647101,Hawkish
47,31, 고유가/NNG;충격/NNG,78,2.2014606049788643,Hawkish
18,20, 생산성/NNG;증대/NNG,38,1.3068244867853258,Hawkish
269,227, 경기/NNG;과열/NNG,496,1.720684223912152,Hawkish
113,120, 점차/MAG;완화/NNG,233,1.3673256204327944,Hawkish
15,15, 상방/NNG;경직/NNG,30,1.4520272075392506,Hawkish
48,46, 잠재/NNG;성장/NNG,94,1.5151588252583488,Hawkish
29,28, 형세/NNG,57,1.503885322094224,Hawkish
3320,3544, 우호적/VAX,6864,1.360251221509682,Hawkish
54,37, 금리/NNG;상승/NNG;확대/NNG,91,2.119174843435663,Hawkish
1123,1126, 인플레이션/NNG;우려/NNG,2249,1.4481585737713842,Hawkish
132,101, 단기물/NNG;강세/NNG,233,1.8976989247047633,Hawkish
2804,1564, 외인/NNG,4368,2.603250824769859,Hawkish
7746,7330, 불구/NNG,15076,1.53443420867654,Hawkish
88,2, 물가지/NNG,90,63.88919713172703,Hawkish
9576,10453, 수급/NNG,20029,1.3302030555243343,Hawkish
715,785, 물가/NNG;상승/NNG;압력/NNG,1500,1.3225470743828844,Hawkish
7284,3912, 발/NNG,11196,2.7036212115838194,Hawkish
37,16, 말지/NNG,53,3.3578129174345177,Hawkish
27,13, 금리/NNG;하락/NNG;확대/NNG,40,3.0157488156584438,Hawkish
57,53, 채권시장/NNG;긍정적/VAX,110,1.561614166598817,Hawkish
1166,1262, 내구재/NNG,2428,1.3415718890576596,Hawkish
12646,12585, 물/NNG,25231,1.459065241679886,Hawkish
2016,80, 를/NNG,2096,36.59108562998912,Hawkish
3547,2753, 선행/NNG,6300,1.8708102089145378,Hawkish
18,20, 채권시장/NNG;우호적/VAX;않/VX,38,1.3068244867853258,Hawkish
42,42, 실적/NNG;예상/NNG;상회/NNG,84,1.4520272075392509,Hawkish
20,20, 인플레이션/NNG;확대/NNG,40,1.4520272075392509,Hawkish
7315,7939, 비/NNG,15254,1.3378988566758558,Hawkish
1111,847, 광공업/NNG,1958,1.9046071163826535,Hawkish
13,3, 여겨짐/VV,16,6.292117899336753,Hawkish
14,3, 소비자/NNG;물가/NNG;부담/NNG,17,6.776126968516503,Hawkish
194,208, 금리/NNG;상승/NNG;제한/NNG,402,1.3542946070318014,Hawkish
158,171, 물가/NNG;우려/NNG,329,1.3416391742175533,Hawkish
178,181, 시킴/XSV,359,1.42796045824302,Hawkish
1075,1101, 절대/MAG,2176,1.4177377366981787,Hawkish
2865,2855, 근원/NNG,5720,1.457113117197882,Hawkish
38,30, 보여줌/VV,68,1.839234462883051,Hawkish
670,690, 앤/NNG,1360,1.4099394623931856,Hawkish
102,107, 가수급/NNG,209,1.3841754688691923,Hawkish
16,14, 미/NNG;금리/NNG;급락/NNG,30,1.6594596657591438,Hawkish
22,16, 개선/NNG;줄/VV,38,1.9965374103664697,Hawkish
23,23, 규제설/NNG,46,1.4520272075392506,Hawkish
918,134, 까지/NNG,1052,9.947469974037555,Hawkish
3129,2954, 중립/NNG,6083,1.5380477767062681,Hawkish
518,427, 물가/NNG;불안/NNG,945,1.7614756288181075,Hawkish
105,102, 유찰/NNG,207,1.4947338901139346,Hawkish
53,41, 매도헤지/NNG,94,1.8770107804775682,Hawkish
1678,1818, 생산자/NNG,3496,1.3402099308310578,Hawkish
25,13, 소비자/NNG;기대/NNG;지수/NNG;하락/NNG,38,2.792360014498559,Hawkish
104,87, 물가/NNG;상승/NNG;압력/NNG;높/VA,191,1.735756661886001,Hawkish
81,79, 금리/NNG;인상/NNG;쉽/VA;않/VX,160,1.488787390008599,Hawkish
35,29, 미/NNG;금리/NNG;급등/NNG,64,1.752446629788751,Hawkish
44,36, 수요/NNG;높/VV,80,1.774699920325751,Hawkish
35,20, 글로벌/NNG;인플레이션/NNG;우려/NNG,55,2.541047613193689,Hawkish
6330,7067, 장기물/NNG,13397,1.3005988713348602,Hawkish
14,13, 순매도량/NNG,27,1.5637216081191931,Hawkish
118,83, 메모/NNG,201,2.064327837224477,Hawkish
23,20, 인플레이/NNG,43,1.6698312886701383,Hawkish
53,22, 총평/NNG,75,3.498065545435468,Hawkish
170,26, 가령/MAG,196,9.494024049295101,Hawkish
866,855, 사실/MAG,1721,1.4707082593321534,Hawkish
2162,1103, 과/NNG,3265,2.8461312989119314,Hawkish
12088,12176, 긴축/NNG,24264,1.4415329241733297,Hawkish
1227,1362, 세부/NNG,2589,1.3081038059109111,Hawkish
398,124, 명/NNG,522,4.660538940327595,Hawkish
297,294, 공업/NNG,591,1.4668438116978146,Hawkish
8,8, 된다기/XSV,16,1.4520272075392506,Hawkish
62,57, 부드럽/VA,119,1.5793980152181324,Hawkish
7998,8926, 전략/NNG,16924,1.301065830819956,Hawkish
2133,2191, 동의/NNG,4324,1.413589244035245,Hawkish
7346,7169, 증가율/NNG,14515,1.487877230657461,Hawkish
88,62, 다분히/MAG,150,2.0609418429589366,Hawkish
2631,1154, 작성/NNG,3785,3.3104710424920007,Hawkish
640,640, 소멸/NNG,1280,1.4520272075392509,Hawkish
772,638, 칼/NNG,1410,1.7569984392167737,Hawkish
134,139, 상이/NNG,273,1.3997960130234501,Hawkish
164,118, 경/NNG,282,2.0180717121731964,Hawkish
24,0, 왔음/VV,24,inf,Hawkish
128,92, 피크/NNG,220,2.0202117670111313,Hawkish
1126,1224, 정점/NNG,2350,1.335770127197056,Hawkish
305,282, 후행/NNG,587,1.5704549585087642,Hawkish
1286,1005, 이평선/NNG,2291,1.8580169043736086,Hawkish
15,9, 인플레이션/NNG;불확실성/NNG,24,2.420045345898751,Hawkish
12469,11794, 변동/NNG,24263,1.5351303417675868,Hawkish
12,7, 물가/NNG;상방/NNG;위험/NNG,19,2.489189498638716,Hawkish
39,27, 물가/NNG;경계/NNG,66,2.097372633112251,Hawkish
313,186, 중단기/NNG,499,2.443465139568739,Hawkish
558,495, 상승시/NNG,1053,1.6368306703169735,Hawkish
155,121, 어쩌면/MAG,276,1.8600348526329247,Hawkish
230,227, 반증/NNG,457,1.4712169944230296,Hawkish
483,463, 참조/NNG,946,1.5147497651003416,Hawkish
930,904, 기저효과/NNG,1834,1.4937890520038755,Hawkish
369,409, 변곡점/NNG,778,1.3100196566796665,Hawkish
55,46, 그런대로/MAG,101,1.736119487275191,Hawkish
96,28, 디플레이션갭/NNG,124,4.978378997277432,Hawkish
644,422, 동행/NNG,1066,2.2158898617423635,Hawkish
292,94, 순환변동치/NNG,386,4.510552602143205,Hawkish
181,150, 자생적/VAX,331,1.752112830430696,Hawkish
192,37, 인플레이션갭/NNG,229,7.534843887771247,Hawkish
16,9, 산출량/NNG,25,2.5813817022920014,Hawkish
350,349, 게재/NNG,699,1.4561877439505382,Hawkish
94,41, 휴지기/NNG,135,3.3290379880168186,Hawkish
44,43, 돌이켜/VV,87,1.4857952821331868,Hawkish
24,6, 지수전/NNG,30,5.808108830157003,Hawkish
110,106, 이론가/NNG,216,1.506820687069034,Hawkish
2701,1676, 투신/NNG,4377,2.340051006899473,Hawkish
995,991, 기인/NNG,1986,1.4578880640782588,Hawkish
138,21, 와/NNG,159,9.541893078115077,Hawkish
201,165, 단기자금시장/NNG,366,1.7688331437296327,Hawkish
1497,1638, 연체율/NNG,3135,1.3270358545093153,Hawkish
94,99, 차압/NNG,193,1.3786925000877732,Hawkish
549,537, 전고점/NNG,1086,1.4844747429032563,Hawkish
12,9, 금리/NNG;인상/NNG;인플레이션/NNG;억제/NNG,21,1.9360362767190011,Hawkish
11,7, 금리/NNG;인상/NNG;기대/NNG;확대/NNG,18,2.2817570404188228,Hawkish
18,9, 인플레이션/NNG;부담/NNG;완화/NNG,27,2.9040544150785017,Hawkish
48,42, 선진국/NNG;경기/NNG;둔화/NNG,90,1.6594596657591438,Hawkish
10,11, 경기/NNG;회복/NNG;불투명/NNG,21,1.3200247341265916,Hawkish
26,22, 국고채/NNG;금리/NNG;인상/NNG,48,1.7160321543645694,Hawkish
23,25, 수입/NNG;물가/NNG;급등/NNG,48,1.3358650309361106,Hawkish
36,33, 인플레이션/NNG;급등/NNG,69,1.58402968095191,Hawkish
98,75, 인플레이션/NNG;완화/NNG,173,1.8973155511846211,Hawkish
18,12, 통화정책/NNG;불안/NNG,30,2.1780408113088763,Hawkish
13,14, 주택시장/NNG;악화/NNG,27,1.3483109784293044,Hawkish
471,507, 통화/NNG;긴축/NNG,978,1.3489246839269962,Hawkish
36,36, 경기/NNG;하향/NNG,72,1.4520272075392509,Hawkish
49,27, 긴축/NNG;강화/NNG,76,2.6351604877564183,Hawkish
2421,2679, 동일/NNG,5100,1.3121903208109467,Hawkish
38,36, 출발/MAG,74,1.5326953857358758,Hawkish
456,500, 탐색/NNG,956,1.3242488132757968,Hawkish
45,30, 우려/NNG;완전히/MAG;해소/NNG,75,2.178040811308876,Hawkish
103,102, 어감/NNG,205,1.4662627683974787,Hawkish
1489,1653, 만기일/NNG,3142,1.3079664319576194,Hawkish
8384,9303, 동향/NNG,17687,1.308588208965826,Hawkish
93,84, 금리/NNG;하락/NNG;제한/NNG,177,1.6076015512041704,Hawkish
311,338, 직매입/NNG,649,1.3360368684754644,Hawkish
32,32, 겸한/VV,64,1.4520272075392506,Hawkish
134,125, 담화/NNG,259,1.5565731664820768,Hawkish
1321,747, 채/MAG,2068,2.56777502163233,Hawkish
34,37, 줌/VV,71,1.3342952717928251,Hawkish
11,10, 악화/NNG;개선/NNG,21,1.5972299282931757,Hawkish
12,11, 지으며/VV,23,1.58402968095191,Hawkish
18,6, 완만/NNG;경기/NNG;둔화/NNG,24,4.356081622617753,Hawkish
15,12, 미/NNG;경제/NNG;호조/NNG,27,1.8150340094240633,Hawkish
3191,3496, 지준율/NNG,6687,1.325348632510798,Hawkish
252,264, 광의/NNG,516,1.3860259708329212,Hawkish
11,9, 인상/NNG;총액/NNG;한도/NNG;대출/NNG;축소/NNG,20,1.774699920325751,Hawkish
9,7, 우려/NNG;채권/NNG;금리/NNG;급등/NNG,16,1.866892123979037,Hawkish
530,580, 원자재/NNG;가격/NNG;상승/NNG,1110,1.3268524482686257,Hawkish
869,738, 지준율/NNG;인상/NNG,1607,1.7097718744601746,Hawkish
210,182, 아태/NNG,392,1.6754160086991357,Hawkish
296,237, 만/NNG,533,1.8135023351545074,Hawkish
1800,119, 에서/NNG,1919,21.96343675269455,Hawkish
9,8, 채권/NNG;매수/NNG;위축/NNG,17,1.6335306084816572,Hawkish
14,7, 낙폭/NNG;크/VV;못하/VX,21,2.9040544150785017,Hawkish
461,469, 서프라이즈/NNG,930,1.427259152826428,Hawkish
23,22, 금리/NNG;정책/NNG;불확실성/NNG,45,1.5180284442455803,Hawkish
23,24, 금리/NNG;낙폭/NNG;제한/NNG,47,1.3915260738917818,Hawkish
9,8, 근시/NNG,17,1.6335306084816572,Hawkish
15,11, 일내/NNG,26,1.9800371011898874,Hawkish
339,294, 구조화채권/NNG,633,1.6742762699177076,Hawkish
57,31, 금리/NNG;상승/NNG;압력/NNG;높/VA,88,2.6698564783786227,Hawkish
434,403, 바트/NNG,837,1.5637216081191934,Hawkish
148,153, 물가/NNG;부담/NNG,301,1.4045753380118244,Hawkish
16,9, 금리/NNG;상승/NNG;제약/NNG,25,2.5813817022920014,Hawkish
144,155, 높/VA;금리/NNG;인상/NNG,299,1.3489801153913041,Hawkish
274,304, 물가/NNG;압력/NNG,578,1.308735048900509,Hawkish
51,34, 금리/NNG;인상/NNG;지준율/NNG;인상/NNG,85,2.1780408113088763,Hawkish
19,9, 외국인/NNG;시장/NNG;이탈/NNG,28,3.0653907714717517,Hawkish
315,282, 물가/NNG;잡/VV,597,1.6219452850172482,Hawkish
2677,1905, 채권투자/NNG,4582,2.0404602806207737,Hawkish
695,454, 차트/NNG,1149,2.22281698070436,Hawkish
1360,463, 발행시장/NNG,1823,4.265133914154171,Hawkish
788,543, 유통시장/NNG,1331,2.1071776050477524,Hawkish
13,6, 경일/NNG,19,3.1460589496683764,Hawkish
354,29, 작/NNG,383,17.72474591272051,Hawkish
51,50, 모종/NNG,101,1.481067751690036,Hawkish
10,9, 본회/NNG,19,1.6133635639325008,Hawkish
186,136, 월비/NNG,322,1.9858607397227985,Hawkish
300,332, 아마도/MAG,632,1.3120727778969135,Hawkish
90,60, 궤적/NNG,150,2.178040811308876,Hawkish
82,64, 함수/NNG,146,1.8604098596596652,Hawkish
885,680, 바라/VV,1565,1.8897707039297604,Hawkish
43,46, 재생산/NNG,89,1.357329780960604,Hawkish
140,28, 우측/NNG,168,7.260136037696255,Hawkish
125,21, 좌측/NNG,146,8.64301909249554,Hawkish
24,16, 조차/NNG,40,2.1780408113088763,Hawkish
3066,2297, 차/NNG,5363,1.9381434124141674,Hawkish
663,207, 은/NNG,870,4.650695838640209,Hawkish
89,64, 초과수요/NNG,153,2.0192253354842706,Hawkish
917,119, 는/VV,1036,11.189150834567169,Hawkish
3710,4018, 배경/NNG,7728,1.3407219860554058,Hawkish
232,237, 마저/MAG,469,1.4213937221481272,Hawkish
97,107, 엿보/VV,204,1.316323730199134,Hawkish
14,13, 빨간색/NNG,27,1.5637216081191931,Hawkish
20,9, 교시/NNG,29,3.2267271278650016,Hawkish
1722,1679, 영역/NNG,3401,1.489214324825843,Hawkish
136,101, 제법/MAG,237,1.9552049527261202,Hawkish
578,216, 잔존/NNG,794,3.885517249804106,Hawkish
16,8, 중략/NNG,24,2.9040544150785013,Hawkish
74,31, 망치/NNG,105,3.466129463158212,Hawkish
611,675, 명분/NNG,1286,1.314353516750344,Hawkish
18,18, 터무니/NNG,36,1.4520272075392509,Hawkish
190,176, 속성/NNG,366,1.5675293717753278,Hawkish
82,86, 통화승수/NNG,168,1.3844910583513785,Hawkish
20,19, 어설프/VA,39,1.5284496921465798,Hawkish
49,42, 방정식/NNG,91,1.694031742129126,Hawkish
16,4, 부득불/MAG,20,5.8081088301570025,Hawkish
1955,2105, 유통/NNG,4060,1.3485573352680453,Hawkish
146,3, 에서/MAG,149,70.66532410024354,Hawkish
40,44, 시킨다면/XSV,84,1.3200247341265916,Hawkish
63,69, 더더욱/MAG,132,1.325763972101055,Hawkish
323,336, 교란/NNG,659,1.39584758343803,Hawkish
216,78, 순환적/VAX,294,4.020998420877925,Hawkish
9,7, 대개/NNG,16,1.866892123979037,Hawkish
621,139, 을/NNG,760,6.487114358862408,Hawkish
35,33, 장시/NNG,68,1.5400288564810236,Hawkish
1106,989, 동/NNG,2095,1.6238039348214475,Hawkish
1273,805, 특수/NNG,2078,2.2961871244689025,Hawkish
1760,1778, 외부/NNG,3538,1.4373272695551638,Hawkish
12,8, 내생/NNG,20,2.1780408113088763,Hawkish
242,266, 하순/NNG,508,1.3210172339266866,Hawkish
692,499, 산업활동/NNG,1191,2.0136329210764763,Hawkish
84,41, 다/VV,125,2.9748850105682214,Hawkish
639,244, 증감/NNG,883,3.8026450230228743,Hawkish
12,11, 게임이론/NNG,23,1.58402968095191,Hawkish
27,26, 무임승차/NNG,53,1.5078744078292219,Hawkish
37,12, 컨대/XSV,49,4.47708388991269,Hawkish
32,18, 일면/NNG,50,2.5813817022920014,Hawkish
74,67, 무드/NNG,141,1.603731542655292,Hawkish
527,482, 공공요금/NNG,1009,1.5875899136373135,Hawkish
48,43, 무기력/NNG,91,1.6208675805089312,Hawkish
148,104, 정답/NNG,252,2.0663464107289338,Hawkish
26,15, 상술/NNG,41,2.5168471597347013,Hawkish
177,173, 실체/NNG,350,1.4856000909505631,Hawkish
412,416, 시사점/NNG,828,1.438065407466758,Hawkish
39,28, 대용/NNG,67,2.0224664676439565,Hawkish
44,33, 해낼/XSV,77,1.936036276719001,Hawkish
275,102, 치/NNG,377,3.9147792360126856,Hawkish
462,445, 경기순환/NNG,907,1.5074979098497392,Hawkish
16,9, 늘상/MAG,25,2.5813817022920014,Hawkish
8897,5177, 등급/NNG,14074,2.4954000512800296,Hawkish
937,486, 섹터/NNG,1423,2.7994845544532465,Hawkish
87,16, 만일/MAG,103,7.895397940994676,Hawkish
3152,1777, 단위/NNG,4929,2.5755710513020365,Hawkish
26,19, 쳐도/VV,45,1.9869845997905538,Hawkish
1321,1354, 레인지/NNG,2675,1.4166380658488555,Hawkish
362,327, 앞서/MAG,689,1.6074429636978862,Hawkish
429,320, 그럼에도/VA,749,1.946623975107308,Hawkish
1812,990, 도/NNG,2802,2.6576497980415374,Hawkish
22,18, 올랐으니/VV,40,1.774699920325751,Hawkish
102,31, 였/VV,133,4.777637908677535,Hawkish
64,66, 유추/NNG,130,1.4080263830683644,Hawkish
87,83, 용시/NNG,170,1.5220044223604194,Hawkish
65,40, 버퍼/NNG,105,2.3595442122512824,Hawkish
103,17, 와의/NNG,120,8.797576610384873,Hawkish
758,833, 상관관계/NNG,1591,1.321292464963688,Hawkish
80,63, 가미/NNG,143,1.8438440730657153,Hawkish
58,14, 월경/NNG,72,6.015541288376896,Hawkish
54,52, 공교/NNG,106,1.5078744078292219,Hawkish
115,122, 선과/NNG,237,1.368714171041097,Hawkish
124,0, 작/MAG,124,inf,Hawkish
7450,8054, 종가/NNG,15504,1.3431341812971713,Hawkish
17,7, 반영시/NNG,24,3.526351789738181,Hawkish
7229,2369, 은행채/NNG,9598,4.430858878556878,Hawkish
36,16, 월전/NNG,52,3.2670612169633144,Hawkish
364,97, 주전/NNG,461,5.448844366435951,Hawkish
1169,208, 개/NNG,1377,8.16067214237204,Hawkish
2008,308, 순발행/NNG,2316,9.466463093307842,Hawkish
1089,1178, 데이터/NNG,2267,1.3423239635061495,Hawkish
612,433, 전산/NNG,1045,2.0522878776305347,Hawkish
2526,621, 금융채/NNG,3147,5.906313568831155,Hawkish
3555,1177, 무보증/NNG,4732,4.385689654037415,Hawkish
87,53, 순증액/NNG,140,2.383516359545563,Hawkish
476,291, 월별/NNG,767,2.3751372879336197,Hawkish
515,459, 지방채/NNG,974,1.6291808537749763,Hawkish
4374,345, 특수채/NNG,4719,18.409179726888937,Hawkish
2737,2716, 기금/NNG,5453,1.4632542220305336,Hawkish
1059,605, 공제/NNG,1664,2.541647624436474,Hawkish
892,123, 기타법인/NNG,1015,10.53014852947164,Hawkish
53,12, 증감액/NNG,65,6.413120166631691,Hawkish
467,255, 영국채/NNG,722,2.6592027683169808,Hawkish
36,8, 독일채/NNG,44,6.534122433926629,Hawkish
142,1, 일본채/NNG,143,206.18786347057363,Hawkish
838,877, 엔달러/NNG,1715,1.3874558721982806,Hawkish
966,788, 주식형/NNG,1754,1.7800232011204522,Hawkish
1170,362, 종금/NNG,1532,4.693016112764982,Hawkish
56,50, 일전/NNG,106,1.626270472443961,Hawkish
283,287, 시장성/NNG,570,1.4317898945421879,Hawkish
22,8, 수신증/NNG,30,3.9930748207329394,Hawkish
67,27, 구성항목/NNG,94,3.603178626115918,Hawkish
40,41, 이격도/NNG,81,1.416611909794391,Hawkish
5872,1879, 본부/NNG,7751,4.5376816193030765,Hawkish
2566,653, 빌딩/NNG,3219,5.7058220743426,Hawkish
3856,1693, 층/NNG,5549,3.3071570657243656,Hawkish
73,58, 상계/NNG,131,1.827551485351126,Hawkish
112,100, 교보/NNG,212,1.626270472443961,Hawkish
92,89, 명동/NNG,181,1.5009719448720344,Hawkish
16,1, 개양/NNG,17,23.23243532062801,Hawkish
62,61, 나래/NNG,123,1.4758309322530092,Hawkish
39,36, 가락/NNG,75,1.5730294748341884,Hawkish
30,5, 길동/NNG,35,8.712163245235503,Hawkish
56,37, 곡/NNG,93,2.197662800599947,Hawkish
54,40, 쇼핑센터/NNG,94,1.9602367301779884,Hawkish
130,92, 영업부/NNG,222,2.0517775758706804,Hawkish
17,9, 화곡/NNG,26,2.7427180586852518,Hawkish
17,3, 도루/MAG,20,8.228154176055755,Hawkish
18,2, 봉천/NNG,20,13.068244867853258,Hawkish
39,37, 건국/NNG,76,1.5305151647035347,Hawkish
24,9, 이마/NNG,33,3.8720725534380023,Hawkish
60,53, 리안/NNG,113,1.6438043858934914,Hawkish
25,15, 명지/NNG,40,2.4200453458987514,Hawkish
18,5, 대준/NNG,23,5.227297947141303,Hawkish
39,40, 지움/VV,79,1.4157265273507695,Hawkish
16,1, 융기/NNG,17,23.23243532062801,Hawkish
100,89, 아카데미/NNG,189,1.6314912444261245,Hawkish
31,11, 경산/NNG,42,4.092076675792434,Hawkish
37,2, 상동/MAG,39,26.86250333947614,Hawkish
379,247, 베스트/NNG,626,2.228009358936745,Hawkish
235,253, 타운/NNG,488,1.3487209239989089,Hawkish
62,41, 안양/NNG,103,2.1957484601813064,Hawkish
12,12, 구포/NNG,24,1.4520272075392509,Hawkish
17,6, 진구/NNG,23,4.114077088027877,Hawkish
21,8, 아이온/NNG,29,3.8115714197905333,Hawkish
20,5, 사하/NNG,25,5.808108830157003,Hawkish
804,736, 해운/NNG,1540,1.5861818951923337,Hawkish
19,1, 대점/NNG,20,27.588516943245768,Hawkish
17,0, 범일/NNG,17,inf,Hawkish
302,161, 번지/NNG,463,2.7236783644525078,Hawkish
38,6, 죽전/NNG,44,9.196172314415255,Hawkish
17,7, 동강/NNG,24,3.526351789738181,Hawkish
31,6, 범어/NNG,37,7.5021405722861285,Hawkish
26,16, 성서/NNG,42,2.359544212251283,Hawkish
23,25, 상호신용금고/NNG,48,1.3358650309361106,Hawkish
18,3, 금남/NNG,21,8.712163245235505,Hawkish
19,1, 성일/NNG,20,27.588516943245768,Hawkish
20,21, 신일/NNG,41,1.3828830547992865,Hawkish
18,1, 호피/NNG,19,26.136489735706515,Hawkish
18,3, 풍림/NNG,21,8.712163245235505,Hawkish
16,0, 금하/NNG,16,inf,Hawkish
36,23, 선수촌/NNG,59,2.272738237887523,Hawkish
20,2, 시그마/NNG,22,14.520272075392509,Hawkish
29,22, 화정/NNG,51,1.914035864483558,Hawkish
85,56, 소망/NNG,141,2.203969868586363,Hawkish
37,36, 아크/NNG,73,1.4923612966375635,Hawkish
21,3, 홍천군/NNG,24,10.164190452774754,Hawkish
39,0, 북문/NNG,39,inf,Hawkish
31,20, 대명/NNG,51,2.250642171685839,Hawkish
637,702, 남/NNG,1339,1.3175802438782092,Hawkish
21,14, 금리/NNG;인상/NNG;통화/NNG;긴축/NNG,35,2.1780408113088763,Hawkish
13,9, 통화정책/NNG;인플레이션/NNG;억제/NNG,22,2.097372633112251,Hawkish
31,16, 글로벌/NNG;인플레이션/NNG;압력/NNG,47,2.8133027146072984,Hawkish
20,18, 인플레이션/NNG;금리/NNG;상승/NNG,38,1.6133635639325008,Hawkish
38,12, 인플레이션/NNG;기대/NNG;차단/NNG,50,4.598086157207628,Hawkish
11,6, 인플레이션/NNG;기대/NNG;완화/NNG,17,2.662049880488626,Hawkish
12,8, 주택가격/NNG;지수/NNG;하락/NNG,20,2.1780408113088763,Hawkish
40,30, 높/VA;인플레이션/NNG;압력/NNG,70,1.936036276719001,Hawkish
25,13, 금리/NNG;변동성/NNG;축소/NNG,38,2.792360014498559,Hawkish
15,8, 회사채/NNG;금리/NNG;급등/NNG,23,2.722551014136095,Hawkish
61,36, 부동산/NNG;경기/NNG;하락/NNG,97,2.460379434997064,Hawkish
14,14, 신흥국/NNG;수요/NNG;증가/NNG,28,1.4520272075392509,Hawkish
33,33, 금리/NNG;상승/NNG;충격/NNG,66,1.4520272075392506,Hawkish
31,27, 우려/NNG;주가/NNG;하락/NNG,58,1.6671423493969175,Hawkish
47,46, 자금/NNG;유입/NNG;둔화/NNG,93,1.4835930163987996,Hawkish
141,153, 물가/NNG;상승률/NNG;높/VA,294,1.338142720673427,Hawkish
56,51, 인상/NNG;가능성/NNG;높/VA,107,1.59438281612153,Hawkish
26,24, 제한적/VAX;밖/NNG;없/VA,50,1.5730294748341882,Hawkish
86,90, 주택담보대출/NNG;급증/NNG,176,1.3874926649819508,Hawkish
18,19, 인플레이션/NNG;긴축/NNG,37,1.375604722931922,Hawkish
16,3, 인플레이션/NNG;최대/NNG,19,7.744145106876003,Hawkish
28,18, 채권시장/NNG;과열/NNG,46,2.258708989505501,Hawkish
266,205, 신용경색/NNG;우려/NNG,471,1.8840938400265401,Hawkish
49,40, 유동성/NNG;억제/NNG,89,1.7787333292355823,Hawkish
36,39, 긴축/NNG;아니/VCN,75,1.3403328069593086,Hawkish
87,63, 신용/NNG;확대/NNG,150,2.0051804294589655,Hawkish
14,9, 경제/NNG;팽창/NNG,23,2.258708989505501,Hawkish
46,38, 경제/NNG;호황/NNG,84,1.7577171459685668,Hawkish
140,108, 금리/NNG;고점/NNG,248,1.8822574912545844,Hawkish
8,8, 고점/NNG;아니/VCN,16,1.4520272075392506,Hawkish
11,11, 예상/NNG;높/VV,22,1.4520272075392509,Hawkish
198,209, 시간외거래/NNG,407,1.375604722931922,Hawkish
128,96, 미채권/NNG,224,1.9360362767190007,Hawkish
18,13, 인상/NNG;힘들/VA,31,2.010499210438963,Hawkish
41,38, 반대급부/NNG,79,1.5666609344502442,Hawkish
19,14, 기대/NNG;잡/VV,33,1.9706083530889835,Hawkish
94,92, 범주/NNG,186,1.4835930163987996,Hawkish
224,15, 개국/NNG,239,21.683606299252812,Hawkish
456,478, 외형/NNG,934,1.3851975034265658,Hawkish
24,21, 차입경영/NNG,45,1.6594596657591438,Hawkish
781,738, 주체/NNG,1519,1.536630418818638,Hawkish
66,16, 월보/NNG,82,5.989612231099409,Hawkish
39,21, 에너지제외지수/NNG,60,2.6966219568586087,Hawkish
71,72, 위시/NNG,143,1.4318601629900947,Hawkish
40,20, 지준율/NNG;인상/NNG;금리/NNG;인상/NNG,60,2.9040544150785017,Hawkish
13,8, 유가/NNG;상품/NNG;가격/NNG;상승/NNG,21,2.359544212251283,Hawkish
13,3, 안정/NNG;인플레이션/NNG;억제/NNG,16,6.292117899336753,Hawkish
31,8, 국고채/NNG;발행/NNG;감소/NNG,39,5.626605429214597,Hawkish
22,15, 경기/NNG;둔화/NNG;부담/NNG,37,2.129639904390901,Hawkish
13,10, 우려/NNG;금리/NNG;급등/NNG,23,1.887635369801026,Hawkish
10,6, 둔화/NNG;가능성/NNG;높/VA,16,2.420045345898751,Hawkish
11,10, 물가/NNG;민생안정/NNG,21,1.5972299282931757,Hawkish
40,38, 인상/NNG;부담/NNG,78,1.5284496921465798,Hawkish
734,772, 장기투자기관/NNG,1506,1.3805543657173704,Hawkish
1049,517, 허리케인/NNG,1566,2.9461828640399887,Hawkish
1098,1144, 발사/NNG,2242,1.3936414981451901,Hawkish
36,35, 대외/NNG;여건/NNG;개선/NNG,71,1.4935136991832296,Hawkish
875,852, 미사일/NNG,1727,1.491225125113667,Hawkish
26,26, 물가/NNG;상승률/NNG;물가/NNG;안정/NNG,52,1.4520272075392509,Hawkish
9,8, 묵시/NNG,17,1.6335306084816572,Hawkish
24,9, 동/MAG,33,3.8720725534380023,Hawkish
108,0, 월과/NNG,108,inf,Hawkish
4035,4389, 변경/NNG,8424,1.3349122311280193,Hawkish
8,8, 물가/NNG;오르/VV;금리/NNG;오르/VV,16,1.4520272075392506,Hawkish
21,20, 악순환/NNG;우려/NNG,41,1.5246285679162133,Hawkish
34,32, 결정타/NNG,66,1.5427789080104541,Hawkish
491,347, 채권스왑/NNG,838,2.0545975760857984,Hawkish
704,776, 계정/NNG,1480,1.3173030336438565,Hawkish
1668,1815, 옵션/NNG,3483,1.3344250039534271,Hawkish
172,185, 잠식/NNG,357,1.349992863225682,Hawkish
31,30, 완벽히/MAG,61,1.5004281144572258,Hawkish
56,46, 장기물/NNG;하락/NNG,102,1.76768529613474,Hawkish
292,325, 우려/NNG;높/VA,617,1.304590598773727,Hawkish
1023,118, 별/NNG,1141,12.588337570446217,Hawkish
65,60, 외생변수/NNG,125,1.5730294748341882,Hawkish
4980,4765, 사회/NNG,9745,1.5175436502718718,Hawkish
107,2, 씩/MAG,109,77.68345560334993,Hawkish
140,148, 어찌/MAG,288,1.373539250374967,Hawkish
491,506, 강경/NNG,997,1.4089829227307749,Hawkish
128,136, 억누르/VV,264,1.3666138423898828,Hawkish
128,54, 수요견인/NNG,182,3.441842269722668,Hawkish
34,32, 혼동/NNG,66,1.5427789080104541,Hawkish
9,8, 키는/XSV,17,1.6335306084816572,Hawkish
21,22, 다채/NNG,43,1.3860259708329212,Hawkish
2519,2629, 관점/NNG,5148,1.3912729310731735,Hawkish
678,660, 괴리/NNG,1338,1.4916279495630487,Hawkish
226,135, 패니매/NNG,361,2.4308011029916345,Hawkish
100,108, 자/VV,208,1.3444696366104174,Hawkish
611,522, 도매/NNG,1133,1.6995950647633757,Hawkish
532,301, 화/NNG,833,2.566373669139141,Hawkish
8276,9235, 제조업/NNG,17511,1.301242790427162,Hawkish
50,36, 인플레이션/NNG;기대/NNG;억제/NNG,86,2.0167044549156263,Hawkish
27,25, 인플레이션/NNG;우려/NNG;확산/NNG,52,1.568189384142391,Hawkish
33,35, 소폭/MAG;금리/NNG;인상/NNG,68,1.3690542242512935,Hawkish
10,11, 금리/NNG;유가/NNG;상승/NNG,21,1.3200247341265916,Hawkish
26,29, 가격/NNG;오르/VV;않/VX,55,1.3018174964145008,Hawkish
756,729, 인플레이션/NNG;억제/NNG,1485,1.5058059930036676,Hawkish
285,247, 인상/NNG;효과/NNG,532,1.6754160086991357,Hawkish
32,27, 금리/NNG;확대/NNG,59,1.720921134861334,Hawkish
10,7, 경기/NNG;쉽/VA,17,2.07432458219893,Hawkish
15,15, 본지/NNG,30,1.4520272075392506,Hawkish
8,8, 점간/NNG,16,1.4520272075392506,Hawkish
3127,2836, 초과/NNG,5963,1.6010187157881655,Hawkish
10,11, 금리/NNG;상승/NNG;반납/NNG,21,1.3200247341265916,Hawkish
11,7, 안정/NNG;기대/NNG;높/VV,18,2.2817570404188228,Hawkish
658,551, 중장기물/NNG,1209,1.7339998231593956,Hawkish
708,305, 구간별/NNG,1013,3.3706074194681626,Hawkish
10,8, 경기/NNG;둔화/NNG;인플레이션/NNG;위험/NNG,18,1.8150340094240636,Hawkish
10,6, 금리/NNG;하락/NNG;금리/NNG;하락/NNG,16,2.420045345898751,Hawkish
23,15, 단기물/NNG;금리/NNG;인상/NNG,38,2.2264417182268508,Hawkish
18,14, 현물/NNG;금리/NNG;하락/NNG,32,1.866892123979037,Hawkish
9,7, 세계/NNG;수요/NNG;감소/NNG,16,1.866892123979037,Hawkish
26,27, 소비자/NNG;물가/NNG;높/VA,53,1.3982484220748341,Hawkish
486,364, 파워/NNG,850,1.9386956672089999,Hawkish
108,79, 송유관/NNG,187,1.9850498533447987,Hawkish
62,58, 폭발사고/NNG,120,1.552167014955751,Hawkish
34,33, 유가증권신고서/NNG,67,1.4960280320101373,Hawkish
77,64, 인플레이션/NNG;우려/NNG;완화/NNG,141,1.7469702340706612,Hawkish
77,72, 지정학/NNG;위험/NNG;완화/NNG,149,1.552862430285032,Hawkish
29,29,반전/NNG,58,1.4520272075392509,Hawkish
39,15, 틀림없이/MAG,54,3.775270739602052,Hawkish
1256,884, 일자/NNG,2140,2.063061281300112,Hawkish
57,40, 주보/NNG,97,2.0691387707434323,Hawkish
11,7, 타당/MAG,18,2.2817570404188228,Hawkish
211,204, 가/NNG,415,1.5018516705430485,Hawkish
236,4, 으로/MAG,240,85.6696052448158,Hawkish
1592,1764, 단기간/NNG,3356,1.310446323357419,Hawkish
1929,1298, 듀레이션/NNG,3227,2.157904840788301,Hawkish
636,30, 전채/NNG,666,30.782976799832113,Hawkish
106,12, 금채/NNG,118,12.826240333263382,Hawkish
119,11, 산금/NNG,130,15.70829433610644,Hawkish
23,23, 중금/NNG,46,1.4520272075392506,Hawkish
259,42, 텍스/NNG,301,8.95416777982538,Hawkish
97,108, 갈림길/NNG,205,1.3041355475121048,Hawkish
34,29, 자동차기업/NNG,63,1.7023767260805012,Hawkish
449,374, 주택매매/NNG,823,1.7432091341848224,Hawkish
538,531, 운송/NNG,1069,1.4711688091452297,Hawkish
39,7, 예상밖/NNG;금리/NNG;인상/NNG,46,8.089865870575826,Hawkish
23,25, 유가/NNG;하향/NNG;안정/NNG,48,1.3358650309361106,Hawkish
42,42, 통화/NNG;긴축/NNG;우려/NNG,84,1.4520272075392509,Hawkish
13,13, 예상/NNG;안정/NNG,26,1.4520272075392509,Hawkish
103,87, 지준일/NNG,190,1.719066693983251,Hawkish
4851,3581, 콜/NNG,8432,1.9669879876495129,Hawkish
264,260, 예보/NNG,524,1.4743660876552394,Hawkish
116,101, 경기/NNG;선행/NNG;지수/NNG;하락/NNG,217,1.6676748126193375,Hawkish
31,19, 통안채/NNG;입찰/NNG;부진/NNG,50,2.369097022827199,Hawkish
127,119, 채권시장/NNG;부담/NNG,246,1.5496424819956711,Hawkish
12,13, 금리/NNG;단기/NNG;급락/NNG,25,1.3403328069593086,Hawkish
25,7, 기대/NNG;인플레이션/NNG;억제/NNG,32,5.1858114554973245,Hawkish
16,8, 주택/NNG;판매가격/NNG;최저/NNG,24,2.9040544150785013,Hawkish
50,44, 매도주체/NNG,94,1.6500309176582397,Hawkish
29,15, 금리/NNG;낙폭/NNG;확대/NNG,44,2.8072526012425514,Hawkish
14,7, 이루어짐/VV,21,2.9040544150785017,Hawkish
2142,1785, 잔고/NNG,3927,1.742432649047101,Hawkish
689,516, 약/NNG,1205,1.9388502829351622,Hawkish
29,32, 멈칫/MAG,61,1.315899656832446,Hawkish
129,136, 조정심리/NNG,265,1.377290513033554,Hawkish
110,64, 하락룸/NNG,174,2.495671762958087,Hawkish
21,20, 경기/NNG;둔화/NNG;가속/NNG,41,1.5246285679162133,Hawkish
36,35, 소비/NNG;둔화/NNG;우려/NNG,71,1.4935136991832296,Hawkish
2542,2829, 도래/NNG,5371,1.3047200995280224,Hawkish
2643,2653, 유효/NNG,5296,1.4465540556073275,Hawkish
4562,4481, 펀더멘털/NNG,9043,1.4782745192577689,Hawkish
1823,1399, 상/NNG,3222,1.8920983554996813,Hawkish
45,35, 했다/XSV,80,1.8668921239790368,Hawkish
174,146, 순수출/NNG,320,1.7304981788481482,Hawkish
102,89, 이평/NNG,191,1.664121069314647,Hawkish
141,107, 환기/NNG,248,1.9134190304956482,Hawkish
26,13, 어쨌든/MAG,39,2.9040544150785017,Hawkish
634,614, 매크로/NNG,1248,1.499324510716425,Hawkish
136,12, 으로/NNG,148,16.45630835211151,Hawkish
14,6, 거위/NNG,20,3.3880634842582515,Hawkish
23,21, 부추/NNG,44,1.5903155130191793,Hawkish
298,332, 후유증/NNG,630,1.3033256260442672,Hawkish
29,23, 째/VV,52,1.830816913853838,Hawkish
30,23, 최종재/NNG,53,1.8939485315729356,Hawkish
26,22, 필수품/NNG,48,1.7160321543645694,Hawkish
20,19, 경도/NNG,39,1.5284496921465798,Hawkish
197,220, 자생력/NNG,417,1.3002243631146928,Hawkish
92,89, 건재/NNG,181,1.5009719448720344,Hawkish
57,61, 디레버리지/NNG,118,1.3568123086842179,Hawkish
380,413, 환경변화/NNG,793,1.3360056631111752,Hawkish
13,10, 버텨온/VV,23,1.887635369801026,Hawkish
14,15, 다름아닌/VA,29,1.3552253937033008,Hawkish
14,14, 함/NNG,28,1.4520272075392509,Hawkish
20,7, 증분/NNG,27,4.14864916439786,Hawkish
239,230, 감속/NNG,469,1.508845663486439,Hawkish
22,14, 도식/NNG,36,2.2817570404188228,Hawkish
44,22, 분해/NNG,66,2.9040544150785017,Hawkish
28,29, 노후화/NNG,57,1.4019573038310007,Hawkish
117,36, 가지/NNG,153,4.719088424502565,Hawkish
1644,1801, 시나리오/NNG,3445,1.3254484892806933,Hawkish
9,8, 놔/VV,17,1.6335306084816572,Hawkish
67,63, 계량/NNG,130,1.5442194111925363,Hawkish
18,9, 기전/NNG,27,2.9040544150785017,Hawkish
66,65, 불변/NNG,131,1.4743660876552394,Hawkish
153,118, 번/VV,271,1.8827132436737744,Hawkish
226,242, 나타난다/VV,468,1.3560254086936805,Hawkish
463,448, 모형/NNG,911,1.5006441899345384,Hawkish
10,6, 변시/NNG,16,2.420045345898751,Hawkish
28,26, 던/VV,54,1.5637216081191931,Hawkish
291,257, 출하/NNG,548,1.6441241921942489,Hawkish
314,318, 쇠고기/NNG,632,1.4337627143626563,Hawkish
2993,2902, 설비/NNG,5895,1.4975594183890342,Hawkish
18,20, 다/VA,38,1.3068244867853258,Hawkish
35,30, 수출대상국/NNG,65,1.694031742129126,Hawkish
81,80, 무역협회/NNG,161,1.4701775476334913,Hawkish
117,117, 감행/NNG,234,1.4520272075392506,Hawkish
27,29, 한다기/XSV,56,1.3518874001227508,Hawkish
594,609, 통/NNG,1203,1.4162629906047866,Hawkish
60,59, 선반/NNG,119,1.4766378381755094,Hawkish
45,49, 영한/VA,94,1.3334943742707404,Hawkish
18,20, 추수/NNG,38,1.3068244867853258,Hawkish
18,12, 궁색/NNG,30,2.1780408113088763,Hawkish
9,10, 녹녹/NNG,19,1.3068244867853258,Hawkish
111,115, 단발/NNG,226,1.4015219133639727,Hawkish
112,58, 변명/NNG,170,2.8039146076620014,Hawkish
14,12, 체면치레/NNG,26,1.6940317421291258,Hawkish
95,103, 봉쇄/NNG,198,1.3392483953031926,Hawkish
96,87, 득세/NNG,183,1.602236918664001,Hawkish
30,11, 상순/NNG,41,3.960074202379775,Hawkish
1943,787, 구분/NNG,2730,3.5848651388167276,Hawkish
271,289, 하락시/NNG,560,1.3615895267928615,Hawkish
74,1, 행순/NNG,75,107.45001335790457,Hawkish
204,224, 예탁/NNG,428,1.3223819211518177,Hawkish
955,550, 채권형/NNG,1505,2.52124724218179,Hawkish
10,6, 절대치/NNG,16,2.420045345898751,Hawkish
1213,1352, 선물환/NNG,2565,1.302743345225674,Hawkish
86,89, 가솔린/NNG,175,1.403082470206467,Hawkish
71,71, 관세청/NNG,142,1.4520272075392509,Hawkish
814,567, 티/NNG,1381,2.084568160382628,Hawkish
11,6, 공공/NNG;서비스/NNG;요금/NNG;인상/NNG,17,2.662049880488626,Hawkish
29,7, 금리/NNG;상승/NNG;금리/NNG;상승/NNG,36,6.015541288376896,Hawkish
9,9, 은행채/NNG;금리/NNG;급등/NNG,18,1.4520272075392509,Hawkish
107,75, 경기/NNG;하락/NNG;우려/NNG,182,2.0715588160893312,Hawkish
13,10, 원유/NNG;수요/NNG;둔화/NNG,23,1.887635369801026,Hawkish
16,6, 수출/NNG;경기/NNG;호조/NNG,22,3.8720725534380014,Hawkish
28,14, 금리/NNG;추세/NNG;하락/NNG,42,2.9040544150785017,Hawkish
11,9, 경기/NNG;우려/NNG;높/VV,20,1.774699920325751,Hawkish
22,16, 인상/NNG;쉽/VA;않/VX,38,1.9965374103664697,Hawkish
24,15, 신용경색/NNG;확산/NNG,39,2.3232435320628015,Hawkish
13,4, 경기순환/NNG;하락/NNG,17,4.719088424502566,Hawkish
15,10, 상승률/NNG;상회/NNG,25,2.178040811308876,Hawkish
46,45, 신용/NNG;불안/NNG,91,1.4842944788179007,Hawkish
15,15, 고점/NNG;상승/NNG,30,1.4520272075392506,Hawkish
8,8, 성장/NNG;감속/NNG,16,1.4520272075392506,Hawkish
11,8, 경제/NNG;급락/NNG,19,1.9965374103664697,Hawkish
22,21, 수요/NNG;하락/NNG,43,1.5211713602792152,Hawkish
20,15, 생산/NNG;증대/NNG,35,1.936036276719001,Hawkish
29,27, 원화/NNG;안정/NNG,56,1.559584778468084,Hawkish
68,45, 긴축/NNG;효과/NNG,113,2.1941744469482014,Hawkish
17,12, 수출/NNG;호황/NNG,29,2.0570385440139387,Hawkish
44,34, 인상/NNG;반대/NNG,78,1.879094033286089,Hawkish
21,21, 긴축/NNG;부담/NNG,42,1.4520272075392509,Hawkish
67,74, 미처/MAG,141,1.314673282501754,Hawkish
462,514, 예상/NNG;상회/NNG,976,1.3051295133913112,Hawkish
121,106, 세금환급/NNG,227,1.6575027557759372,Hawkish
11,8, 금리/NNG;인플레이션/NNG;우려/NNG,19,1.9965374103664697,Hawkish
184,144, 환매수/NNG,328,1.855368098522376,Hawkish
20,22, 심리/NNG;높/VA,42,1.3200247341265916,Hawkish
422,424, 케/XSV,846,1.445178022598028,Hawkish
117,123, 못지/VA,240,1.3811966120495311,Hawkish
21,1, 현은/NNG,22,30.492571358324266,Hawkish
17,13, 금리선물옵션/NNG,30,1.8988048098590204,Hawkish
11,6, 바이어스/NNG,17,2.662049880488626,Hawkish
157,171, 반사/NNG,328,1.3331477870389612,Hawkish
47,52, 인플레이션/NNG;경계/NNG,99,1.3124092068143227,Hawkish
10,8, 인상/NNG;긴축/NNG,18,1.8150340094240636,Hawkish
19,0, 월주/NNG,19,inf,Hawkish
16,9, 메아리/NNG,25,2.5813817022920014,Hawkish
1371,1283, 상승국면/NNG,2654,1.5516206559129484,Hawkish
146,133, 무력/NNG,279,1.5939546789528618,Hawkish
71,64, 스펙/NNG,135,1.6108426833638565,Hawkish
773,611, 비제조업/NNG,1384,1.8370164180488393,Hawkish
44,17, 재고지수/NNG,61,3.758188066572178,Hawkish
23,3, 연간화/NNG,26,11.132208591134255,Hawkish
772,802, 가동률/NNG,1574,1.3977119753370344,Hawkish
35,23, 경기/NNG;둔화/NNG;우려/NNG;하락/NNG,58,2.2096066201684255,Hawkish
19,5, 위험/NNG;없/VA;않/VX,24,5.517703388649153,Hawkish
57,16, 씩/NNG,73,5.172846926858581,Hawkish
28,21, 인플레이션/NNG;불안/NNG,49,1.9360362767190011,Hawkish
11638,1684, 크레딧/NNG,13322,10.03485311243575,Hawkish
24,20, 은행채/NNG;금리/NNG;상승/NNG,44,1.742432649047101,Hawkish
62,56, 금리/NNG;상승/NNG;부담/NNG,118,1.6076015512041708,Hawkish
54,50, 무역지수/NNG,104,1.568189384142391,Hawkish
23,24, 유가/NNG;소폭/MAG;상승/NNG,47,1.3915260738917818,Hawkish
26,16, 꼬임/NNG,42,2.359544212251283,Hawkish
27,26, 무위험자산/NNG,53,1.5078744078292219,Hawkish
385,255, 순증/NNG,640,2.192276372167104,Hawkish
2167,1741, 차환/NNG,3908,1.8073193329911297,Hawkish
87,45, 하반/NNG,132,2.8072526012425514,Hawkish
1100,950, 발행계획/NNG,2050,1.6812946613612378,Hawkish
155,115, 그래프/NNG,270,1.9570801492920338,Hawkish
29,16, 기발/NNG,45,2.631799313664892,Hawkish
112,61, 구축효과/NNG,173,2.6660171679409195,Hawkish
14,15, 생겨서/VV,29,1.3552253937033008,Hawkish
189,203, 가수요/NNG,392,1.3518874001227508,Hawkish
219,111, 자산부채/NNG,330,2.86481043649636,Hawkish
2889,3089, 재무/NNG,5978,1.3580144391650681,Hawkish
13,11, 키워온/VV,24,1.7160321543645694,Hawkish
10,7, 망설임/VV,17,2.07432458219893,Hawkish
553,474, 아울러/MAG,1027,1.694031742129126,Hawkish
7511,7797, 절상/NNG,15308,1.3987657247437877,Hawkish
47,49, 음/NNG,96,1.3927607909049955,Hawkish
22,21, 유로채/NNG,43,1.5211713602792152,Hawkish
458,438, 실세/NNG,896,1.518329819755655,Hawkish
3367,3060, 캐리/NNG,6427,1.5977044469884503,Hawkish
1720,1778, 서브프라임/NNG,3498,1.4046607407016372,Hawkish
141,156, 현시점/NNG,297,1.3124092068143227,Hawkish
148,138, 장기추세/NNG,286,1.557246570404414,Hawkish
142,122, 쌍둥이적자/NNG,264,1.690064454676833,Hawkish
940,972, 한미/NNG,1912,1.4042238426819915,Hawkish
548,234, 산금채/NNG,782,3.4004739732115787,Hawkish
85,82, 일러/VV,167,1.5051501541565404,Hawkish
9,8, 통화정책/NNG;방향/NNG;완화/NNG,17,1.6335306084816572,Hawkish
9,7, 기술적/VAX;지지선/NNG;무너/VV,16,1.866892123979037,Hawkish
25,21, 채권시장/NNG;위험/NNG,46,1.7286038184991082,Hawkish
29,30, 신용위기/NNG;최악/NNG,59,1.4036263006212757,Hawkish
326,322, 유동성/NNG;흡수/NNG,648,1.4700648126018503,Hawkish
60,13, 크레딧/NNG;약세/NNG,73,6.701664034796542,Hawkish
28,19, 국고채/NNG;강세/NNG,47,2.1398295690052116,Hawkish
17,12, 원달러/NNG;강세/NNG,29,2.0570385440139387,Hawkish
269,258, 경기/NNG;바닥/NNG,527,1.5139353442948003,Hawkish
18,14, 경기/NNG;지탱/NNG,32,1.866892123979037,Hawkish
26,29, 금리/NNG;압박/NNG,55,1.3018174964145008,Hawkish
74,68, 위기/NNG;넘/VV,142,1.5801472552633022,Hawkish
5574,2203, 민평/NNG,7777,3.6738990716403923,Hawkish
43,10, 발행재개/NNG,53,6.243716992418778,Hawkish
331,272, 비우호적/VAX,603,1.766988991527544,Hawkish
644,665, 장단기스프레드/NNG,1309,1.4061737167748534,Hawkish
2221,808, 공사채/NNG,3029,3.9912777573572717,Hawkish
2542,819, 유동화/NNG,3361,4.506780417051008,Hawkish
41,45, 괴롭히/VV,86,1.3229581224246507,Hawkish
19,11, 맞물려서/VV,30,2.5080469948405244,Hawkish
229,239, 속보/NNG,468,1.3912729310731735,Hawkish
3397,3191, 전문/NNG,6588,1.5457650968382437,Hawkish
112,29, 주택지/NNG,141,5.607829215324003,Hawkish
132,40, 시계열/NNG,172,4.791689784879527,Hawkish
665,85, 지/XSV,750,11.359977564865904,Hawkish
129,8, 행지/NNG,137,23.41393872157042,Hawkish
15,16, 모기지/NNG;금리/NNG;안정/NNG,31,1.3612755070680476,Hawkish
14,7, 금리/NNG;일시적/VAX;상승/NNG,21,2.9040544150785017,Hawkish
150,151, 자산/NNG;가격/NNG;거품/NNG,301,1.4424111333171366,Hawkish
11,8, 주택/NNG;재고/NNG;감소/NNG,19,1.9965374103664697,Hawkish
24,11, 펀더멘털/NNG;둔화/NNG,35,3.16805936190382,Hawkish
23,17, 거품/NNG;해소/NNG,40,1.9645073984354566,Hawkish
133,58, 중금채/NNG,191,3.329648596598627,Hawkish
251,27, 계/NNG,278,13.49847515156859,Hawkish
682,415, 회/NNG,1097,2.3862230254018533,Hawkish
136,128, 료/NNG,264,1.5427789080104541,Hawkish
224,220, 정/NNG,444,1.4784277022217827,Hawkish
43,12, 회/MAG,55,5.203097493682315,Hawkish
175,185, 록/NNG,360,1.373539250374967,Hawkish
381,304, 출/VV,685,1.8198104147120218,Hawkish
683,546, 유/NNG,1229,1.8163637046690628,Hawkish
26,28, 압/NNG,54,1.3483109784293044,Hawkish
27,5, 력/NNG,32,7.8409469207119535,Hawkish
14,6, 신규주/NNG,20,3.3880634842582515,Hawkish
71,36, 택/NNG,107,2.8637203259801893,Hawkish
14,10, 착/MAG,24,2.032838090554951,Hawkish
74,77, 질/VV,151,1.3954547189338253,Hawkish
15,8, 려/NNG,23,2.722551014136095,Hawkish
248,58, 지로/NNG,306,6.208668059823004,Hawkish
657,603, 드/VV,1260,1.5820594947815718,Hawkish
42,41, 마/VV,83,1.4874425052841107,Hawkish
221,237, 매/NNG,458,1.3540000542876558,Hawkish
1655,1119, 국/NNG,2774,2.1475469423391065,Hawkish
12,13, 흘/NNG,25,1.3403328069593086,Hawkish
137,60, 결/NNG,197,3.3154621238812894,Hawkish
15,11, 랍/NNG,26,1.9800371011898874,Hawkish
119,66, 용/NNG,185,2.61804905601774,Hawkish
67,61, 락/NNG,128,1.5948495558217999,Hawkish
47,40, 물가/NNG;둔화/NNG,87,1.7061319688586194,Hawkish
116,127, 재고/NNG;감소/NNG,243,1.326261071453174,Hawkish
25,27, 국고채/NNG;발행/NNG;축소/NNG,52,1.3444696366104174,Hawkish
37,37, 무리없이/MAG,74,1.4520272075392509,Hawkish
248,249, 채권시장/NNG;우호적/VAX,497,1.4461957729708201,Hawkish
456,461, 채권자금/NNG,917,1.436278539344682,Hawkish
49,54, 장보/NNG,103,1.3175802438782092,Hawkish
1064,745, 자금흐름/NNG,1809,2.073767716539279,Hawkish
49,17, 선발행/NNG,66,4.1852548923190165,Hawkish
501,452, 수탁고/NNG,953,1.609437236675143,Hawkish
29,30, 자기실현/NNG,59,1.4036263006212757,Hawkish
2322,2427, 공시/NNG,4749,1.3892077362612856,Hawkish
148,133, 중장기영역/NNG,281,1.6157896745549558,Hawkish
16,12, 평행/NNG,28,1.9360362767190007,Hawkish
30,31, 시켰으나/XSV,61,1.405187620199275,Hawkish
123,119, 기울기/NNG,242,1.500834844767461,Hawkish
80,32, 축/MAG,112,3.630068018848127,Hawkish
21,19, 행이/NNG,40,1.604872176753909,Hawkish
167,170, 리/NNG,337,1.4264031979944407,Hawkish
36,25, 회전식/NNG,61,2.0909191788565216,Hawkish
2620,2717, 대내외/NNG,5337,1.4001881795188948,Hawkish
347,359, 여전사/NNG,706,1.4034914791535376,Hawkish
94,70, 적/NNG,164,1.949865107266994,Hawkish
149,157, 채권은행/NNG,306,1.378038560021327,Hawkish
376,107, 월중/NNG,483,5.102450747988395,Hawkish
119,105, 신고서/NNG,224,1.6456308352111506,Hawkish
521,231, 순상환/NNG,752,3.2749185070474014,Hawkish
929,965, 순유출/NNG,1894,1.3978583168952994,Hawkish
61,31, 요구불/NNG,92,2.857214827738526,Hawkish
116,62, 금전신탁/NNG,178,2.7166960657185983,Hawkish
950,879, 혼합/NNG,1829,1.5693126816408285,Hawkish
60,0, 소계/NNG,60,inf,Hawkish
238,72, 발행어음/NNG,310,4.79975660269919,Hawkish
61,0, 행투/NNG,61,inf,Hawkish
98,78, 나타났으나/VV,176,1.8243418761390588,Hawkish
827,874, 재투자/NNG,1701,1.373943364570893,Hawkish
32,11, 원원/NNG,43,4.224079149205093,Hawkish
17,12, 시지/NNG,29,2.0570385440139387,Hawkish
719,629, 잠정치/NNG,1348,1.659789447091767,Hawkish
617,492, 루피아/NNG,1109,1.8209365590482067,Hawkish
795,648, 페소/NNG,1443,1.781422268508803,Hawkish
21,15, 링기트/NNG,36,2.032838090554951,Hawkish
29,25, 지에/NNG,54,1.684351560745531,Hawkish
161,175, 이면/NNG,336,1.3358650309361106,Hawkish
35,29, 간간히/MAG,64,1.752446629788751,Hawkish
162,178, 유념/NNG,340,1.3215079079851608,Hawkish
27,11, 순채무국/NNG,38,3.5640667821417975,Hawkish
363,303, 비록/MAG,666,1.739557347646033,Hawkish
428,461, 발동/NNG,889,1.3480859974550963,Hawkish
66,8, 총계/NNG,74,11.979224462198818,Hawkish
65,35, 말잔/NNG,100,2.6966219568586083,Hawkish
123,110, 토/NNG,233,1.6236304229757077,Hawkish
51,52, 유가/NNG;원자재/NNG;가격/NNG;하락/NNG,103,1.4241036073942652,Hawkish
18,20, 자금/NNG;조달/NNG;여건/NNG;개선/NNG,38,1.3068244867853258,Hawkish
18,6, 기대/NNG;인플레이션/NNG;확산/NNG,24,4.356081622617753,Hawkish
20,13, 외국인/NNG;채권시장/NNG;이탈/NNG,33,2.2338880115988475,Hawkish
13,9, 유로존/NNG;경제/NNG;둔화/NNG,22,2.097372633112251,Hawkish
30,13, 자본/NNG;수지/NNG;적자/NNG,43,3.350832017398271,Hawkish
40,21, 금리/NNG;상승/NNG;견인/NNG,61,2.765766109598573,Hawkish
116,122, 금리/NNG;하락/NNG;압력/NNG,238,1.3806160333979762,Hawkish
32,13, 금리/NNG;상승/NNG;축소/NNG,45,3.5742208185581554,Hawkish
15,6, 개선/NNG;금리/NNG;상승/NNG,21,3.6300680188481267,Hawkish
344,369, 대출/NNG;금리/NNG;인상/NNG,713,1.3536513804701957,Hawkish
45,36, 주택/NNG;경기/NNG;하락/NNG,81,1.8150340094240633,Hawkish
9,7, 경기/NNG;하락/NNG;둔화/NNG,16,1.866892123979037,Hawkish
105,103, 전망/NNG;금리/NNG;인상/NNG,208,1.4802219105982655,Hawkish
42,45, 투자자금/NNG;이탈/NNG,87,1.3552253937033008,Hawkish
10,7, 신용위험/NNG;증대/NNG,17,2.07432458219893,Hawkish
12,13, 펀더멘털/NNG;불안/NNG,25,1.3403328069593086,Hawkish
309,306, 주택시장/NNG;침체/NNG,615,1.4662627683974787,Hawkish
11,10, 부동산/NNG;부실/NNG,21,1.5972299282931757,Hawkish
14,11, 원자재/NNG;급락/NNG,25,1.8480346277772284,Hawkish
71,72, 은행/NNG;고금리/NNG,143,1.4318601629900947,Hawkish
39,40, 순자산/NNG;감소/NNG,79,1.4157265273507695,Hawkish
52,29, 물가/NNG;위험/NNG,81,2.6036349928290017,Hawkish
168,187, 위험/NNG;완화/NNG,355,1.304495031372161,Hawkish
71,24, 신용/NNG;축소/NNG,95,4.295580488970284,Hawkish
15,11, 주택/NNG;부진/NNG,26,1.9800371011898874,Hawkish
13,8, 하락/NNG;취약/NNG,21,2.359544212251283,Hawkish
54,51, 무역/NNG;개선/NNG,105,1.5374405726886184,Hawkish
215,192, 트리거/NNG,407,1.6259679667757234,Hawkish
202,127, 수요우위/NNG,329,2.3095235899443205,Hawkish
11,9, 벗어남/VV,20,1.774699920325751,Hawkish
318,329, 분할매수/NNG,647,1.40347918540268,Hawkish
12,11, 진부/NNG,23,1.58402968095191,Hawkish
13,5, 계량기/NNG,18,3.775270739602052,Hawkish
22,24, 단임/NNG,46,1.331024940244313,Hawkish
28,18, 화시/NNG,46,2.258708989505501,Hawkish
166,166, 마다/NNG,332,1.4520272075392506,Hawkish
1026,985, 금고/NNG,2011,1.5124669187160116,Hawkish
41,40, 역관/NNG,81,1.488327887727732,Hawkish
71,2, 주요지/NNG,73,51.54696586764341,Hawkish
574,637, 속보치/NNG,1211,1.3084201210793247,Hawkish
43,48, 고점/NNG;넘/VV,91,1.3007743734205788,Hawkish
9,10, 전망/NNG;꺾/VV,19,1.3068244867853258,Hawkish
13,3, 직매/NNG,16,6.292117899336753,Hawkish
84,91, 기설/NNG,175,1.3403328069593086,Hawkish
58,57, 휩싸여/VV,115,1.477501369075027,Hawkish
45,40, 경기/NNG;둔화/NNG;우려/NNG;금리/NNG;인상/NNG,85,1.633530608481657,Hawkish
85,51, 유가/NNG;불안/NNG,136,2.420045345898751,Hawkish
14,5, 미/NNG;경기/NNG;둔화/NNG;우려/NNG,19,4.065676181109902,Hawkish
13,9, 인플레이션/NNG;부담/NNG;덜/VV,22,2.097372633112251,Hawkish
8,8, 낮/VA;유가/NNG;하락/NNG,16,1.4520272075392506,Hawkish
156,142, 조업일수/NNG,298,1.5951848195501628,Hawkish
1817,1854, 저하/NNG,3671,1.4230493182841526,Hawkish
76,45, 도급/NNG,121,2.4523126171774017,Hawkish
15,2, 엿보인/VV,17,10.89020405654438,Hawkish
85,46, 금리재정거래/NNG,131,2.6830937530616588,Hawkish
12,9, 자산/NNG;건전성/NNG;우려/NNG,21,1.9360362767190011,Hawkish
57,42, 단기/NNG;외채/NNG;증가/NNG,99,1.970608353088983,Hawkish
13,9, 국채선물/NNG;가격/NNG;급락/NNG,22,2.097372633112251,Hawkish
14,13, 채권시장/NNG;압박/NNG,27,1.5637216081191931,Hawkish
19,17, 구제금융설/NNG,36,1.622853937837986,Hawkish
10,11, 수요/NNG;금리/NNG;상승/NNG,21,1.3200247341265916,Hawkish
431,417, 청/NNG,848,1.5007763224206645,Hawkish
28,28, 나타났었/VV,56,1.4520272075392509,Hawkish
42,43, 새로이/MAG,85,1.4182591329453147,Hawkish
42,35, 장기전/NNG,77,1.742432649047101,Hawkish
19,11, 국제/NNG;수지/NNG;적자/NNG,30,2.5080469948405244,Hawkish
10,7, 기대/NNG;유가/NNG;하락/NNG,17,2.07432458219893,Hawkish
16,17, 금리/NNG;환율/NNG;하락/NNG,33,1.3666138423898828,Hawkish
163,165, 금리/NNG;소폭/MAG;상승/NNG,328,1.4344268777508964,Hawkish
10,10, 은행/NNG;대출/NNG;감소/NNG,20,1.4520272075392509,Hawkish
41,41, 하단부/NNG,82,1.4520272075392509,Hawkish
12,11, 캐치/NNG,23,1.58402968095191,Hawkish
33,0, 명하/VV,33,inf,Hawkish
78,72, 경기/NNG;둔화/NNG;위험/NNG,150,1.5730294748341884,Hawkish
17,18, 낮/VA;가능성/NNG;높/VA,35,1.3713590293426259,Hawkish
13,4, 인하/NNG;전환/NNG,17,4.719088424502566,Hawkish
57,58, 인상/NNG;없/VA,115,1.4269922556851258,Hawkish
94,97, 높/VA;위험/NNG,191,1.4071191495741193,Hawkish
1532,1662, 우량/NNG,3194,1.3384510721721614,Hawkish
25,14, 유로금리/NNG,39,2.5929057277486622,Hawkish
38,39, 상당량/NNG,77,1.41479574067927,Hawkish
25,17, 했었으나/XSV,42,2.1353341287341925,Hawkish
116,122, 과언/NNG,238,1.3806160333979762,Hawkish
19,9, 무자비/NNG,28,3.0653907714717517,Hawkish
11,10, 효익/NNG,21,1.5972299282931757,Hawkish
72,49, 까지/VV,121,2.133590998833185,Hawkish
13,7, 인다면/VV,20,2.6966219568586087,Hawkish
367,318, 기간조정/NNG,685,1.6757672489525315,Hawkish
83,82, 둔다/VV,165,1.4697348564116808,Hawkish
54,36, 보채/NNG,90,2.1780408113088763,Hawkish
24,9, 외인/NNG;자금/NNG;이탈/NNG,33,3.8720725534380023,Hawkish
40,33, 자금/NNG;이탈/NNG;가속/NNG,73,1.7600329788354554,Hawkish
20,18, 이토록/MAG,38,1.6133635639325008,Hawkish
456,231, 망/NNG,687,2.8663394226748844,Hawkish
183,203, 약진/NNG,386,1.3089703398013937,Hawkish
49,22, 용채/NNG,71,3.23406059861015,Hawkish
17,17, 우려/NNG;유가/NNG;급락/NNG,34,1.4520272075392509,Hawkish
115,85, 주택가격/NNG;안정/NNG,200,1.964507398435457,Hawkish
12,7, 최악/NNG;끝/NNG,19,2.489189498638716,Hawkish
11,7, 하락/NNG;인플레이션/NNG;우려/NNG,18,2.2817570404188228,Hawkish
33,30, 경제/NNG;부담/NNG;줄/VV,63,1.5972299282931757,Hawkish
31,31, 리보금리/NNG;상승/NNG,62,1.452027207539251,Hawkish
301,307, 매수주체/NNG,608,1.4236488256329463,Hawkish
128,118, 만기도래액/NNG,246,1.5750803607205432,Hawkish
218,198, 콜시장/NNG,416,1.5986966224422052,Hawkish
39,37, 무마/NNG,76,1.5305151647035347,Hawkish
991,1045, 부실채권/NNG,2036,1.3769942226520548,Hawkish
39,42, 하락/NNG;금리/NNG;상승/NNG,81,1.3483109784293044,Hawkish
963,1030, 양극화/NNG,1993,1.3575749522915521,Hawkish
39,35, 침착/NNG,74,1.6179731741151653,Hawkish
29,27, 만능/NNG,56,1.559584778468084,Hawkish
38,37, 대도/NNG,75,1.4912711861213928,Hawkish
28,8, 단/VA,36,5.082095226387378,Hawkish
91,2, 음영/NNG,93,66.0672379430359,Hawkish
22,21, 부도나/VV,43,1.5211713602792152,Hawkish
100,103, 진로/NNG,203,1.4097351529507292,Hawkish
58,46, 빅딜/NNG,104,1.830816913853838,Hawkish
57,34, 종금사/NNG,91,2.434280906756979,Hawkish
63,69, 모라토리엄/NNG,132,1.325763972101055,Hawkish
241,37, 아시/NNG,278,9.4577988382962,Hawkish
18,18, 경기/NNG;침체/NNG;완화/NNG,36,1.4520272075392509,Hawkish
50,42, 인플레이션/NNG;공포/NNG,92,1.7286038184991082,Hawkish
35,8, 평사/NNG,43,6.352619032984223,Hawkish
18,19, 매각액/NNG,37,1.375604722931922,Hawkish
54,2, 발/VA,56,39.20473460355977,Hawkish
14,13, 기대/NNG;안전자산/NNG;선호/NNG,27,1.5637216081191931,Hawkish
14,6, 크레딧/NNG;시장/NNG;불안/NNG,20,3.3880634842582515,Hawkish
14,9, 이전비/NNG,23,2.258708989505501,Hawkish
10,7, 연방/NNG;금리/NNG;인하/NNG,17,2.07432458219893,Hawkish
19,10, 유동성/NNG;선호/NNG,29,2.7588516943245764,Hawkish
28,24, 실물/NNG;경제/NNG;개선/NNG,52,1.6940317421291258,Hawkish
101,83, 민평/NNG;높/VA,184,1.76692467423451,Hawkish
13,6, 금리/NNG;환율/NNG;급등/NNG,19,3.1460589496683764,Hawkish
817,709, 비우량/NNG,1526,1.673210477517021,Hawkish
49,51, 주입/NNG,100,1.395084964106339,Hawkish
396,386, 기조적/VAX,782,1.4896444927086614,Hawkish
20,19, 겹쳐서/VV,39,1.5284496921465798,Hawkish
15,12, 자금/NNG;수요/NNG;확대/NNG,27,1.8150340094240633,Hawkish
9,7, 악화/NNG;완화/NNG,16,1.866892123979037,Hawkish
50,48, 들려오/VV,98,1.5125283411867194,Hawkish
40,38, 국고채/NNG;금리/NNG;급락/NNG,78,1.5284496921465798,Hawkish
23,8, 크레딧/NNG;금리/NNG;상승/NNG,31,4.174578221675346,Hawkish
146,77, 의의/NNG,223,2.753194445464034,Hawkish
499,51, 변형/NNG,550,14.207089736511492,Hawkish
121,127, 흘러나오/VV,248,1.3834274969468452,Hawkish
19,15, 장대음봉/NNG,34,1.839234462883051,Hawkish
286,247, 날짜/NNG,533,1.6812946613612378,Hawkish
6332,5983, 절하/NNG,12315,1.5367267722110205,Hawkish
10,8, 달러환/NNG,18,1.8150340094240636,Hawkish
13,9, 상환/NNG;부담/NNG;없/VA,22,2.097372633112251,Hawkish
75,7, 국고채/NNG;축소/NNG,82,15.557434366491975,Hawkish
16,4, 절하/NNG;절상/NNG,20,5.8081088301570025,Hawkish
803,589, 내역/NNG,1392,1.9795888754737152,Hawkish
25,18, 한달/XSV,43,2.0167044549156263,Hawkish
13,10, 경기/NNG;회복/NNG;쉽/VA;않/VX,23,1.887635369801026,Hawkish
13,14, 하락/NNG;경기/NNG;회복/NNG,27,1.3483109784293044,Hawkish
11,6, 채권시장/NNG;환율/NNG;상승/NNG,17,2.662049880488626,Hawkish
75,59, 신용등급/NNG;전망/NNG;하향/NNG,134,1.8457972977193868,Hawkish
10,8, 인하/NNG;가능성/NNG;높/VV,18,1.8150340094240636,Hawkish
239,232, 대출자산/NNG,471,1.4958383732839695,Hawkish
79,26, 크레딧/NNG;강세/NNG,105,4.411928822907724,Hawkish
11,11, 설움/NNG,22,1.4520272075392509,Hawkish
39,22, 팩/MAG,61,2.574048231546854,Hawkish
87,90, 배당소득/NNG,177,1.4036263006212757,Hawkish
9,9, 된다거나/XSV,18,1.4520272075392509,Hawkish
29,26, 지라/NNG,55,1.6195688084091644,Hawkish
22,23, 수자원/NNG,45,1.388895589820153,Hawkish
19,8, 보채/VV,27,3.448564617905721,Hawkish
96,101, 초단/NNG,197,1.3801446725125552,Hawkish
138,135, 기물/NNG,273,1.4842944788179009,Hawkish
227,149, 융/NNG,376,2.212148832962483,Hawkish
9,8, 금리/NNG;상승/NNG;금리/NNG;인하/NNG,17,1.6335306084816572,Hawkish
13,14, 외화/NNG;유동성/NNG;위험/NNG,27,1.3483109784293044,Hawkish
20,13, 기대/NNG;금리/NNG;상승/NNG,33,2.2338880115988475,Hawkish
29,20, 신용위험/NNG;완화/NNG,49,2.1054394509319136,Hawkish
11,9, 최악/NNG;넘/VV,20,1.774699920325751,Hawkish
75,9, 높임/NNG,84,12.100226729493757,Hawkish
30,5, 비지/NNG,35,8.712163245235503,Hawkish
21,11, 통안채/NNG;강세/NNG,32,2.7720519416658425,Hawkish
58,59, 금리/NNG;하회/NNG,117,1.4274165769029923,Hawkish
83,15, 이나/NNG,98,8.034550548383853,Hawkish
203,154, 증권금융/NNG,357,1.9140358644835578,Hawkish
22,17, 채권/NNG;매수/NNG;심리/NNG;위축/NNG,39,1.879094033286089,Hawkish
82,90, 다원화/NNG,172,1.3229581224246507,Hawkish
666,699, 자부담/NNG,1365,1.3834765668399729,Hawkish
18,17, 너머/NNG,35,1.5374405726886184,Hawkish
38,42, 꼬여/VV,80,1.3137389020593222,Hawkish
22,9, 용서/NNG,31,3.549399840651502,Hawkish
51,37, 다분/NNG,88,2.0014429076892375,Hawkish
17,3, 버스트/NNG,20,8.228154176055755,Hawkish
19,19, 심대/NNG,38,1.4520272075392509,Hawkish
29,32, 삼중고/NNG,61,1.315899656832446,Hawkish
12,12, 변방/NNG,24,1.4520272075392509,Hawkish
85,82, 축소도/NNG,167,1.5051501541565404,Hawkish
12,10, 경제/NNG;금융/NNG;불안/NNG,22,1.742432649047101,Hawkish
9,10, 우호적/VAX;영향/NNG;줄/VV,19,1.3068244867853258,Hawkish
81,86, 불안/NNG;조짐/NNG,167,1.3676070210544107,Hawkish
70,77, 금리갭/NNG;줄/VV,147,1.3200247341265916,Hawkish
41,44, 예상/NNG;소폭/MAG;상회/NNG,85,1.3530253524797564,Hawkish
334,336, 투신사/NNG,670,1.4433841884467553,Hawkish
113,123, 징/NNG,236,1.3339762150563848,Hawkish
464,321, 바젤/NNG,785,2.098880449527141,Hawkish
14,13, 금리/NNG;결정/NNG;인하/NNG,27,1.5637216081191931,Hawkish
144,145, 위험/NNG;확대/NNG,289,1.442013226797601,Hawkish
37,40, 묘수/NNG,77,1.343125166973807,Hawkish
32,33, 급매/NNG,65,1.4080263830683644,Hawkish
370,306, 대차/NNG,676,1.7557191725147805,Hawkish
691,715, 대조/NNG,1406,1.4032878327407305,Hawkish
139,143, 가용/NNG,282,1.4114110618738172,Hawkish
23,14, 경제/NNG;펀더멘털/NNG;양호/NNG,37,2.3854732695287693,Hawkish
684,448, 국한/NNG,1132,2.2169343972251063,Hawkish
15,10, 멈춰서/VV,25,2.178040811308876,Hawkish
12,11, 낙폭/NNG;크/VV;하락/NNG,23,1.58402968095191,Hawkish
17,13, 새끼/NNG,30,1.8988048098590204,Hawkish
25,23, 미운/VA,48,1.5782904429774465,Hawkish
18,20, 백조/NNG,38,1.3068244867853258,Hawkish
1072,1173, 패턴/NNG,2245,1.3270018469582923,Hawkish
15,16, 이리/MAG,31,1.3612755070680476,Hawkish
72,6, 월로/NNG,78,17.42432649047101,Hawkish
146,112, 이연/NNG,258,1.8928211812565237,Hawkish
510,551, 국공채/NNG,1061,1.343981625853027,Hawkish
70,62, 유동자산/NNG,132,1.6393855568991544,Hawkish
324,345, 보유비중/NNG,669,1.3636429427325139,Hawkish
243,267, 채권비중/NNG,510,1.3215079079851608,Hawkish
32,23, 강제성/NNG,55,2.0202117670111313,Hawkish
41,11, 유동부채/NNG,52,5.412101409919026,Hawkish
24,24, 바뀜/VV,48,1.4520272075392509,Hawkish
18,14, 실물거래/NNG,32,1.866892123979037,Hawkish
100,97, 미스매치/NNG,197,1.4969352655043824,Hawkish
18,18, 인수수수료/NNG,36,1.4520272075392509,Hawkish
44,48, 기차/NNG,92,1.331024940244313,Hawkish
65,63, 자본거래/NNG,128,1.4981233093658934,Hawkish
108,110, 환류/NNG,218,1.425626712856719,Hawkish
11,11, 청산과정/NNG,22,1.4520272075392509,Hawkish
23,2, 국민은행채/NNG,25,16.698312886701384,Hawkish
16,11, 원임/NNG,27,2.1120395746025467,Hawkish
104,95, 실제/MAG,199,1.589587679832443,Hawkish
37,34, 여하/NNG,71,1.5801472552633022,Hawkish
116,122, 순탄/NNG,238,1.3806160333979762,Hawkish
18,9, 난해/NNG,27,2.9040544150785017,Hawkish
15,8, 행여나/MAG,23,2.722551014136095,Hawkish
321,331, 럼/NNG,652,1.408159316072808,Hawkish
15,16, 추정손실/NNG,31,1.3612755070680476,Hawkish
16,17, 회수의문/NNG,33,1.3666138423898828,Hawkish
23,20, 목도/NNG,43,1.6698312886701383,Hawkish
141,118, 살펴본/VV,259,1.7350494598562234,Hawkish
382,23, 보험기금/NNG,405,24.116277968695382,Hawkish
123,45, 종류별/NNG,168,3.9688743672739526,Hawkish
101,4, 채국/NNG,105,36.66368699036609,Hawkish
1215,1143, 헤알/NNG,2358,1.543493488329125,Hawkish
361,168, 포린트/NNG,529,3.1201298923908904,Hawkish
777,520, 루피/NNG,1297,2.1696637312653806,Hawkish
33,33, 관보/NNG,66,1.4520272075392506,Hawkish
15,1, 보광/NNG,16,21.78040811308876,Hawkish
16,15, 금리/NNG;인하/NNG;모멘텀/NNG,31,1.5488290213752007,Hawkish
45,43, 자산/NNG;건전성/NNG;악화/NNG,88,1.5195633567271227,Hawkish
60,56, 어렵/VA;금리/NNG;인하/NNG,116,1.5557434366491973,Hawkish
52,24, 신용위험/NNG;확대/NNG,76,3.1460589496683764,Hawkish
13,13, 채권투자/NNG;위험/NNG,26,1.4520272075392509,Hawkish
11,12, 대출비중/NNG;증가/NNG,23,1.331024940244313,Hawkish
19,13, 완화/NNG;긍정적/VAX,32,2.122193611018905,Hawkish
36,33, 외채/NNG;증가/NNG,69,1.58402968095191,Hawkish
45,27, 여력/NNG;약화/NNG,72,2.420045345898751,Hawkish
91,94, 안정/NNG;효과/NNG,185,1.405685913681615,Hawkish
22,17, 신용/NNG;개선/NNG,39,1.879094033286089,Hawkish
9,7, 위험/NNG;급증/NNG,16,1.866892123979037,Hawkish
14,14, 차환/NNG;부담/NNG,28,1.4520272075392509,Hawkish
15,11, 산액/NNG,26,1.9800371011898874,Hawkish
13,12, 작/VA;감소/NNG,25,1.5730294748341882,Hawkish
13,11, 백도/NNG,24,1.7160321543645694,Hawkish
65,62, 국채/NNG;발행/NNG;증가/NNG,127,1.5222865885492145,Hawkish
26,27, 낮춤/NNG,53,1.3982484220748341,Hawkish
839,895, 질/NNG,1734,1.361174108520035,Hawkish
31,21, 유동비율/NNG,52,2.143468734938894,Hawkish
49,37, 상단부/NNG,86,1.9229549505249537,Hawkish
19,11, 국채/NNG;확대/NNG,30,2.5080469948405244,Hawkish
29,22, 전영역/NNG,51,1.914035864483558,Hawkish
65,72, 도대체/MAG,137,1.3108578956951569,Hawkish
869,269, 만기별/NNG,1138,4.690749603537579,Hawkish
14,15, 계량모형/NNG,29,1.3552253937033008,Hawkish
20,15, 선형/NNG,35,1.936036276719001,Hawkish
33,16, 매수비중/NNG,49,2.9948061155497046,Hawkish
140,1, 고용증감/NNG,141,203.28380905549514,Hawkish
25,24, 자산/NNG;부실/NNG,49,1.5125283411867194,Hawkish
31,8, 보임/NNG,39,5.626605429214597,Hawkish
375,46, 기평/NNG,421,11.837178322330848,Hawkish
17,15, 높/VA;경기/NNG;침체/NNG,32,1.645630835211151,Hawkish
9,10, 우려/NNG;심하/VA,19,1.3068244867853258,Hawkish
13,8, 크레딧/NNG;시장/NNG;안정/NNG,21,2.359544212251283,Hawkish
204,85, 순발행금액/NNG,289,3.4848652980942023,Hawkish
10,11, 아쉬웠/VV,21,1.3200247341265916,Hawkish
12,12, 서두른/VV,24,1.4520272075392509,Hawkish
122,133, 외곽/NNG,255,1.3319347317277337,Hawkish
46,45, 관대/NNG,91,1.4842944788179007,Hawkish
995,700, 유가증권/NNG,1695,2.063952959287935,Hawkish
164,171, 주인공/NNG,335,1.3925874972891061,Hawkish
23,2, 스크리닝/NNG,25,16.698312886701384,Hawkish
131,120, 스왑레이트/NNG,251,1.585129701563682,Hawkish
10,7, 중소기업/NNG;위험/NNG,17,2.07432458219893,Hawkish
42,32, 신용/NNG;하락/NNG,74,1.9057857098952666,Hawkish
37,35, 자본/NNG;감소/NNG,72,1.5350001908272082,Hawkish
43,33, 단기/NNG;부담/NNG,76,1.8920354522481146,Hawkish
11,11, 악화/NNG;조짐/NNG,22,1.4520272075392509,Hawkish
36,39, 불안/NNG;상승/NNG,75,1.3403328069593086,Hawkish
32,23, 위험/NNG;배제/NNG,55,2.0202117670111313,Hawkish
426,388, 밝힘/VV,814,1.594236057762167,Hawkish
14,14, 기대/NNG;채권시장/NNG;강세/NNG,28,1.4520272075392509,Hawkish
250,167, 북클로징/NNG,417,2.1736934244599566,Hawkish
40,11, 앞서간/VV,51,5.280098936506366,Hawkish
26,9, 재차/NNG,35,4.194745266224502,Hawkish
12,13, 계량분석/NNG,25,1.3403328069593086,Hawkish
26,23, 여겨질/VV,49,1.6414220606965444,Hawkish
16,14, 조삼모사/NNG,30,1.6594596657591438,Hawkish
66,71, 증권선물거래소/NNG,137,1.3497717703885992,Hawkish
12,6, 동/VV,18,2.9040544150785017,Hawkish
14,11, 하락/NNG;소폭/MAG;상승/NNG,25,1.8480346277772284,Hawkish
25,24, 채권시장/NNG;활성화/NNG,49,1.5125283411867194,Hawkish
76,49, 펀더멘털/NNG;우려/NNG,125,2.252123832101695,Hawkish
22,17, 기대/NNG;금리/NNG;하락/NNG,39,1.879094033286089,Hawkish
68,72, 기대/NNG;하락/NNG,140,1.3713590293426259,Hawkish
28,28, 제약조건/NNG,56,1.4520272075392509,Hawkish
43,19, 평가단/NNG,62,3.2861668381151468,Hawkish
255,270, 디레버리징/NNG,525,1.3713590293426257,Hawkish
16,7, 국고채/NNG;금리/NNG;하향/NNG,23,3.3189193315182877,Hawkish
98,58, 재부/NNG,156,2.4534252817042517,Hawkish
48,37, 라/NNG,85,1.8837109719428118,Hawkish
18,15, 환부/NNG,33,1.742432649047101,Hawkish
604,524, 피/NNG,1128,1.6737107506750142,Hawkish
59,64, 취해왔/VV,123,1.3385875819502469,Hawkish
46,32, 임/NNG,78,2.087289110837673,Hawkish
108,107, 편/NNG,215,1.4655975552732625,Hawkish
9,10, 모기지/NNG;시장/NNG;안정/NNG,19,1.3068244867853258,Hawkish
11,7, 건전성/NNG;부담/NNG,18,2.2817570404188228,Hawkish
12,13, 대출/NNG;안정/NNG,25,1.3403328069593086,Hawkish
25,15, 침체/NNG;완화/NNG,40,2.4200453458987514,Hawkish
635,658, 현대/NNG,1293,1.401272457123745,Hawkish
63,70, 균형점/NNG,133,1.3068244867853258,Hawkish
34,17, 편드/VV,51,2.9040544150785017,Hawkish
186,21, 자기자본/NNG,207,12.860812409633363,Hawkish
423,282, 인상기/NNG,705,2.1780408113088763,Hawkish
225,227, 수익증권/NNG,452,1.4392340162833985,Hawkish
1630,422, 합계/NNG,2052,5.608541109689524,Hawkish
22,11, 국고채/NNG;금리/NNG;저점/NNG,33,2.9040544150785017,Hawkish
10,9, 국고채/NNG;수급/NNG;부담/NNG,19,1.6133635639325008,Hawkish
19,18, 전망/NNG;부정적/VAX;하향/NNG,37,1.5326953857358758,Hawkish
14,13, 국채/NNG;금리/NNG;저점/NNG,27,1.5637216081191931,Hawkish
16,3, 채권/NNG;공급/NNG;증가/NNG,19,7.744145106876003,Hawkish
40,40, 높/VA;금리/NNG;상승/NNG,80,1.4520272075392509,Hawkish
52,48, 자금/NNG;수요/NNG;많/VA,100,1.5730294748341882,Hawkish
22,21, 금리/NNG;덜/MAG;오르/VV,43,1.5211713602792152,Hawkish
16,15, 어렵/VA;양적완화/NNG,31,1.5488290213752007,Hawkish
14,9, 신용/NNG;상승/NNG,23,2.258708989505501,Hawkish
9,9, 소득/NNG;둔화/NNG,18,1.4520272075392509,Hawkish
15,13, 공급/NNG;둔화/NNG,28,1.6754160086991354,Hawkish
14,13, 금리/NNG;하락/NNG;우호적/VAX,27,1.5637216081191931,Hawkish
25,10, 금리/NNG;하락/NNG;견인/NNG,35,3.630068018848127,Hawkish
172,172, 상응/NNG,344,1.4520272075392506,Hawkish
40,42, 신자유주의/NNG,82,1.3828830547992865,Hawkish
87,80, 상륙/NNG,167,1.579079588198935,Hawkish
72,71, 솔직/NNG,143,1.472478294969381,Hawkish
9,10, 가래/NNG,19,1.3068244867853258,Hawkish
212,128, 일반은행/NNG,340,2.4049200624868843,Hawkish
46,23, 않/NNG,69,2.9040544150785013,Hawkish
9,8, 경기/NNG;우려/NNG;확대/NNG,17,1.6335306084816572,Hawkish
88,96, 세액/NNG,184,1.331024940244313,Hawkish
222,41, 신정/NNG,263,7.86219609935887,Hawkish
389,323, 평/NNG,712,1.748726265426528,Hawkish
10,6, 금리/NNG;결정/NNG;부담/NNG,16,2.420045345898751,Hawkish
133,143, 행시/NNG,276,1.350486843375667,Hawkish
181,130, 민/NNG,311,2.021668650496957,Hawkish
1000,928, 재무구조/NNG,1928,1.5646844908828135,Hawkish
87,79, 전망/NNG;강세/NNG,166,1.5990679374166432,Hawkish
27,15, 비상조치/NNG,42,2.613648973570651,Hawkish
153,142, 풋옵션/NNG,295,1.5645081884049672,Hawkish
20,14, 채권/NNG;확대/NNG,34,2.07432458219893,Hawkish
20,22, 칼자루/NNG,42,1.3200247341265916,Hawkish
92,89, 실상/NNG,181,1.5009719448720344,Hawkish
22,17, 원위치/NNG,39,1.879094033286089,Hawkish
681,630, 회복국면/NNG,1311,1.5695722671971901,Hawkish
14,7, 그럴듯한/VA,21,2.9040544150785017,Hawkish
347,330, 정성/NNG,677,1.5268286091397576,Hawkish
117,116, 기준일/NNG,233,1.4645446834663132,Hawkish
951,39, 도인/NNG,990,35.40712498384173,Hawkish
19,16, 국채/NNG;발행/NNG;부담/NNG,35,1.7242823089528605,Hawkish
8,8, 정책/NNG;최대/NNG,16,1.4520272075392506,Hawkish
9,8, 성정/NNG,17,1.6335306084816572,Hawkish
13,8, 금리/NNG;하락/NNG;축소/NNG,21,2.359544212251283,Hawkish
4312,308, 여전채/NNG,4620,20.328380905549512,Hawkish
69,68, 전망/NNG;금리/NNG;인하/NNG,137,1.4733805488265928,Hawkish
118,131, 리플레이션/NNG,249,1.3079329045010044,Hawkish
16,17, 양적완화/NNG;정책/NNG;확대/NNG,33,1.3666138423898828,Hawkish
26,17, 잠재/NNG;부담/NNG,43,2.22074749388356,Hawkish
13,10, 내비침/VV,23,1.887635369801026,Hawkish
74,81, 여의/NNG,155,1.3265433747889452,Hawkish
231,212, 내재/NNG,443,1.5821617214224857,Hawkish
40,4, 미워도/VA,44,14.520272075392509,Hawkish
56,52, 기/VA,108,1.5637216081191931,Hawkish
415,394, 신보/NNG,809,1.5294195206314445,Hawkish
181,200, 기보/NNG,381,1.314084622823022,Hawkish
157,113, 디플레이터/NNG,270,2.017418332598782,Hawkish
13,9, 모기지/NNG;변동/NNG;금리/NNG;하락/NNG,22,2.097372633112251,Hawkish
87,97, 안전자산/NNG;선호/NNG;약화/NNG,184,1.3023336809888126,Hawkish
250,262, 펀더멘털/NNG;개선/NNG,512,1.3855221445985217,Hawkish
89,56, 채권/NNG;우호적/VAX,145,2.307686097696309,Hawkish
19,21, 대강/MAG,40,1.3137389020593222,Hawkish
10,11, 악화/NNG;부담/NNG,21,1.3200247341265916,Hawkish
25,5, 소폭/MAG;금리/NNG;상승/NNG,30,7.260136037696254,Hawkish
29,28,의/NNG,57,1.503885322094224,Hawkish
21,9, 피상/NNG,30,3.3880634842582515,Hawkish
1197,1096, 새해/NNG,2293,1.5858362841464264,Hawkish
86,85, 벽두/NNG,171,1.4691098805691243,Hawkish
207,175, 개별기업/NNG,382,1.7175407540607137,Hawkish
190,202, 사업구조/NNG,392,1.3657681655072162,Hawkish
98,108, 자원배분/NNG,206,1.3175802438782092,Hawkish
18,18, 순리/NNG,36,1.4520272075392509,Hawkish
24,6, 여개/NNG,30,5.808108830157003,Hawkish
43,42, 경제재/NNG,85,1.486599283909233,Hawkish
73,68, 금융소외자/NNG,141,1.5587939139759603,Hawkish
36,30, 방향성설정/NNG,66,1.742432649047101,Hawkish
15,15, 생전/NNG,30,1.4520272075392506,Hawkish
192,195, 자구계획/NNG,387,1.4296883274232624,Hawkish
381,308, 독/NNG,689,1.796176513222255,Hawkish
31,30, 내수산업/NNG,61,1.5004281144572258,Hawkish
35,32, 차선/NNG,67,1.5881547582460558,Hawkish
53,36, 산업군/NNG,89,2.1377067222105635,Hawkish
44,44, 흡수합병/NNG,88,1.4520272075392509,Hawkish
24,19, 미착/NNG,43,1.834139630575896,Hawkish
261,275, 획득/NNG,536,1.3781058224281617,Hawkish
2129,2152, 공사/NNG,4281,1.4365083293917587,Hawkish
300,213, 시공사/NNG,513,2.0451087430130293,Hawkish
74,58, 대손/NNG,132,1.8525864372052512,Hawkish
51,55, 적당히/MAG,106,1.3464252288091234,Hawkish
369,408, 아이디어/NNG,777,1.3132304891715283,Hawkish
72,63, 예시/NNG,135,1.6594596657591438,Hawkish
39,35, 이루어져야/VV,74,1.6179731741151653,Hawkish
12,4, 별일/NNG,16,4.356081622617753,Hawkish
51,5, 일국/NNG,56,14.810677516900357,Hawkish
131,13, 고채/NNG,144,14.631966475972451,Hawkish
14,6, 발행월/NNG,20,3.3880634842582515,Hawkish
452,279, 오토/NNG,731,2.3523881641854527,Hawkish
300,328, 홈/NNG,628,1.3280736654322416,Hawkish
902,486, 투자등급/NNG,1388,2.694914693827992,Hawkish
23,21, 경기/NNG;전망/NNG;하향/NNG,44,1.5903155130191793,Hawkish
28,23, 실물/NNG;경기/NNG;개선/NNG,51,1.76768529613474,Hawkish
9,7, 경제/NNG;생산성/NNG;높/VV,16,1.866892123979037,Hawkish
14,3, 크레딧/NNG;우호적/VAX,17,6.776126968516503,Hawkish
25,26, 극심한/VAX;침체/NNG,51,1.3961800072492796,Hawkish
9,8, 완화/NNG;어렵/VA,17,1.6335306084816572,Hawkish
490,494, 외/VA,984,1.4402699022150462,Hawkish
10,10, 급락/NNG;약세/NNG,20,1.4520272075392509,Hawkish
514,77, 섹터별/NNG,591,9.692753047729544,Hawkish
245,250, 든든/NNG,495,1.4229866633884658,Hawkish
24,7, 자산계정/NNG,31,4.978378997277432,Hawkish
351,290, 실험/NNG,641,1.7574536201595758,Hawkish
13,12, 지정학/NNG;위험/NNG;상승/NNG,25,1.5730294748341882,Hawkish
17,14, 해외/NNG;자금/NNG;이탈/NNG,31,1.7631758948690905,Hawkish
15,2, 신용/NNG;감소/NNG,17,10.89020405654438,Hawkish
9,8, 꺼풀/NNG,17,1.6335306084816572,Hawkish
11,12, 채권시장/NNG;급락/NNG,23,1.331024940244313,Hawkish
12,8, 밝혀짐/VV,20,2.1780408113088763,Hawkish
22,9, 시중은행채/NNG,31,3.549399840651502,Hawkish
15,8, 금리/NNG;낙폭/NNG;축소/NNG,23,2.722551014136095,Hawkish
53,54, 비상경제대책회의/NNG,107,1.4251378148070424,Hawkish
75,8, 치인/NNG,83,13.612755070680477,Hawkish
9,7, 치환/NNG,16,1.866892123979037,Hawkish
46,44, 녹이/VV,90,1.5180284442455803,Hawkish
14,14, 궁리/NNG,28,1.4520272075392509,Hawkish
815,371, 카드채/NNG,1186,3.189763272626656,Hawkish
277,11, 주물/NNG,288,36.56468513530659,Hawkish
78,38, 채권평가사/NNG,116,2.9804768996858306,Hawkish
13,8, 평상/NNG,21,2.359544212251283,Hawkish
456,154, 발행물/NNG,610,4.299509134012327,Hawkish
267,178, 발행비중/NNG,445,2.178040811308876,Hawkish
123,135, 거래비중/NNG,258,1.3229581224246507,Hawkish
92,96, 안정국면/NNG,188,1.3915260738917818,Hawkish
40,31, 절대/MAG;금리/NNG;높/VA,71,1.8735834935990334,Hawkish
40,30, 금리/NNG;추세/NNG;상승/NNG,70,1.936036276719001,Hawkish
10,8, 일익/NNG,18,1.8150340094240636,Hawkish
596,537, 단기영역/NNG,1133,1.611560923078945,Hawkish
436,417, 투기등급/NNG,853,1.5181867205925978,Hawkish
10,6, 꺼트리/VV,16,2.420045345898751,Hawkish
38,12, 신용위험/NNG;상승/NNG,50,4.598086157207628,Hawkish
11,5,미묘/NNG,16,3.1944598565863513,Hawkish
2676,2652, 제안/NNG,5328,1.4651677252545383,Hawkish
175,126, 중기물/NNG,301,2.0167044549156263,Hawkish
186,176, 타임/NNG,362,1.5345287534221628,Hawkish
545,554, 상각/NNG,1099,1.4284383178860862,Hawkish
397,319, 고정자산/NNG,716,1.8070683429250238,Hawkish
11,7, 단기/NNG;경기/NNG;침체/NNG,18,2.2817570404188228,Hawkish
35,16, 일시적/VAX;확대/NNG,51,3.1763095164921116,Hawkish
44,39, 금리/NNG;상회/NNG,83,1.6381845418391547,Hawkish
151,122, 낙찰금액/NNG,273,1.7971812158887448,Hawkish
71,75, 성행/NNG,146,1.3745857564704909,Hawkish
87,82, 중장기채/NNG,169,1.5405654519014003,Hawkish
51,11, 생산지/NNG,62,6.732126144045618,Hawkish
68,72, 듀레이션/NNG;길/VA,140,1.3713590293426259,Hawkish
11,11, 하향/NNG;금리/NNG;인하/NNG,22,1.4520272075392509,Hawkish
16,15, 방금/MAG,31,1.5488290213752007,Hawkish
18,19, 그럴까/VV,37,1.375604722931922,Hawkish
129,56, 신청지수/NNG,185,3.3448483887957745,Hawkish
49,37, 물가/NNG;상승/NNG;부담/NNG,86,1.9229549505249537,Hawkish
16,16, 스티프닝/NNG;플래트닝/NNG,32,1.4520272075392506,Hawkish
56,50, 업황/NNG;악화/NNG,106,1.626270472443961,Hawkish
36,39, 승수/NNG,75,1.3403328069593086,Hawkish
25,24, 들어서야/VV,49,1.5125283411867194,Hawkish
40,31, 금리/NNG;매력/NNG;높/VA,71,1.8735834935990334,Hawkish
93,85, 효용/NNG,178,1.5886885917782392,Hawkish
35,33, 진일보/NNG,68,1.5400288564810236,Hawkish
69,73, 피해갈/VV,142,1.372464072879566,Hawkish
29,32, 해외/NNG;금리/NNG;상승/NNG,61,1.315899656832446,Hawkish
12,13, 심리/NNG;되돌/VV,25,1.3403328069593086,Hawkish
15,8, 노정/NNG,23,2.722551014136095,Hawkish
20,18, 조정위험/NNG,38,1.6133635639325008,Hawkish
656,619, 종결/NNG,1275,1.5388204331918391,Hawkish
26,12, 개/VV,38,3.1460589496683764,Hawkish
595,111, 특수은행/NNG,706,7.783389085458145,Hawkish
17,6, 대기성여수신제도/NNG,23,4.114077088027877,Hawkish
315,207, 이치/NNG,522,2.209606620168425,Hawkish
123,135, 골고루/MAG,258,1.3229581224246507,Hawkish
17,13, 결론짓/VV,30,1.8988048098590204,Hawkish
9,9, 장황/NNG,18,1.4520272075392509,Hawkish
56,61, 절충안/NNG,117,1.3330085839704597,Hawkish
1843,1560, 공모/NNG,3403,1.7154398355736147,Hawkish
12,13, 욕망/NNG,25,1.3403328069593086,Hawkish
13,5, 평기/NNG,18,3.775270739602052,Hawkish
251,246, 발행사/NNG,497,1.481539955659967,Hawkish
81,19, 미결/NNG,100,6.1902212531936485,Hawkish
490,391, 기여도/NNG,881,1.819676040138703,Hawkish
14,13, 구조조정/NNG;부담/NNG,27,1.5637216081191931,Hawkish
67,61, 듀레이션/NNG;늘/VV,128,1.5948495558217999,Hawkish
1167,817, 우량등급/NNG,1984,2.0740706869012313,Hawkish
246,259, 관전/NNG,505,1.3791455330295588,Hawkish
19,14, 유쾌/NNG,33,1.9706083530889835,Hawkish
492,455, 취업자/NNG,947,1.57010414529519,Hawkish
136,115, 재고조정/NNG,251,1.717180001959462,Hawkish
9,8, 고미/NNG,17,1.6335306084816572,Hawkish
254,226, 단기성/NNG,480,1.6319243836945563,Hawkish
117,30, 장기성/NNG,147,5.662906109403077,Hawkish
10,10, 국고채/NNG;금리/NNG;안정/NNG,20,1.4520272075392509,Hawkish
13,4, 스티프닝/NNG;추세/NNG,17,4.719088424502566,Hawkish
14,15, 높/VA;인하/NNG,29,1.3552253937033008,Hawkish
225,219, 스/VV,444,1.4918087748690934,Hawkish
79,87, 딩/NNG,166,1.3185074643172507,Hawkish
28,28, 금리/NNG;많이/MAG;하락/NNG,56,1.4520272075392509,Hawkish
104,86, 호/NNG,190,1.7559398788846754,Hawkish
9,10, 높/VA;양호/NNG,19,1.3068244867853258,Hawkish
13,5, 롤링/NNG,18,3.775270739602052,Hawkish
42,46, 발현/NNG,88,1.325763972101055,Hawkish
57,56, 재미있/VA,113,1.4779562648167375,Hawkish
37,31, 깃발/NNG,68,1.733064731579106,Hawkish
32,13, 소매시장/NNG,45,3.5742208185581554,Hawkish
327,314, 고용률/NNG,641,1.5121429836475637,Hawkish
135,100, 계절성/NNG,235,1.9602367301779886,Hawkish
12,8, 대미/NNG;수출/NNG;감소/NNG,20,2.1780408113088763,Hawkish
13,4, 예상/NNG;우호적/VAX,17,4.719088424502566,Hawkish
24,21, 환경/NNG;나쁘/VA,45,1.6594596657591438,Hawkish
46,46, 다진/VV,92,1.4520272075392506,Hawkish
45,47, 옮겨간/VV,92,1.39023881572907,Hawkish
39,20, 요구수익률/NNG,59,2.831453054701539,Hawkish
144,157, 심리/NNG;부담/NNG,301,1.331795655322625,Hawkish
23,25, 작/VA;충격/NNG,48,1.3358650309361106,Hawkish
20,21, 지켜낸/VV,41,1.3828830547992865,Hawkish
92,100, 문건/NNG,192,1.3358650309361106,Hawkish
13,12, 누울/VV,25,1.5730294748341882,Hawkish
172,178, 필자/NNG,350,1.403082470206467,Hawkish
11,11, 황실/NNG,22,1.4520272075392509,Hawkish
259,125, 크로나/NNG,384,3.0086003740213276,Hawkish
26,3, 률/NNG,29,12.584235798673506,Hawkish
307,130, 회차/NNG,437,3.429018097804231,Hawkish
8,8, 재정거래/NNG;유인/NNG;확대/NNG,16,1.4520272075392506,Hawkish
11,7, 단기/NNG;외채/NNG;감소/NNG,18,2.2817570404188228,Hawkish
15,14, 장기물/NNG;우호적/VAX,29,1.5557434366491973,Hawkish
23,10, 금리/NNG;부정적/VAX,33,3.3396625773402766,Hawkish
582,498, 종목별/NNG,1080,1.6969474594133411,Hawkish
121,98, 장단기스프레드/NNG;축소/NNG,219,1.7928091031862177,Hawkish
22,6, 틱/MAG,28,5.324099760977252,Hawkish
99,87, 단기물/NNG;약세/NNG,186,1.652306822372251,Hawkish
32,32, 대외/NNG;여건/NNG;불안/NNG,64,1.4520272075392506,Hawkish
13,10, 중장기물/NNG;약세/NNG,23,1.887635369801026,Hawkish
71,44, 붉/VA,115,2.3430439030747006,Hawkish
34,34, 은지/NNG,68,1.4520272075392509,Hawkish
287,258, 공급측면/NNG,545,1.6152395680766083,Hawkish
175,159, 장단기물/NNG,334,1.5981431529520056,Hawkish
1260,1196, 종류/NNG,2456,1.529727660116602,Hawkish
421,425, 자본재/NNG,846,1.4383610691153519,Hawkish
16,12, 지아/NNG,28,1.9360362767190007,Hawkish
68,67, 긴급대출/NNG,135,1.473699255412971,Hawkish
21,3, 즉/VV,24,10.164190452774754,Hawkish
55,44, 외국인지분율/NNG,99,1.8150340094240636,Hawkish
83,84, 블/NNG,167,1.4347411693542598,Hawkish
15,12, 민감히/MAG,27,1.8150340094240633,Hawkish
10,7, 누명/NNG,17,2.07432458219893,Hawkish
21,18, 크리티컬/NNG,39,1.6940317421291258,Hawkish
12,12, 키가/XSV,24,1.4520272075392509,Hawkish
33,35, 무차별/NNG,68,1.3690542242512935,Hawkish
84,87, 해프닝/NNG,171,1.4019573038310007,Hawkish
27,29, 요새/NNG,56,1.3518874001227508,Hawkish
16,17, 거대기업/NNG,33,1.3666138423898828,Hawkish
95,67, 우상/NNG,162,2.0588445480034157,Hawkish
33,21, 발행가격/NNG,54,2.2817570404188223,Hawkish
17,18, 백기사/NNG,35,1.3713590293426259,Hawkish
1464,438, 수록/NNG,1902,4.853351214240783,Hawkish
61,62, 반길/VV,123,1.428607413869263,Hawkish
32,0, 롤링효과/NNG,32,inf,Hawkish
193,135, 기대수익/NNG,328,2.0758611189264844,Hawkish
31,3, 적순/NNG,34,15.004281144572257,Hawkish
44,10, 소맥/NNG,54,6.388919713172703,Hawkish
160,149, 초과지준/NNG,309,1.5592238470220143,Hawkish
76,77, 웨/VV,153,1.4331697113374424,Hawkish
249,4, 아리/NNG,253,90.38869366931836,Hawkish
21,15, 벨/VV,36,2.032838090554951,Hawkish
19,0, 미본/NNG,19,inf,Hawkish
20,19, 저평가주/NNG,39,1.5284496921465798,Hawkish
60,61, 팰리스/NNG,121,1.4282234828254925,Hawkish
10,10, 보라매/NNG,20,1.4520272075392509,Hawkish
18,8, 국제/NNG;국가/NNG;신용등급/NNG;하향/NNG,26,3.2670612169633144,Hawkish
16,8, 금리/NNG;상승/NNG;압력/NNG;높/VV,24,2.9040544150785013,Hawkish
35,31, 단기/NNG;금리/NNG;안정/NNG,66,1.6393855568991544,Hawkish
98,96, 재정/NNG;적자/NNG;축소/NNG,194,1.4822777743629851,Hawkish
10,7, 자금/NNG;유출/NNG;위험/NNG,17,2.07432458219893,Hawkish
16,16, 이탈/NNG;가능성/NNG;낮/VA,32,1.4520272075392506,Hawkish
9,8, 채권시장/NNG;악영향/NNG,17,1.6335306084816572,Hawkish
28,29, 불확실성/NNG;부담/NNG,57,1.4019573038310007,Hawkish
33,2, 발행시장/NNG;강세/NNG,35,23.958448924397636,Hawkish
16,7, 고평가/NNG;해소/NNG,23,3.3189193315182877,Hawkish
141,98, 긴축/NNG;전환/NNG,239,2.0891411863574936,Hawkish
15,11, 기대수익/NNG;낮/VA,26,1.9800371011898874,Hawkish
12,10, 통제/NNG;어렵/VA,22,1.742432649047101,Hawkish
48,51, 채권/NNG;살/VV,99,1.366613842389883,Hawkish
174,50, 바벨/NNG,224,5.053054682236593,Hawkish
18,10, 소비자/NNG;물가/NNG;예상/NNG;상회/NNG,28,2.6136489735706516,Hawkish
27,17, 저평/NNG;축소/NNG,44,2.3061608590329277,Hawkish
22,12, 현물/NNG;금리/NNG;상승/NNG,34,2.662049880488626,Hawkish
15,14,돌아온/VV,29,1.5557434366491973,Hawkish
42,39, 특이사항/NNG,81,1.5637216081191931,Hawkish
895,988, 법인세/NNG,1883,1.315348533145374,Hawkish
176,188, 매입계획/NNG,364,1.3593446198239796,Hawkish
51,38, 고용증가율/NNG,89,1.9487733574868893,Hawkish
11,8, 단기/NNG;금융시장/NNG;안정/NNG,19,1.9965374103664697,Hawkish
13,13, 소매/NNG;판매/NNG;하락/NNG,26,1.4520272075392509,Hawkish
87,64, 채권시장/NNG;금리/NNG;상승/NNG,151,1.973849485248669,Hawkish
28,29, 평과/NNG,57,1.4019573038310007,Hawkish
41,36, 중임/NNG,77,1.6536976530308134,Hawkish
15,15, 이랬/VV,30,1.4520272075392506,Hawkish
14,8, 흔쾌히/MAG,22,2.541047613193689,Hawkish
11,11, 싸인/VV,22,1.4520272075392509,Hawkish
521,556, 상반/NNG,1077,1.3606226171366003,Hawkish
22,18, 인수/NNG;부담/NNG,40,1.774699920325751,Hawkish
44,36, 구조조정기금/NNG,80,1.774699920325751,Hawkish
239,215, 만약/MAG,454,1.614113965590144,Hawkish
140,122, 채권지수/NNG,262,1.666260729963075,Hawkish
112,113, 추/NNG,225,1.4391774092424432,Hawkish
19,14, 부실채권정리기금/NNG,33,1.9706083530889835,Hawkish
469,423, 법정관리/NNG,892,1.609930875498602,Hawkish
46,15, 이어서/MAG,61,4.4528834364537015,Hawkish
18,2, 월금/NNG,20,13.068244867853258,Hawkish
57,59, 합의사항/NNG,116,1.402805946266734,Hawkish
14,8, 대량환매사태/NNG,22,2.541047613193689,Hawkish
109,113, 장단/NNG,222,1.4006280143520207,Hawkish
26,19, 절대금액/NNG,45,1.9869845997905538,Hawkish
49,50, 법인자금/NNG,99,1.422986663388466,Hawkish
141,137, 유사시/NNG,278,1.4944221625039005,Hawkish
124,99, 공산품/NNG,223,1.8187007447966372,Hawkish
13,6, 소득효과/NNG,19,3.1460589496683764,Hawkish
22,3, 판매비율/NNG,25,10.648199521954504,Hawkish
31,26, 가처분/NNG;소득/NNG;증가/NNG,57,1.731263208989107,Hawkish
30,26, 채권/NNG;발행/NNG;증가/NNG,56,1.6754160086991354,Hawkish
53,30, 높/VA;밖/NNG;없/VA,83,2.5652480666526762,Hawkish
9,9, 최대한/NNG;흡수/NNG,18,1.4520272075392509,Hawkish
31,22, 자금/NNG;감소/NNG,53,2.046038337896217,Hawkish
2134,417, 잔존만기/NNG,2551,7.430757939781201,Hawkish
116,43, 한하/VV,159,3.9170966528965834,Hawkish
449,395, 조건부/NNG,844,1.6505321928737307,Hawkish
54,60, 버전/NNG,114,1.3068244867853256,Hawkish
31,25, 확언/NNG,56,1.8005137373486713,Hawkish
9,7, 조상/NNG,16,1.866892123979037,Hawkish
15,9, 테크니컬/NNG,24,2.420045345898751,Hawkish
11,9, 신용시장/NNG;개선/NNG,20,1.774699920325751,Hawkish
80,65, 듀레이션/NNG;축소/NNG,145,1.7871104092790782,Hawkish
73,73, 부동산/NNG;위축/NNG,146,1.4520272075392509,Hawkish
19,16, 채권/NNG;긍정적/VAX,35,1.7242823089528605,Hawkish
17,18, 경기/NNG;최악/NNG,35,1.3713590293426259,Hawkish
900,740, 기점/NNG,1640,1.7659790361963863,Hawkish
22,20, 자비/NNG,42,1.5972299282931757,Hawkish
29,27, 수재/NNG,56,1.559584778468084,Hawkish
20,11, 주수/NNG,31,2.640049468253183,Hawkish
28,0, 설건/NNG,28,inf,Hawkish
16,14, 평시/NNG,30,1.6594596657591438,Hawkish
91,81, 한계점/NNG,172,1.631289825753973,Hawkish
117,102, 유입액/NNG,219,1.6655606204126698,Hawkish
56,57, 림/NNG,113,1.4265530460034743,Hawkish
525,572, 국고채/NNG;상승/NNG,1097,1.3327172796470397,Hawkish
13,8, 중장기물/NNG;금리/NNG;상승/NNG,21,2.359544212251283,Hawkish
10,8, 기대/NNG;점차/MAG;약화/NNG,18,1.8150340094240636,Hawkish
32,25, 환용/NNG,57,1.858594825650241,Hawkish
20,17, 높/VA;강세/NNG,37,1.7082673029873539,Hawkish
12,12, 뒷맛/NNG,24,1.4520272075392509,Hawkish
27,28, 이리저리/MAG,55,1.4001690929842776,Hawkish
19,12, 발원지/NNG,31,2.299043078603814,Hawkish
118,127, 기운/NNG,245,1.3491276416506426,Hawkish
34,27, 앞설/VV,61,1.8284787057901677,Hawkish
25,16, 소순환/NNG,41,2.2687925117800796,Hawkish
13,12, 채워져/VV,25,1.5730294748341882,Hawkish
2976,1802, 현황/NNG,4778,2.398020515891681,Hawkish
35,27, 구매지수/NNG,62,1.8822574912545844,Hawkish
55,26, 소비지/NNG,81,3.071596015948415,Hawkish
136,144, 액면가/NNG,280,1.3713590293426259,Hawkish
37,40, 자간/NNG,77,1.343125166973807,Hawkish
49,51, 끊임없/VA,100,1.395084964106339,Hawkish
629,666, 투자수익률/NNG,1295,1.3713590293426259,Hawkish
114,91, 투자이익/NNG,205,1.8190230951590616,Hawkish
17,16, 판별/NNG,33,1.5427789080104541,Hawkish
93,82, 색/NNG,175,1.6468113451359796,Hawkish
1037,1077, 주주/NNG,2114,1.398098620444014,Hawkish
185,179, 편차/NNG,364,1.5006985105852593,Hawkish
1582,1686, 투자전략/NNG,3268,1.362459692957945,Hawkish
769,90, 만기수익률/NNG,859,12.406765806640932,Hawkish
109,92, 만기보유/NNG,201,1.7203365828454167,Hawkish
8,8, 만기보유전략/NNG,16,1.4520272075392506,Hawkish
118,108, 우월/NNG,226,1.5864741712002923,Hawkish
14,13, 쎄/VA,27,1.5637216081191931,Hawkish
461,481, 텀/NNG,942,1.3916518558744173,Hawkish
199,216, 초과수익/NNG,415,1.3377472884273651,Hawkish
1757,1932, 원화채권/NNG,3689,1.320503003957797,Hawkish
42,33, 자분/NNG,75,1.8480346277772282,Hawkish
2796,1916, 상위/NNG,4712,2.118929056513437,Hawkish
72,63, 사간/NNG,135,1.6594596657591438,Hawkish
453,491, 운용자산/NNG,944,1.3396503564466,Hawkish
206,218, 빈번/NNG,424,1.3720991043719528,Hawkish
14,5, 월수/NNG,19,4.065676181109902,Hawkish
189,197, 다지기/NNG,386,1.3930616356594843,Hawkish
22,8, 과잉/NNG;유동성/NNG;축소/NNG,30,3.9930748207329394,Hawkish
14,13, 원자재/NNG;가격/NNG;바닥/NNG,27,1.5637216081191931,Hawkish
13,12, 국채/NNG;발행/NNG;축소/NNG,25,1.5730294748341882,Hawkish
18,17, 실물/NNG;경제/NNG;안정/NNG,35,1.5374405726886184,Hawkish
66,33, 선행/NNG;지수/NNG;상승/NNG,99,2.9040544150785013,Hawkish
110,114, 금리/NNG;변동/NNG;위험/NNG,224,1.401078884467698,Hawkish
17,16, 금리/NNG;변동성/NNG;높/VA,33,1.5427789080104541,Hawkish
13,12, 높/VA;금리/NNG;하락/NNG,25,1.5730294748341882,Hawkish
15,16, 많/VA;금리/NNG;상승/NNG,31,1.3612755070680476,Hawkish
12,7, 스티프닝/NNG;전환/NNG,19,2.489189498638716,Hawkish
9,8, 모기지/NNG;부담/NNG,17,1.6335306084816572,Hawkish
45,50, 하락/NNG;안정/NNG,95,1.3068244867853258,Hawkish
29,26, 정책/NNG;실망/NNG,55,1.6195688084091644,Hawkish
19,11, 안정/NNG;조짐/NNG,30,2.5080469948405244,Hawkish
24,22, 국고채/NNG;발행/NNG;증가/NNG,46,1.58402968095191,Hawkish
38,33, 선네고/NNG,71,1.6720313298936829,Hawkish
521,479, 수출/NNG;호조/NNG,1000,1.5793448332525046,Hawkish
13,3, 호조/NNG;개선/NNG,16,6.292117899336753,Hawkish
33,19, 호/VV,52,2.5219419920418567,Hawkish
74,67, 경제/NNG;성장률/NNG;상향/NNG,141,1.603731542655292,Hawkish
67,66, 채권/NNG;금리/NNG;강세/NNG,133,1.4740276197746938,Hawkish
20,12, 높/VA;안전자산/NNG;선호/NNG,32,2.420045345898751,Hawkish
362,235, 연도/NNG,597,2.2367397835285483,Hawkish
15,4, 출대/NNG,19,5.44510202827219,Hawkish
21,4, 국고채/NNG;확대/NNG,25,7.6231428395810665,Hawkish
21,20, 수요/NNG;지지/NNG,41,1.5246285679162133,Hawkish
14,9, 경기/NNG;악재/NNG,23,2.258708989505501,Hawkish
23,22, 낙찰/NNG;금리/NNG;높/VA,45,1.5180284442455803,Hawkish
35,26, 선물가/NNG,61,1.9546520101489917,Hawkish
26,26, 경기/NNG;회복/NNG;기대/NNG;살/VV,52,1.4520272075392509,Hawkish
47,25, 전망/NNG;경기/NNG;회복/NNG,72,2.7298111501737914,Hawkish
13,9, 닫혔/VV,22,2.097372633112251,Hawkish
336,326, 지속성/NNG,662,1.4965679194269579,Hawkish
64,65, 경기/NNG;회복/NNG;기대/NNG;높/VA,129,1.4296883274232624,Hawkish
16,14, 금리/NNG;단기/NNG;하락/NNG,30,1.6594596657591438,Hawkish
36,36, 경기/NNG;회복/NNG;우려/NNG,72,1.4520272075392509,Hawkish
47,36, 높/VA;경기/NNG;회복/NNG,83,1.8957021876206883,Hawkish
19,21, 높/VA;금리/NNG;낮/VA,40,1.3137389020593222,Hawkish
187,197, 경기/NNG;불확실성/NNG,384,1.3783202426895427,Hawkish
35,25, 인상/NNG;아니/VCN,60,2.0328380905549515,Hawkish
50,51, 억제/NNG;효과/NNG,101,1.423556085822795,Hawkish
26,21, 경기/NNG;강세/NNG,47,1.7977479712390725,Hawkish
51,54, 지나쳤/VV,105,1.3713590293426257,Hawkish
28,22, 경기/NNG;회복/NNG;부담/NNG,50,1.8480346277772284,Hawkish
33,32, 채권비중/NNG;줄/VV,65,1.4974030577748523,Hawkish
492,492, 현금흐름/NNG,984,1.4520272075392509,Hawkish
28,25, 연탄/NNG,53,1.626270472443961,Hawkish
86,81, 언어/NNG,167,1.541658516646612,Hawkish
60,25, 순매수비중/NNG,85,3.484865298094202,Hawkish
9,9, 팔라/NNG,18,1.4520272075392509,Hawkish
66,45, 투자포인트/NNG,111,2.129639904390901,Hawkish
581,43, 매도전략/NNG,624,19.61925133907685,Hawkish
26,23, 재빠르/VA,49,1.6414220606965444,Hawkish
90,73, 원보험/NNG,163,1.7901705298429118,Hawkish
14,14, 채인/VV,28,1.4520272075392509,Hawkish
237,254, 사모사채/NNG,491,1.3548442842000097,Hawkish
11,10, 장기물/NNG;입찰/NNG;부담/NNG,21,1.5972299282931757,Hawkish
21,19, 회복/NNG;저해/NNG,40,1.604872176753909,Hawkish
51,50, 신용위험/NNG;높/VA,101,1.481067751690036,Hawkish
13,5, 전망/NNG;축소/NNG,18,3.775270739602052,Hawkish
34,34, 이익/NNG;오르/VV,68,1.4520272075392509,Hawkish
26,20, 공급/NNG;작/VA,46,1.887635369801026,Hawkish
43,18, 농금채/NNG,61,3.4687316624548767,Hawkish
39,41, 우군/NNG,80,1.3811966120495314,Hawkish
886,493, 자산배분/NNG,1379,2.6095255697358546,Hawkish
19,19, 재정위/NNG,38,1.4520272075392509,Hawkish
54,53, 과잉/NNG;유동성/NNG;흡수/NNG,107,1.4794239473041424,Hawkish
28,22, 과잉/NNG;유동성/NNG;우려/NNG,50,1.8480346277772284,Hawkish
10,9, 리바운드/NNG,19,1.6133635639325008,Hawkish
10,7, 시험지/NNG,17,2.07432458219893,Hawkish
159,171, 볼/NNG,330,1.3501305613961454,Hawkish
37,17, 금감/NNG,54,3.1602945105266045,Hawkish
21,14, 승수효과/NNG,35,2.1780408113088763,Hawkish
100,104, 진폭/NNG,204,1.3961800072492796,Hawkish
469,10, 고국/NNG,479,68.10007603359087,Hawkish
585,0, 안통/NNG,585,inf,Hawkish
534,3, 채수/NNG,537,258.4608429419866,Hawkish
348,8, 행은/NNG,356,63.16318352795741,Hawkish
294,103, 행/NNG,397,4.144621349675143,Hawkish
442,0, 전여/NNG,442,inf,Hawkish
93,4, 여월/NNG,97,33.75963257528758,Hawkish
13,7, 금리/NNG;하락/NNG;쉽/VA;않/VX,20,2.6966219568586087,Hawkish
18,15, 유동성/NNG;공급/NNG;줄/VV,33,1.742432649047101,Hawkish
57,56, 국채입찰/NNG;성공/NNG,113,1.4779562648167375,Hawkish
16,8, 펀더멘털/NNG;부담/NNG,24,2.9040544150785013,Hawkish
11,5, 심리/NNG;줄/VV,16,3.1944598565863513,Hawkish
26,21, 왝더독/NNG,47,1.7977479712390725,Hawkish
66,66, 채권시장/NNG;금리/NNG;하락/NNG,132,1.4520272075392506,Hawkish
79,72, 쉼/NNG,151,1.5931965193833446,Hawkish
21,1, 월후/NNG,22,30.492571358324266,Hawkish
47,50, 상수/NNG,97,1.3649055750868957,Hawkish
88,85, 그저/MAG,173,1.5032752266288714,Hawkish
222,234, 구직/NNG,456,1.377564273819289,Hawkish
56,30, 비경제활동인구/NNG,86,2.7104507874066015,Hawkish
55,52, 엿보였/VV,107,1.5357980079742075,Hawkish
36,38, 힘겨루기/NNG,74,1.375604722931922,Hawkish
48,49, 날카롭/VA,97,1.4223939992221233,Hawkish
14,12, 답/MAG,26,1.6940317421291258,Hawkish
146,149, 비추/VV,295,1.4227917604075881,Hawkish
24,18, 심산/NNG,42,1.9360362767190011,Hawkish
173,118, 돼지/NNG,291,2.1288195500363596,Hawkish
144,94, 독감/NNG,238,2.2243821051665122,Hawkish
148,122, 파이낸스/NNG,270,1.7614756288181077,Hawkish
15,13, 경기/NNG;선행/NNG;지수/NNG;개선/NNG,28,1.6754160086991354,Hawkish
49,39, 경기/NNG;회복/NNG;속도/NNG;둔화/NNG,88,1.8243418761390588,Hawkish
17,16, 제조업/NNG;지수/NNG;개선/NNG,33,1.5427789080104541,Hawkish
19,7, 가격/NNG;상승/NNG;축소/NNG,26,3.941216706177967,Hawkish
12,11, 민간/NNG;수요/NNG;회복/NNG,23,1.58402968095191,Hawkish
52,48, 펀더멘털/NNG;회복/NNG,100,1.5730294748341882,Hawkish
17,11, 금융자산/NNG;증가/NNG,28,2.244042048015206,Hawkish
40,42, 수출/NNG;급증/NNG,82,1.3828830547992865,Hawkish
630,688, 가격/NNG;부담/NNG,1318,1.3296179371362327,Hawkish
22,24, 기대/NNG;어렵/VA,46,1.331024940244313,Hawkish
23,24, 여력/NNG;낮/VA,47,1.3915260738917818,Hawkish
9,10, 많/VA;부실/NNG,19,1.3068244867853258,Hawkish
589,538, 스트레스테스트/NNG,1127,1.5896729093691795,Hawkish
34,21, 금리/NNG;상승/NNG;가능성/NNG;높/VA,55,2.350901193158787,Hawkish
12,8, 봉인/NNG,20,2.1780408113088763,Hawkish
82,61, 위함/VV,143,1.9519054265281732,Hawkish
57,31, 억/NNG,88,2.6698564783786227,Hawkish
17,15, 쌍방향/NNG,32,1.645630835211151,Hawkish
28,30, 부풀려진/VV,58,1.3552253937033008,Hawkish
25,13, 미/NNG;재정/NNG;적자/NNG,38,2.792360014498559,Hawkish
16,6, 경기/NNG;예상/NNG;좋/VA,22,3.8720725534380014,Hawkish
28,30, 국채/NNG;매입/NNG;늘/VV,58,1.3552253937033008,Hawkish
13,7, 지출/NNG;안정/NNG,20,2.6966219568586087,Hawkish
78,62, 수요/NNG;개선/NNG,140,1.8267439062590576,Hawkish
47,25, 주도력/NNG,72,2.7298111501737914,Hawkish
10,6, 경기/NNG;동행/NNG;지수/NNG;상승/NNG,16,2.420045345898751,Hawkish
9,8, 생산/NNG;지수/NNG;상승/NNG,17,1.6335306084816572,Hawkish
479,482, 복구/NNG,961,1.44298969379938,Hawkish
708,523, 아/VV,1231,1.965650598351414,Hawkish
46,43, 몸통/NNG,89,1.5533314313210589,Hawkish
11,6, 소비자/NNG;심리/NNG;상승/NNG,17,2.662049880488626,Hawkish
13,9, 동행/NNG;지수/NNG;상승/NNG,22,2.097372633112251,Hawkish
175,149, 경제/NNG;호조/NNG,324,1.7054010826803283,Hawkish
22,19, 민간/NNG;고용/NNG;감소/NNG,41,1.6812946613612378,Hawkish
60,65, 시중/NNG;유동성/NNG;흡수/NNG,125,1.3403328069593086,Hawkish
16,15, 금리/NNG;상승/NNG;주춤/NNG,31,1.5488290213752007,Hawkish
40,33, 폭발력/NNG,73,1.7600329788354554,Hawkish
116,62, 임시직/NNG,178,2.7166960657185983,Hawkish
21,12, 후방/NNG,33,2.5410476131936885,Hawkish
27,27, 경기관/NNG,54,1.4520272075392506,Hawkish
655,676, 톤/NNG,1331,1.4069198534588894,Hawkish
15,12, 비약/NNG,27,1.8150340094240633,Hawkish
29,30, 숏마인드/NNG,59,1.4036263006212757,Hawkish
11,10, 제한적/VAX;금리/NNG;상승/NNG,21,1.5972299282931757,Hawkish
20,18, 금리/NNG;단기/NNG;급등/NNG,38,1.6133635639325008,Hawkish
8,8, 금리/NNG;상승/NNG;그치/VV,16,1.4520272075392506,Hawkish
9,7, 예상/NNG;덜/MAG;감소/NNG,16,1.866892123979037,Hawkish
17,8, 상향/NNG;이탈/NNG,25,3.0855578160209083,Hawkish
10,11, 위축/NNG;상쇄/NNG,21,1.3200247341265916,Hawkish
20,15, 해서인지/XSV,35,1.936036276719001,Hawkish
9,9, 하락/NNG;막/VV;없/VA,18,1.4520272075392509,Hawkish
32,27, 수속/NNG,59,1.720921134861334,Hawkish
24,25, 말끔히/MAG,49,1.393946119237681,Hawkish
16,14, 금리/NNG;인상/NNG;완화/NNG,30,1.6594596657591438,Hawkish
12,5, 국고채/NNG;하단/NNG,17,3.484865298094202,Hawkish
77,76, 완화/NNG;축소/NNG,153,1.4711328286910832,Hawkish
29,32, 과도/NNG;긴축/NNG,61,1.315899656832446,Hawkish
25,19, 저점/NNG;하회/NNG,44,1.9105621151832248,Hawkish
13,5, 낮/VA;완화/NNG,18,3.775270739602052,Hawkish
813,850, 계열/NNG,1663,1.3888213173287187,Hawkish
22,16, 금리/NNG;하락/NNG;모멘텀/NNG,38,1.9965374103664697,Hawkish
18,11, 금리/NNG;변동성/NNG;줄/VV,29,2.376044521427865,Hawkish
19,21, 낙관론/NNG;경계/NNG,40,1.3137389020593222,Hawkish
11,9,작/VV,20,1.774699920325751,Hawkish
67,67, 들썩/MAG,134,1.4520272075392506,Hawkish
52,55, 뜯어보/VV,107,1.3728257234916554,Hawkish
221,216, 준비금/NNG,437,1.4856389484545112,Hawkish
100,109, 보유현금/NNG,209,1.3321350527883036,Hawkish
27,17, 금리/NNG;상승/NNG;압력/NNG;크/VV,44,2.3061608590329277,Hawkish
19,20, 회복/NNG;기대/NNG;높/VV,39,1.3794258471622882,Hawkish
73,77, 듀레이션/NNG;확대/NNG,150,1.376597222732017,Hawkish
10,8, 채권시장/NNG;조정/NNG;압력/NNG,18,1.8150340094240636,Hawkish
49,13, 채권시장/NNG;모멘텀/NNG,62,5.473025628417177,Hawkish
12,8, 금리/NNG;인상/NNG;유동성/NNG;흡수/NNG,20,2.1780408113088763,Hawkish
75,7, 채미/NNG,82,15.557434366491975,Hawkish
378,292, 서베이/NNG,670,1.8796790563350576,Hawkish
126,96, 순환변동/NNG,222,1.9057857098952666,Hawkish
43,40, 아웃소싱/NNG,83,1.5609292481046946,Hawkish
238,255, 지루/NNG,493,1.3552253937033005,Hawkish
12,8, 금리/NNG;상승/NNG;압력/NNG;완화/NNG,20,2.1780408113088763,Hawkish
16,9, 부작용/NNG;완화/NNG,25,2.5813817022920014,Hawkish
19,2,서거/NNG,21,13.794258471622884,Hawkish
628,554, 북핵/NNG,1182,1.6459803002430495,Hawkish
426,457, 개선/NNG;추세/NNG,883,1.3535308324107678,Hawkish
47,44, 금리/NNG;제한/NNG,91,1.551029062598745,Hawkish
38,34, 줄여나갔/VV,72,1.622853937837986,Hawkish
38,17, 전망/NNG;금리/NNG;상승/NNG,55,3.245707875675972,Hawkish
25,20, 하락/NNG;가능성/NNG;배제/NNG,45,1.8150340094240636,Hawkish
175,180,캐리/NNG,355,1.4116931184409383,Hawkish
12,12, 나뉠/VV,24,1.4520272075392509,Hawkish
138,130, 재정/NNG;적자/NNG;확대/NNG,268,1.5413827280032049,Hawkish
24,10, 실세/NNG;금리/NNG;상승/NNG,34,3.484865298094202,Hawkish
80,88, 모기지/NNG;금리/NNG;오르/VV,168,1.3200247341265916,Hawkish
66,65, 국채/NNG;매입/NNG;확대/NNG,131,1.4743660876552394,Hawkish
19,19, 이루어진다/VV,38,1.4520272075392509,Hawkish
69,2, 승상/NNG,71,50.094938660104155,Hawkish
90,97, 승/NNG,187,1.347241738953944,Hawkish
103,93, 법칙/NNG,196,1.60815916533917,Hawkish
35,30, 생산요소/NNG,65,1.694031742129126,Hawkish
52,28, 생산물/NNG,80,2.6966219568586087,Hawkish
184,200, 손상/NNG,384,1.3358650309361106,Hawkish
52,48, 분자/NNG,100,1.5730294748341882,Hawkish
64,52, 분모/NNG,116,1.7871104092790777,Hawkish
112,124, 옮길/VV,236,1.3115084455193233,Hawkish
188,162, 창출력/NNG,350,1.6850686112183897,Hawkish
21,17, 부동산/NNG;자산/NNG;가격/NNG;상승/NNG,38,1.7936806681367214,Hawkish
10,7, 공급/NNG;능력/NNG;확대/NNG,17,2.07432458219893,Hawkish
27,25, 변동성/NNG;증폭/NNG,52,1.568189384142391,Hawkish
10,8, 하락/NNG;악순환/NNG,18,1.8150340094240636,Hawkish
94,80, 자산/NNG;확대/NNG,174,1.7061319688586194,Hawkish
32,34, 자산/NNG;감소/NNG,66,1.3666138423898828,Hawkish
142,104, 경제/NNG;과열/NNG,246,1.982575610293977,Hawkish
9,9, 하락/NNG;심하/VA,18,1.4520272075392509,Hawkish
33,25, 저축/NNG;줄/VV,58,1.916675913951811,Hawkish
18,7, 지프/NNG,25,3.733784247958074,Hawkish
519,559, 헤드라인/NNG,1078,1.348125439557909,Hawkish
156,140, 근로시간/NNG,296,1.6179731741151653,Hawkish
746,768, 유상증자/NNG,1514,1.4104326781566159,Hawkish
102,97, 결정지/VV,199,1.52687397081447,Hawkish
11,12, 경기/NNG;개선/NNG;기대/NNG;높/VA,23,1.331024940244313,Hawkish
57,37, 금리/NNG;상승/NNG;하락/NNG,94,2.236906779182089,Hawkish
14,13, 금리/NNG;긍정적/VAX,27,1.5637216081191931,Hawkish
26,21, 취업자/NNG;감소/NNG,47,1.7977479712390725,Hawkish
12,4, 바닥/NNG;조짐/NNG,16,4.356081622617753,Hawkish
11,8, 비용/NNG;안정/NNG,19,1.9965374103664697,Hawkish
232,239, 경제/NNG;부진/NNG,471,1.4094992140129967,Hawkish
14,13, 부진/NNG;심각/NNG,27,1.5637216081191931,Hawkish
34,37, 예상/NNG;더디/VA,71,1.3342952717928251,Hawkish
23,25, 이래/NNG,48,1.3358650309361106,Hawkish
25,21, 작/VA;상승/NNG,46,1.7286038184991082,Hawkish
40,28, 역기능/NNG,68,2.07432458219893,Hawkish
56,49, 산생/NNG,105,1.6594596657591436,Hawkish
37,31, 이어서/VV,68,1.733064731579106,Hawkish
19,10, 당연/MAG,29,2.7588516943245764,Hawkish
356,368, 잠재성/NNG,724,1.4046784942499273,Hawkish
29,14, 수요/NNG;인플레이션/NNG;압력/NNG,43,3.007770644188448,Hawkish
14,10, 기대/NNG;인플레이션/NNG;우려/NNG,24,2.032838090554951,Hawkish
18,16, 선진국/NNG;경기/NNG;부진/NNG,34,1.6335306084816572,Hawkish
14,5, 경기/NNG;하락/NNG;멈추/VV,19,4.065676181109902,Hawkish
17,9, 마이너스/NNG;아니/VCN,26,2.7427180586852518,Hawkish
46,47, 당분간/MAG;완화/NNG,93,1.4211330116341603,Hawkish
15,4, 불안/NNG;긴축/NNG,19,5.44510202827219,Hawkish
23,10, 기대/NNG;하향/NNG,33,3.3396625773402766,Hawkish
22,22, 기대/NNG;무너/VV,44,1.4520272075392509,Hawkish
1076,1189, 이중침체/NNG,2265,1.3140296680506593,Hawkish
48,36, 하의/NNG,84,1.9360362767190011,Hawkish
20,22, 딥/NNG,42,1.3200247341265916,Hawkish
9,9, 앞당겨서/VV,18,1.4520272075392509,Hawkish
26,12, 점도/NNG,38,3.1460589496683764,Hawkish
19,11, 접시/NNG,30,2.5080469948405244,Hawkish
12,10, 재정/NNG;집행/NNG;확대/NNG,22,1.742432649047101,Hawkish
44,48, 양호/NNG;성장/NNG,92,1.331024940244313,Hawkish
1005,960, 북한리스크/NNG,1965,1.520090982892653,Hawkish
103,81, 재고율/NNG,184,1.8464049676116399,Hawkish
83,73, 산업/NNG;생산/NNG;부진/NNG,156,1.6509350441884634,Hawkish
20,20, 우려/NNG;약하/VA,40,1.4520272075392509,Hawkish
44,38, 전망/NNG;확대/NNG,82,1.6812946613612378,Hawkish
10,9, 금리/NNG;급등/NNG;위험/NNG,19,1.6133635639325008,Hawkish
12,10, 가수급/NNG;부담/NNG,22,1.742432649047101,Hawkish
15,16, 미의회예산국/NNG,31,1.3612755070680476,Hawkish
39,29, 위전/NNG,68,1.952726244621751,Hawkish
19,4, 점선/NNG,23,6.897129235811442,Hawkish
57,14, 경기/NNG;모멘텀/NNG;약화/NNG,71,5.91182505926695,Hawkish
27,17, 재정/NNG;적자/NNG;부담/NNG,44,2.3061608590329277,Hawkish
18,19, 불안/NNG;아니/VCN,37,1.375604722931922,Hawkish
10,7, 주택시장/NNG;회복/NNG;지연/NNG,17,2.07432458219893,Hawkish
186,198, 금리/NNG;하단/NNG,384,1.3640255585974779,Hawkish
10,11, 단기물/NNG;금리/NNG;급등/NNG,21,1.3200247341265916,Hawkish
20,11, 금리/NNG;하락/NNG;막/VV,31,2.640049468253183,Hawkish
53,55, 하이퍼인플레이션/NNG,108,1.3992262181741872,Hawkish
103,103, 채굴/NNG,206,1.4520272075392509,Hawkish
73,76, 틀렸/VV,149,1.3947103440837543,Hawkish
32,29, 훨훨/MAG,61,1.6022369186640009,Hawkish
25,19, 찍혀/VV,44,1.9105621151832248,Hawkish
1573,1684, 긴축정책/NNG,3257,1.3563175756883858,Hawkish
11,9, 대공/NNG,20,1.774699920325751,Hawkish
10,9, 황시/NNG,19,1.6133635639325008,Hawkish
23,23, 없다/VA,46,1.4520272075392506,Hawkish
18,10, 복기/NNG,28,2.6136489735706516,Hawkish
108,113, 경제/NNG;성장률/NNG;전망/NNG;상향/NNG,221,1.3877782160552132,Hawkish
22,18, 긴축정책/NNG;전환/NNG,40,1.774699920325751,Hawkish
91,99, 경제/NNG;낙관/NNG,190,1.334691675616887,Hawkish
26,26, 아직/MAG;성장/NNG,52,1.4520272075392509,Hawkish
50,52, 과열/NNG;억제/NNG,102,1.3961800072492796,Hawkish
10,9, 정책/NNG;되돌/VV,19,1.6133635639325008,Hawkish
108,118, 하락/NNG;멈추/VV,226,1.3289740543579585,Hawkish
128,132, 유동성/NNG;줄/VV,260,1.4080263830683644,Hawkish
25,23, 채권/NNG;늘/VV,48,1.5782904429774465,Hawkish
19,17, 타격/NNG;작/VA,36,1.622853937837986,Hawkish
71,66, 이머징채권/NNG,137,1.5620292687164667,Hawkish
152,130, 글로벌/NNG;경제/NNG;회복/NNG,282,1.6977548888151242,Hawkish
9,9, 중장기물/NNG;금리/NNG;하락/NNG,18,1.4520272075392509,Hawkish
16,17, 금리/NNG;낙폭/NNG;크/VV,33,1.3666138423898828,Hawkish
9,10, 만을/NNG,19,1.3068244867853258,Hawkish
47,38, 개수/NNG,85,1.7959283882722312,Hawkish
36,15, 특소/NNG,51,3.484865298094202,Hawkish
30,32, 준내구재/NNG,62,1.3612755070680476,Hawkish
72,74, 비내구재/NNG,146,1.412783228957109,Hawkish
126,112, 기성/NNG,238,1.6335306084816572,Hawkish
14,10, 아팠/VA,24,2.032838090554951,Hawkish
44,43, 들어와서/VV,87,1.4857952821331868,Hawkish
12,11, 반전일/NNG,23,1.58402968095191,Hawkish
17,13, 경기/NNG;회복/NNG;모멘텀/NNG;약화/NNG,30,1.8988048098590204,Hawkish
11,10, 소비/NNG;투자/NNG;개선/NNG,21,1.5972299282931757,Hawkish
51,33, 선행/NNG;지수/NNG;하락/NNG,84,2.244042048015206,Hawkish
29,23, 경기/NNG;불확실성/NNG;높/VA,52,1.830816913853838,Hawkish
17,13, 개선/NNG;둔화/NNG,30,1.8988048098590204,Hawkish
12,9, 판매/NNG;개선/NNG,21,1.9360362767190011,Hawkish
79,75, 금리/NNG;되돌/VV,154,1.5294686586080108,Hawkish
16,14, 주금/NNG,30,1.6594596657591438,Hawkish
9,8, 유가/NNG;원자재/NNG;가격/NNG;안정/NNG,17,1.6335306084816572,Hawkish
167,164, 경기/NNG;낙관/NNG,331,1.4785886808478959,Hawkish
12,10, 일과성/NNG,22,1.742432649047101,Hawkish
47,32, 아시아이머징/NNG,79,2.1326649610732744,Hawkish
97,95, 초입/NNG,192,1.4825962013821825,Hawkish
23,13, 성장/NNG;모멘텀/NNG;둔화/NNG,36,2.568971213338674,Hawkish
177,190, 경기/NNG;모멘텀/NNG,367,1.352677977549723,Hawkish
263,271, 오버/NNG,534,1.409162935729974,Hawkish
72,37, 글로벌리/MAG,109,2.825566457914218,Hawkish
133,102, 언더/NNG,235,1.8933295941443171,Hawkish
11,11, 좋/VA;않/VX;우려/NNG,22,1.4520272075392509,Hawkish
33,26, 상향/NNG;추세/NNG,59,1.842957609569049,Hawkish
18,18, 저점/NNG;높/VA,36,1.4520272075392509,Hawkish
12,11, 전망/NNG;변화/NNG;줄/VV,23,1.58402968095191,Hawkish
11,11, 경기/NNG;회복/NNG;기대/NNG;강화/NNG,22,1.4520272075392509,Hawkish
11,9, 플래트닝/NNG;전환/NNG,20,1.774699920325751,Hawkish
23,24, 널/NNG,47,1.3915260738917818,Hawkish
41,8, 부록/NNG,49,7.441639438638661,Hawkish
25,16, 시분할/NNG,41,2.2687925117800796,Hawkish
9,9, 윙/NNG,18,1.4520272075392509,Hawkish
46,25, 부동산세/NNG,71,2.6717300618722213,Hawkish
135,87, 감세안/NNG,222,2.253145666871251,Hawkish
16,2, 글로벌/NNG;경기/NNG;모멘텀/NNG;둔화/NNG,18,11.616217660314005,Hawkish
86,58, 부동산/NNG;경기/NNG;둔화/NNG,144,2.153005859454751,Hawkish
50,43, 막대/NNG;재정/NNG;적자/NNG,93,1.6884037296968033,Hawkish
9,9, 심각/NNG;재정/NNG;적자/NNG,18,1.4520272075392509,Hawkish
11,6, 투자심리/NNG;살/VV;않/VX,17,2.662049880488626,Hawkish
16,11, 개선/NNG;견인/NNG,27,2.1120395746025467,Hawkish
189,211, 둔화/NNG;조짐/NNG,400,1.3006310058053006,Hawkish
11,9, 주택가격/NNG;불안/NNG,20,1.774699920325751,Hawkish
47,39, 저금리/NNG;부작용/NNG,86,1.749878942419097,Hawkish
30,23, 마음먹/VV,53,1.8939485315729356,Hawkish
81,67, 템포/NNG,148,1.755435877771333,Hawkish
27,23, 금기/NNG,50,1.7045536784156423,Hawkish
15,11, 인상/NNG;압력/NNG,26,1.9800371011898874,Hawkish
36,40, 숙고/NNG,76,1.3068244867853258,Hawkish
23,17, 의례/NNG,40,1.9645073984354566,Hawkish
22,24,논쟁/NNG,46,1.331024940244313,Hawkish
10,8, 가진다고/VV,18,1.8150340094240636,Hawkish
24,0, 화폐발행액/NNG,24,inf,Hawkish
13,9, 본의/NNG,22,2.097372633112251,Hawkish
462,101, 탈/NNG,563,6.641946236466672,Hawkish
242,251, 통화신용정책/NNG,493,1.399962486950194,Hawkish
285,282, 예치금/NNG,567,1.467474305491796,Hawkish
11,7, 한은금융망/NNG,18,2.2817570404188228,Hawkish
46,49, 들어간다고/VV,95,1.363127582587868,Hawkish
27,14, 금리/NNG;상단/NNG;제한/NNG,41,2.800338185968555,Hawkish
17,15, 신규/NNG;주택/NNG;판매/NNG;호조/NNG,32,1.645630835211151,Hawkish
18,20, 약하/VA;상승/NNG,38,1.3068244867853258,Hawkish
17,14, 금리/NNG;단기/NNG;상승/NNG,31,1.7631758948690905,Hawkish
429,458, 휴가/NNG,887,1.3600866201623114,Hawkish
10,9, 불안/NNG;점차/MAG;크/VV,19,1.6133635639325008,Hawkish
199,213, 현저/NNG,412,1.356588799531976,Hawkish
197,153, 전강후약/NNG,350,1.869603659380604,Hawkish
108,100, 동인/NNG,208,1.568189384142391,Hawkish
220,204, 성장기여도/NNG,424,1.5659116944050742,Hawkish
29,22, 채발/NNG,51,1.914035864483558,Hawkish
12,6, 순상품교역조건/NNG,18,2.9040544150785017,Hawkish
18,17, 뚜렷히/MAG,35,1.5374405726886184,Hawkish
30,31, 체계적위험/NNG,61,1.405187620199275,Hawkish
14,14, 화약고/NNG,28,1.4520272075392509,Hawkish
63,65, 재매입/NNG,128,1.407349447307274,Hawkish
325,347, 역rp/NNG,672,1.3599678456779725,Hawkish
81,90, 초/NNG,171,1.3068244867853258,Hawkish
17,11, 경험칙/NNG,28,2.244042048015206,Hawkish
74,67, 집약/NNG,141,1.603731542655292,Hawkish
15,7, 튜닝/NNG,22,3.1114868732983947,Hawkish
56,53, 논할/VV,109,1.5342174268339255,Hawkish
51,0, 기자/NNG,51,inf,Hawkish
14,15, 껄끄러운/VA,29,1.3552253937033008,Hawkish
21,23, 맛보/VV,44,1.325763972101055,Hawkish
168,97, 동일등급/NNG,265,2.514851246047362,Hawkish
143,157, 만기구조/NNG,300,1.3225470743828844,Hawkish
361,289, 유효수요/NNG,650,1.8137779305248083,Hawkish
1382,1502, 부채비율/NNG,2884,1.336019707602693,Hawkish
89,58, 경기/NNG;모멘텀/NNG;둔화/NNG,147,2.228110715017126,Hawkish
12,11, 실적/NNG;예상/NNG;양호/NNG,23,1.58402968095191,Hawkish
39,21, 민간/NNG;소비/NNG;개선/NNG,60,2.6966219568586087,Hawkish
22,20, 별다른/VA;모멘텀/NNG,42,1.5972299282931757,Hawkish
25,23, fed/NNG;거품/NNG,48,1.5782904429774465,Hawkish
15,5, 금리/NNG;전고점/NNG,20,4.356081622617752,Hawkish
13,7, 경기/NNG;반등/NNG,20,2.6966219568586087,Hawkish
13,14, 경제/NNG;혼조/NNG,27,1.3483109784293044,Hawkish
26,22, 거품/NNG;억제/NNG,48,1.7160321543645694,Hawkish
25,23, 새롭/VA;거품/NNG,48,1.5782904429774465,Hawkish
20,15, 통화/NNG;줄/VV,35,1.936036276719001,Hawkish
10,9, 지준/NNG;줄/VV,19,1.6133635639325008,Hawkish
21,18, 매섭/VA,39,1.6940317421291258,Hawkish
64,65, 더뎌지/VA,129,1.4296883274232624,Hawkish
86,89, 증시자금/NNG,175,1.403082470206467,Hawkish
263,94, 국민주택/NNG,357,4.062586761519393,Hawkish
42,45, 느껴질/VV,87,1.3552253937033008,Hawkish
59,28, 국주/NNG,87,3.0596287587434214,Hawkish
49,27, 고용/NNG;여건/NNG;개선/NNG,76,2.6351604877564183,Hawkish
20,20, 경기/NNG;여건/NNG;개선/NNG,40,1.4520272075392509,Hawkish
10,11, 금리/NNG;단기/NNG;고점/NNG,21,1.3200247341265916,Hawkish
100,106, 당분간/MAG;금리/NNG;인상/NNG,206,1.3698369882445764,Hawkish
10,6, 회복/NNG;불확실성/NNG,16,2.420045345898751,Hawkish
173,170, 플러스/NNG;성장/NNG,343,1.4776512170840612,Hawkish
13,14, 멈출지/VV,27,1.3483109784293044,Hawkish
42,43, 근로자수/NNG,85,1.4182591329453147,Hawkish
34,31, 타진/VV,65,1.5925459695591786,Hawkish
614,639, 신/NNG,1253,1.3952186313444446,Hawkish
28,9, 은행/NNG;예금/NNG;금리/NNG;인상/NNG,37,4.517417979011002,Hawkish
25,15, 단기/NNG;금리/NNG;상승/NNG;압력/NNG,40,2.4200453458987514,Hawkish
105,112, 단기/NNG;금리/NNG;오르/VV,217,1.3612755070680478,Hawkish
23,17, 심리/NNG;약세/NNG,40,1.9645073984354566,Hawkish
21,16, 금리/NNG;긴축/NNG,37,1.9057857098952666,Hawkish
537,497, 드/NNG,1034,1.5688905642828526,Hawkish
114,104, 잇/NNG,218,1.5916452082641788,Hawkish
121,102, 다가구/NNG,223,1.7225028638455817,Hawkish
191,196, 본드/NNG,387,1.4149856971428414,Hawkish
12,7, 재유/NNG,19,2.489189498638716,Hawkish
18,18, 재입찰/NNG,36,1.4520272075392509,Hawkish
14,6, 단기/NNG;금리/NNG;불안/NNG,20,3.3880634842582515,Hawkish
68,66, 공급/NNG;축소/NNG,134,1.4960280320101373,Hawkish
30,31, 최대/NNG;줄/VV,61,1.405187620199275,Hawkish
10,7, 좋/VA;경기/NNG;회복/NNG,17,2.07432458219893,Hawkish
10,9, 연고점/NNG;넘/VV,19,1.6133635639325008,Hawkish
9,10, 낙폭제한/NNG,19,1.3068244867853258,Hawkish
20,14, 어긋날/VV,34,2.07432458219893,Hawkish
10,10, 하락/NNG;채권/NNG;강세/NNG,20,1.4520272075392509,Hawkish
230,204, 기습/NNG,434,1.637089498696214,Hawkish
45,34, 시소/NNG,79,1.9218007158607728,Hawkish
146,110, 전약후강/NNG,256,1.9272361118248238,Hawkish
819,662, 세제개편안/NNG,1481,1.7963901555508255,Hawkish
14,9, 허무/NNG,23,2.258708989505501,Hawkish
132,100, 테일러준칙/NNG,232,1.916675913951811,Hawkish
80,85, 상한/VV,165,1.3666138423898833,Hawkish
104,99, 평균값/NNG,203,1.525361914990728,Hawkish
100,110, 궤/NNG,210,1.3200247341265916,Hawkish
18,18, 설명력/NNG,36,1.4520272075392509,Hawkish
22,8, 주액/NNG,30,3.9930748207329394,Hawkish
104,106, 징검다리/NNG,210,1.4246304677743593,Hawkish
13,13, 밀린다/VV,26,1.4520272075392509,Hawkish
220,126, 신종/NNG,346,2.5352856004653583,Hawkish
15,6, 채권/NNG;금리/NNG;상승/NNG;압력/NNG;높/VA,21,3.6300680188481267,Hawkish
12,4, 경상/NNG;적자/NNG;줄/VV,16,4.356081622617753,Hawkish
27,20, 대외변수/NNG;불확실성/NNG,47,1.9602367301779884,Hawkish
18,18, 바닥/NNG;회복/NNG,36,1.4520272075392509,Hawkish
100,96, 안정/NNG;상승/NNG,196,1.5125283411867194,Hawkish
77,53, 인상/NNG;어렵/VA,130,2.1095489618966474,Hawkish
414,384, 확장국면/NNG,798,1.5654668331282546,Hawkish
109,87,채권분석/NNG,196,1.819206501399751,Hawkish
80,70, 금리/NNG;과도/NNG,150,1.6594596657591438,Hawkish
48,44, 금리/NNG;인상/NNG;시기상조/NNG,92,1.58402968095191,Hawkish
17,14, 금리/NNG;하단/NNG;지지/NNG,31,1.7631758948690905,Hawkish
12,11, 개살구/NNG,23,1.58402968095191,Hawkish
19,17, 누려온/VV,36,1.622853937837986,Hawkish
46,44, 알린/VV,90,1.5180284442455803,Hawkish
21,23, 질지/NNG,44,1.325763972101055,Hawkish
11,11, 높/VA;않/VX;금리/NNG;인상/NNG,22,1.4520272075392509,Hawkish
17,15, 정책/NNG;효과/NNG;약화/NNG,32,1.645630835211151,Hawkish
87,1, 통안채/NNG;확대/NNG,88,126.32636705591482,Hawkish
24,20, 생산/NNG;회복/NNG,44,1.742432649047101,Hawkish
9,9, 부실/NNG;충격/NNG,18,1.4520272075392509,Hawkish
43,24, 경기/NNG;양호/NNG,67,2.6015487468411576,Hawkish
13,9, 금리/NNG;변동성/NNG;낮/VA,22,2.097372633112251,Hawkish
30,14, 출구전략/NNG;부담/NNG,44,3.1114868732983947,Hawkish
24,24, 금리/NNG;소폭/MAG;인상/NNG,48,1.4520272075392509,Hawkish
10,9, 이익/NNG;작/VA,19,1.6133635639325008,Hawkish
9,8,법칙/NNG,17,1.6335306084816572,Hawkish
143,118, 전술/NNG,261,1.759660090492482,Hawkish
14,7, 겁나/VV,21,2.9040544150785017,Hawkish
8,8, 해진다면/XSV,16,1.4520272075392506,Hawkish
23,24, 금리/NNG;못/MAG;오르/VV,47,1.3915260738917818,Hawkish
9,7, 경제/NNG;인상/NNG,16,1.866892123979037,Hawkish
47,30, 인상/NNG;그치/VV,77,2.274842625144826,Hawkish
12,10, 예상밖/NNG;좋/VA,22,1.742432649047101,Hawkish
14,2, 네모/NNG,16,10.164190452774756,Hawkish
61,67, 상자/NNG,128,1.3219949202969299,Hawkish
38,29, 높/VA;경제/NNG;성장/NNG,67,1.902656340913501,Hawkish
11,5, 채권시장/NNG;나쁘/VA;않/VX,16,3.1944598565863513,Hawkish
12,13, 조임/NNG,25,1.3403328069593086,Hawkish
55,20, 계약수/NNG,75,3.9930748207329394,Hawkish
129,111, 자산군/NNG,240,1.6874910790321023,Hawkish
78,81, 찬스/NNG,159,1.3982484220748341,Hawkish
215,165, 편입비중/NNG,380,1.8920354522481146,Hawkish
22,23, 금리/NNG;인상/NNG;가능성/NNG;높/VA;않/VX,45,1.388895589820153,Hawkish
10,8, 외국인/NNG;채권투자/NNG;늘/VV,18,1.8150340094240636,Hawkish
220,12, 절상/NNG;절하/NNG,232,26.620498804886264,Hawkish
28,22, 개선/NNG;더디/VA,50,1.8480346277772284,Hawkish
28,28, 수그러/VV,56,1.4520272075392509,Hawkish
45,41, 불안/NNG;높/VV,86,1.5936883985186898,Hawkish
20,20, 여전/NNG;금리/NNG;인상/NNG,40,1.4520272075392509,Hawkish
18,19, 미쳤으며/VV,37,1.375604722931922,Hawkish
211,231, 프로그램매도/NNG,442,1.326310566193861,Hawkish
11,5, 휘발/NNG,16,3.1944598565863513,Hawkish
368,325, 지주/NNG,693,1.6441415765367517,Hawkish
405,102, 한경/NNG,507,5.765402147582319,Hawkish
70,9, 산전/NNG,79,11.293544947527508,Hawkish
9,8, 쵸/NNG,17,1.6335306084816572,Hawkish
128,119, 무보/NNG,247,1.5618443913027233,Hawkish
87,79, 증회/NNG,166,1.5990679374166432,Hawkish
761,797, 사채/NNG,1558,1.3864400312890464,Hawkish
831,193, 에스/NNG,1024,6.251992795156049,Hawkish
174,165, 신주/NNG,339,1.5312286915868463,Hawkish
686,585, 주관/NNG,1271,1.7027190843964548,Hawkish
69,62, 양수/NNG,131,1.6159657632291664,Hawkish
15,6, 금리/NNG;채권/NNG;금리/NNG;하락/NNG,21,3.6300680188481267,Hawkish
17,9, 소폭/MAG;금리/NNG;하락/NNG,26,2.7427180586852518,Hawkish
10,7, 물량/NNG;부담/NNG;하락/NNG,17,2.07432458219893,Hawkish
159,107, 나타났으며/VV,266,2.1576852897078584,Hawkish
9,9, 임료/NNG,18,1.4520272075392509,Hawkish
76,67, 우라늄/NNG,143,1.6470756384027323,Hawkish
31,34, 그린/NNG,65,1.3239071598151992,Hawkish
23,13, 탄소세/NNG,36,2.568971213338674,Hawkish
102,76, 등재/NNG,178,1.9487733574868893,Hawkish
33,17, 발행가액/NNG,50,2.8186410499291332,Hawkish
81,82, 사업다각화/NNG,163,1.434319558666821,Hawkish
164,41, 네트웍스/NNG,205,5.808108830157003,Hawkish
14,9, 판매/NNG;예상밖/NNG;감소/NNG,23,2.258708989505501,Hawkish
127,117, 단기/NNG;급등/NNG;부담/NNG,244,1.57613209707252,Hawkish
11,7, 수요/NNG;약화/NNG;우려/NNG,18,2.2817570404188228,Hawkish
29,13, 엇갈림/NNG,42,3.239137616818329,Hawkish
228,193, 무보증사채/NNG,421,1.7153482037251253,Hawkish
25,12, 거래한도/NNG,37,3.025056682373439,Hawkish
8,8, 공자/NNG,16,1.4520272075392506,Hawkish
176,189, 투쟁/NNG,365,1.352152320248191,Hawkish
38,22, 활/NNG,60,2.5080469948405244,Hawkish
21,13, 실성/NNG,34,2.3455824121787896,Hawkish
241,250, 만호/NNG,491,1.399754228067838,Hawkish
224,165, 합/NNG,389,1.97123693629571,Hawkish
19,17, 원유/NNG;원자재/NNG;가격/NNG;하락/NNG,36,1.622853937837986,Hawkish
10,8, 하락/NNG;영향/NNG;약세/NNG,18,1.8150340094240636,Hawkish
78,69, 수요/NNG;감소/NNG;우려/NNG,147,1.6414220606965444,Hawkish
321,334, 재무구조/NNG;개선/NNG,655,1.3955111785032919,Hawkish
13,11, 지수/NNG;강하/VA;상승/NNG,24,1.7160321543645694,Hawkish
22,20, 소비자/NNG;심리/NNG;개선/NNG,42,1.5972299282931757,Hawkish
303,272, 규제안/NNG,575,1.6175156025161508,Hawkish
57,50, 닉스/NNG,107,1.655311016594746,Hawkish
26,25, 휘/NNG,51,1.510108295840821,Hawkish
25,17, 유성/NNG,42,2.1353341287341925,Hawkish
9,9, 부진/NNG;영향/NNG;약세/NNG,18,1.4520272075392509,Hawkish
17,12, 단기물/NNG;불안/NNG,29,2.0570385440139387,Hawkish
34,31, 돌아섬/VV,65,1.5925459695591786,Hawkish
15,7, 간접세/NNG,22,3.1114868732983947,Hawkish
57,43, 사이즈/NNG,100,1.9247802518543555,Hawkish
21,23, 세련/NNG,44,1.325763972101055,Hawkish
24,26, 노련/NNG,50,1.3403328069593086,Hawkish
12,8, 얼핏/MAG,20,2.1780408113088763,Hawkish
130,73, 선생/NNG,203,2.5858018764397617,Hawkish
18,15, 채권팀/NNG,33,1.742432649047101,Hawkish
60,50, 향유/NNG,110,1.742432649047101,Hawkish
187,146, 스케줄/NNG,333,1.8597882726701365,Hawkish
219,191, 수취/NNG,410,1.6648898348224919,Hawkish
25,24, 올지/VV,49,1.5125283411867194,Hawkish
27,8, 하락주/NNG,35,4.900591825444971,Hawkish
924,70, 등급별/NNG,994,19.166759139518113,Hawkish
194,29, 에프/NNG,223,9.713561319400506,Hawkish
100,63, 코퍼레이션/NNG,163,2.304805091332144,Hawkish
190,16, 등급간/NNG,206,17.242823089528606,Hawkish
118,37, 열위/NNG,155,4.630789472692745,Hawkish
301,77, 케이/XSV,378,5.676106356744343,Hawkish
145,4, 브로드밴드/NNG,149,52.63598627329784,Hawkish
33,10, 지브/NNG,43,4.791689784879527,Hawkish
331,37, 스리/NNG,368,12.989756910688973,Hawkish
40,40, 테일/NNG,80,1.4520272075392509,Hawkish
712,774, 홀딩스/NNG,1486,1.335714950604582,Hawkish
143,85, 모스/NNG,228,2.442822243271916,Hawkish
79,13, 여천/NNG,92,8.823857645815448,Hawkish
10,8, 이오/NNG,18,1.8150340094240636,Hawkish
20,14, 에스티/NNG,34,2.07432458219893,Hawkish
18,11, 경기/NNG;선행/NNG;지수/NNG;꺾/VV,29,2.376044521427865,Hawkish
50,51, 금리/NNG;오르/VV;쉽/VA;않/VX,101,1.423556085822795,Hawkish
43,45, 기업/NNG;이익/NNG;모멘텀/NNG,88,1.3874926649819508,Hawkish
10,10, 막대/NNG;경상/NNG;흑자/NNG,20,1.4520272075392509,Hawkish
137,141, 금리/NNG;인상/NNG;반대/NNG,278,1.4108349463324634,Hawkish
18,10, 하락/NNG;금리/NNG;하락/NNG,28,2.6136489735706516,Hawkish
13,10, 미/NNG;경상/NNG;적자/NNG,23,1.887635369801026,Hawkish
62,45, 출구전략/NNG;시기상조/NNG,107,2.000570819276301,Hawkish
19,21, 신용경색/NNG;위험/NNG,40,1.3137389020593222,Hawkish
12,13, 부실채권/NNG;우려/NNG,25,1.3403328069593086,Hawkish
16,15, 부동산/NNG;타격/NNG,31,1.5488290213752007,Hawkish
24,15, 불확실성/NNG;낮/VA,39,2.3232435320628015,Hawkish
38,3, 구차/NNG,41,18.39234462883051,Hawkish
14,9, 미확정/NNG,23,2.258708989505501,Hawkish
19,6, 재무약정/NNG,25,4.598086157207628,Hawkish
74,70, 공급계약/NNG,144,1.5350001908272082,Hawkish
63,49, 조회공시/NNG,112,1.8668921239790368,Hawkish
15,6, 구/VV,21,3.6300680188481267,Hawkish
137,151, 화려/NNG,288,1.3174021684296513,Hawkish
14,3, 펀더멘털/NNG;불확실성/NNG,17,6.776126968516503,Hawkish
36,37, 윈도/NNG,73,1.412783228957109,Hawkish
32,19, 만대/NNG,51,2.4455195074345277,Hawkish
117,115, 출혈/NNG,232,1.47727985462689,Hawkish
542,421, 뉴/NNG,963,1.8693556923664465,Hawkish
29,24, 중추절/NNG,53,1.7545328757765946,Hawkish
59,62, 액정/NNG,121,1.381767826529287,Hawkish
166,118, 신종플루/NNG,284,2.0426823428094547,Hawkish
23,18, 컨센서스/NNG;낮/VA,41,1.855368098522376,Hawkish
146,160, 국유/NNG,306,1.3249748268795665,Hawkish
45,41, 틴/NNG,86,1.5936883985186898,Hawkish
232,212, 텍/NNG,444,1.5890109063637086,Hawkish
57,54, 매직/NNG,111,1.5326953857358756,Hawkish
168,150, 예정일/NNG,318,1.626270472443961,Hawkish
13,4, 금리/NNG;인상/NNG;경기/NNG;회복/NNG;자신/NNG,17,4.719088424502566,Hawkish
47,49, 기업/NNG;실적/NNG;긍정적/VAX,96,1.3927607909049955,Hawkish
221,235, 세계/NNG;경기/NNG;회복/NNG,456,1.3655234590049976,Hawkish
31,27, 부진/NNG;강세/NNG,58,1.6671423493969175,Hawkish
37,38, 하락/NNG;경계/NNG,75,1.4138159652355864,Hawkish
1045,295, 발행금액/NNG,1340,5.143621802978024,Hawkish
49,50, 심상찮/VA,99,1.422986663388466,Hawkish
10,9, 테이크/NNG,19,1.6133635639325008,Hawkish
95,68, 일반공모/NNG,163,2.0285674222974825,Hawkish
10,11, 결/VV,21,1.3200247341265916,Hawkish
29,17, 발행주식수/NNG,46,2.476987589331663,Hawkish
31,20, 발행가/NNG,51,2.250642171685839,Hawkish
45,49, 주요주주/NNG,94,1.3334943742707404,Hawkish
54,54, 요금/NNG;인하/NNG,108,1.4520272075392506,Hawkish
25,27, 자기주식/NNG,52,1.3444696366104174,Hawkish
14,13, 채권시장/NNG;약세/NNG;금리/NNG;상승/NNG,27,1.5637216081191931,Hawkish
139,11, 제이차/NNG,150,18.348343804359626,Hawkish
123,133, 케이/NNG,256,1.3428522295287808,Hawkish
124,40, 제일차/NNG,164,4.501284343371678,Hawkish
18,19, 분할매각/NNG,37,1.375604722931922,Hawkish
33,35, 램/NNG,68,1.3690542242512935,Hawkish
39,30, 율/NNG,69,1.887635369801026,Hawkish
41,42, 베리/NNG,83,1.4174551311692687,Hawkish
18,3, 티비/NNG,21,8.712163245235505,Hawkish
325,351, 실적/NNG;호전/NNG,676,1.3444696366104174,Hawkish
14,9, 부동산/NNG;가격/NNG;상승/NNG;둔화/NNG,23,2.258708989505501,Hawkish
47,30, 통화정책/NNG;불확실성/NNG;해소/NNG,77,2.274842625144826,Hawkish
38,34, 훗날/NNG,72,1.622853937837986,Hawkish
68,44, 인플레이션/NNG;막/VV,112,2.244042048015206,Hawkish
13,14, 엔딩/NNG,27,1.3483109784293044,Hawkish
120,132, 어조/NNG,252,1.3200247341265916,Hawkish
92,52, 내재변동성/NNG,144,2.568971213338674,Hawkish
24,20, 주택가격/NNG;상승/NNG;둔화/NNG,44,1.742432649047101,Hawkish
34,37, 주택담보대출/NNG;감소/NNG,71,1.3342952717928251,Hawkish
10,7, 금융시장/NNG;적잖/VA,17,2.07432458219893,Hawkish
255,213, 선순위/NNG,468,1.7383424315610747,Hawkish
17,10, 물적분할/NNG,27,2.4684462528167264,Hawkish
34,18, 발전자/NNG,52,2.7427180586852518,Hawkish
192,204, 바뀐다/VV,396,1.366613842389883,Hawkish
64,65, 진퇴양난/NNG,129,1.4296883274232624,Hawkish
68,75, 국제에너지기구/NNG,143,1.3165046681689208,Hawkish
32,7, 자본잉여금/NNG,39,6.637838663036575,Hawkish
90,91, 미주/NNG,181,1.436070864599259,Hawkish
17,17, 사모전환사채/NNG,34,1.4520272075392509,Hawkish
25,16, 변경상장/NNG,41,2.2687925117800796,Hawkish
120,134, 주권/NNG,254,1.3003228724232097,Hawkish
20,6, 원유/NNG;수요/NNG;전망/NNG;상향/NNG,26,4.840090691797502,Hawkish
33,35, 재무/NNG;건전성/NNG;개선/NNG,68,1.3690542242512935,Hawkish
73,69, 신용등급/NNG;안정/NNG,142,1.5362026978313814,Hawkish
145,145, 등가격/NNG,290,1.4520272075392506,Hawkish
52,41, 금리/NNG;하락/NNG;되돌/VV,93,1.8415954827327083,Hawkish
21,14, 중장기물/NNG;강세/NNG,35,2.1780408113088763,Hawkish
11,9, 중외/NNG,20,1.774699920325751,Hawkish
230,234, 주간사/NNG,464,1.427206229632597,Hawkish
137,151, 고속/NNG;성장/NNG,288,1.3174021684296513,Hawkish
19,15, 하락/NNG;급등/NNG,34,1.839234462883051,Hawkish
149,139, 만선/NNG,288,1.5564895965708514,Hawkish
19,19, 리뉴얼/NNG,38,1.4520272075392509,Hawkish
22,20, 우시/NNG,42,1.5972299282931757,Hawkish
31,17, 무역/NNG;호조/NNG,48,2.6478143196303985,Hawkish
292,325, 마/NNG,617,1.304590598773727,Hawkish
15,12, 주식취득/NNG,27,1.8150340094240633,Hawkish
67,4, 피에스/NNG,71,24.321455726282448,Hawkish
15,10, 앤지/NNG,25,2.178040811308876,Hawkish
40,43, 내비게이션/NNG,83,1.3507229837574426,Hawkish
18,7, 산자/NNG,25,3.733784247958074,Hawkish
22,7, 인적분할/NNG,29,4.5635140808376455,Hawkish
18,13, 신용등급채권/NNG,31,2.010499210438963,Hawkish
64,1, 등급물/NNG,65,92.92974128251204,Hawkish
17,14, 기업/NNG;재무구조/NNG;개선/NNG,31,1.7631758948690905,Hawkish
23,4, 경기/NNG;모멘텀/NNG;상승/NNG,27,8.349156443350692,Hawkish
21,22, 당분간/MAG;금리/NNG;상승/NNG,43,1.3860259708329212,Hawkish
19,8, 상승률/NNG;기저효과/NNG,27,3.448564617905721,Hawkish
226,232, 드림/VV,458,1.4144747797580632,Hawkish
400,420, 채산성/NNG,820,1.3828830547992865,Hawkish
49,32, 휴대/NNG,81,2.223416661544478,Hawkish
28,27, 공주/NNG,55,1.5058059930036674,Hawkish
121,129, 적자전환/NNG,250,1.3619790086220878,Hawkish
69,59, 통화선물/NNG,128,1.6981335139018359,Hawkish
24,26, 마이너스/NNG;확대/NNG,50,1.3403328069593086,Hawkish
61,62, 과격/NNG,123,1.428607413869263,Hawkish
368,346, 핫머니/NNG,714,1.5443526369203593,Hawkish
9,9, 장대비/NNG,18,1.4520272075392509,Hawkish
42,41, 곰/NNG,83,1.4874425052841107,Hawkish
60,65, 홈런/NNG,125,1.3403328069593086,Hawkish
50,7, 외평/NNG,57,10.371622910994649,Hawkish
216,225, 폭풍/NNG,441,1.3939461192376807,Hawkish
28,21, 예상/NNG;달리/MAG;금리/NNG;인상/NNG,49,1.9360362767190011,Hawkish
18,20, 촉/NNG,38,1.3068244867853258,Hawkish
12,10, 실험장/NNG,22,1.742432649047101,Hawkish
10,10, 고밀도/NNG,20,1.4520272075392509,Hawkish
1613,1780, 투자의견/NNG,3393,1.3157976886296696,Hawkish
72,79, 소프트/NNG,151,1.3233665688965326,Hawkish
65,38, 대여금/NNG,103,2.483730749738192,Hawkish
18,18, 금리/NNG;급등/NNG;되돌/VV,36,1.4520272075392509,Hawkish
12,12, 하항/NNG,24,1.4520272075392509,Hawkish
11,11, 화물기/NNG,22,1.4520272075392509,Hawkish
26,19, 미터/NNG,45,1.9869845997905538,Hawkish
61,35, 주식수/NNG,96,2.5306759902826945,Hawkish
193,207, 사옥/NNG,400,1.3538224688650984,Hawkish
17,18, 회복/NNG;기대/NNG;높/VA,35,1.3713590293426259,Hawkish
37,33, 고용없는성장/NNG,70,1.6280305054227964,Hawkish
51,54, 의약/NNG,105,1.3713590293426257,Hawkish
166,159, 턴/XSV,325,1.515952933657331,Hawkish
11,7, 성연/NNG,18,2.2817570404188228,Hawkish
20,16, 유동화전문회사/NNG,36,1.8150340094240636,Hawkish
43,43, 투기거래/NNG,86,1.4520272075392506,Hawkish
39,37, 우회상장/NNG,76,1.5305151647035347,Hawkish
141,116, 국제/NNG;원자재/NNG;가격/NNG;상승/NNG,257,1.7649641057158134,Hawkish
81,83, 인플레이션/NNG;압력/NNG;증가/NNG,164,1.4170386001286663,Hawkish
107,72, 외환규제/NNG,179,2.15787376675972,Hawkish
362,362, 물류/NNG,724,1.4520272075392509,Hawkish
209,226, 대여/NNG,435,1.3428039220163868,Hawkish
100,82, 승모/NNG,182,1.7707648872429889,Hawkish
60,62, 오래갈/VV,122,1.405187620199275,Hawkish
105,92, 수입품/NNG,197,1.6572049651263188,Hawkish
18,0, 출순/NNG,18,inf,Hawkish
17,6, 고정자본/NNG,23,4.114077088027877,Hawkish
21,20, 당첨금/NNG,41,1.5246285679162133,Hawkish
14,7, 경기/NNG;선행/NNG;지수/NNG;고점/NNG,21,2.9040544150785017,Hawkish
23,24, 경상/NNG;수지/NNG;흑자/NNG;축소/NNG,47,1.3915260738917818,Hawkish
9,10, 외국인/NNG;수급/NNG;불안/NNG,19,1.3068244867853258,Hawkish
14,9, 국고채/NNG;금리/NNG;고점/NNG,23,2.258708989505501,Hawkish
11,11, 대출태도/NNG;강화/NNG,22,1.4520272075392509,Hawkish
19,20, 여력/NNG;한계/NNG,39,1.3794258471622882,Hawkish
451,25, 저작권/NNG,476,26.194570824008085,Hawkish
10,11, 대본/NNG,21,1.3200247341265916,Hawkish
34,30, 비트/NNG,64,1.645630835211151,Hawkish
23,24,는/VV,47,1.3915260738917818,Hawkish
19,20, 죈다/VV,39,1.3794258471622882,Hawkish
18,13, 한국신용정보/NNG,31,2.010499210438963,Hawkish
17,10, 소비/NNG;심리/NNG;약화/NNG,27,2.4684462528167264,Hawkish
13,11, 주택가격/NNG;지수/NNG;상승/NNG,24,1.7160321543645694,Hawkish
21,21, 쌍둥이/NNG,42,1.4520272075392509,Hawkish
70,46, 유형자산/NNG,116,2.2096066201684255,Hawkish
47,38, 데드크로스/NNG,85,1.7959283882722312,Hawkish
197,192, 고르/VA,389,1.4898404160689187,Hawkish
18,7, 국채/NNG;매입/NNG;종료/NNG,25,3.733784247958074,Hawkish
52,35, 호조/NNG;상승/NNG,87,2.157297565486887,Hawkish
38,37, 수대/NNG,75,1.4912711861213928,Hawkish
20,20, 소비/NNG;약화/NNG,40,1.4520272075392509,Hawkish
16,15, 경제/NNG;견조/NNG;회복/NNG,31,1.5488290213752007,Hawkish
12,8, 증후/NNG,20,2.1780408113088763,Hawkish
116,81, 분식회계/NNG,197,2.079446371290779,Hawkish
21,20, 판다/NNG,41,1.5246285679162133,Hawkish
21,9, 전분/NNG,30,3.3880634842582515,Hawkish
38,41, 소비자/NNG;신뢰지수/NNG;하락/NNG,79,1.3457813143046715,Hawkish
14,15, 매출/NNG;순이익/NNG;증가/NNG,29,1.3552253937033008,Hawkish
15,15, 원유/NNG;증산/NNG,30,1.4520272075392506,Hawkish
30,20, 인수기업/NNG,50,2.178040811308876,Hawkish
28,25, 경기/NNG;회복/NNG;기대/NNG;상승/NNG,53,1.626270472443961,Hawkish
12,13, 고용/NNG;호전/NNG,25,1.3403328069593086,Hawkish
31,30, 코끼리/NNG,61,1.5004281144572258,Hawkish
71,55, 흑자국/NNG,126,1.8744351224597602,Hawkish
3269,759, 트레이드/NNG,4028,6.25385631284033,Hawkish
540,574, 투자대상/NNG,1114,1.366018627301734,Hawkish
16,4, 만/VA,20,5.8081088301570025,Hawkish
401,436, 서브프라임사태/NNG,837,1.3354653904202742,Hawkish
152,123, 로컬/NNG,275,1.794375085739562,Hawkish
16,12, 흘렸/VV,28,1.9360362767190007,Hawkish
15,11, 놀래켰/VV,26,1.9800371011898874,Hawkish
21,23, 한데/NNG,44,1.325763972101055,Hawkish
10,7, 트릴레마/NNG,17,2.07432458219893,Hawkish
14,14, 강약/NNG,28,1.4520272075392509,Hawkish
47,40, 트위스트/NNG,87,1.7061319688586194,Hawkish
13,12, fed/NNG;금리/NNG;인상/NNG;아니/VCN,25,1.5730294748341882,Hawkish
17,14, 금리/NNG;오르/VV;가능성/NNG;낮/VA,31,1.7631758948690905,Hawkish
17,6, 글로벌/NNG;경제/NNG;이중침체/NNG,23,4.114077088027877,Hawkish
19,14, 경기/NNG;불확실성/NNG;우려/NNG,33,1.9706083530889835,Hawkish
9,8, 아무래도/MAG;금리/NNG;인상/NNG,17,1.6335306084816572,Hawkish
21,19, 미/NNG;금리갭/NNG;축소/NNG,40,1.604872176753909,Hawkish
21,14, 미/NNG;경제/NNG;강하/VA,35,2.1780408113088763,Hawkish
28,20, 약하/VA;지지/NNG;않/VX,48,2.032838090554951,Hawkish
13,14, 경제/NNG;작/VV;않/VX,27,1.3483109784293044,Hawkish
22,20, 채권시장/NNG;이탈/NNG,42,1.5972299282931757,Hawkish
11,8, 펀더멘털/NNG;자신/NNG,19,1.9965374103664697,Hawkish
14,11, 양호/NNG;회복/NNG,25,1.8480346277772284,Hawkish
17,14, 전망/NNG;둔화/NNG,31,1.7631758948690905,Hawkish
18,12, 낮/VA;고금리/NNG,30,2.1780408113088763,Hawkish
63,58, 투자/NNG;축소/NNG,121,1.577201966809876,Hawkish
329,62, 하비/NNG,391,7.705112117426024,Hawkish
182,189, 투자회사/NNG,371,1.398248422074834,Hawkish
14,7, 시중/NNG;유동성/NNG;축소/NNG,21,2.9040544150785017,Hawkish
25,24, 경제낙관론/NNG,49,1.5125283411867194,Hawkish
13,13, 웨이브/NNG,26,1.4520272075392509,Hawkish
101,74, 부동산임대업/NNG,175,1.9818209183981665,Hawkish
12,6, 체스/NNG,18,2.9040544150785017,Hawkish
19,15, 영업이익/NNG;흑자전환/NNG,34,1.839234462883051,Hawkish
63,56, 감축안/NNG,119,1.6335306084816572,Hawkish
36,23, 준정부기관/NNG,59,2.272738237887523,Hawkish
106,116, 퀄컴/NNG,222,1.3268524482686257,Hawkish
58,61, 열람/NNG,119,1.3806160333979762,Hawkish
26,25, 자산/NNG;거품/NNG;위험/NNG,51,1.510108295840821,Hawkish
21,8, 가격효과/NNG,29,3.8115714197905333,Hawkish
19,6, 경제/NNG;활동/NNG;활성화/NNG,25,4.598086157207628,Hawkish
159,1, 자기자본비율/NNG,160,230.87232599874088,Hawkish
11,9, 지존/NNG,20,1.774699920325751,Hawkish
35,38, 낯설/VA,73,1.3373934806282575,Hawkish
9,10, 변화무쌍/NNG,19,1.3068244867853258,Hawkish
24,26, 대외/NNG;경제/NNG;불확실성/NNG,50,1.3403328069593086,Hawkish
22,15, 점차/MAG;금리/NNG;인상/NNG,37,2.129639904390901,Hawkish
183,199, 금리/NNG;인상/NNG;부담/NNG,382,1.3352813014054417,Hawkish
11,6, 인상/NNG;불가능/NNG,17,2.662049880488626,Hawkish
45,41, 경기/NNG;고점/NNG,86,1.5936883985186898,Hawkish
400,231, 긴축/NNG;우려/NNG,631,2.5143328269077934,Hawkish
156,162, 재량/NNG,318,1.3982484220748341,Hawkish
11,12, 높/VA;매파/NNG,23,1.331024940244313,Hawkish
23,23, 금괴/NNG,46,1.4520272075392506,Hawkish
79,76, 적대적/VAX,155,1.5093440709947477,Hawkish
61,0, 화유/NNG,61,inf,Hawkish
11,10, 동성/NNG,21,1.5972299282931757,Hawkish
41,20, 열대성/NNG,61,2.976655775455464,Hawkish
76,79, 광/NNG,155,1.3968869338352288,Hawkish
14,4, 긍정적/VAX;상향/NNG,18,5.082095226387378,Hawkish
102,88, 시장지위/NNG,190,1.6830315360114045,Hawkish
85,83, 교환사채/NNG,168,1.4870158149498351,Hawkish
247,256, 귀금속/NNG,503,1.400979376024199,Hawkish
64,71, 원유/NNG;수요/NNG;증가/NNG,135,1.3088695955283385,Hawkish
110,121, 실업률/NNG;오르/VV,231,1.3200247341265918,Hawkish
44,36, 재향/NNG,80,1.774699920325751,Hawkish
165,184, 일제/NNG,349,1.3020896154563935,Hawkish
239,32, 계열회사/NNG,271,10.84482820630878,Hawkish
14,15, 무상감자/NNG,29,1.3552253937033008,Hawkish
13,10, 경제/NNG;완연/NNG;회복/NNG,23,1.887635369801026,Hawkish
23,24, 신규/NNG;대출/NNG;증가/NNG,47,1.3915260738917818,Hawkish
29,32, 수주/NNG;확대/NNG,61,1.315899656832446,Hawkish
114,84, 유료/NNG,198,1.970608353088983,Hawkish
18,11, 대토/NNG,29,2.376044521427865,Hawkish
44,44, 합작사/NNG,88,1.4520272075392509,Hawkish
15,12, 얼른/MAG,27,1.8150340094240633,Hawkish
67,72, 콤/NNG,139,1.3511919847934692,Hawkish
11,8, 일신상/NNG,19,1.9965374103664697,Hawkish
14,15, 장하성펀드/NNG,29,1.3552253937033008,Hawkish
132,145, 이중침체/NNG;우려/NNG,277,1.3218454578978005,Hawkish
36,2, 단함/NNG,38,26.136489735706515,Hawkish
10,10, 면피/NNG,20,1.4520272075392509,Hawkish
84,71, 금리/NNG;인상/NNG;긴축/NNG,155,1.7178913441309445,Hawkish
13,9, 경기/NNG;견조/NNG;회복/NNG,22,2.097372633112251,Hawkish
565,525, 곡선/NNG,1090,1.5626578519231935,Hawkish
27,17, 노후차/NNG,44,2.3061608590329277,Hawkish
81,68, 기업/NNG;실적/NNG;호전/NNG,149,1.7296206442746958,Hawkish
43,43, 골라야/VV,86,1.4520272075392506,Hawkish
49,45, 추출/NNG,94,1.581096292653851,Hawkish
1144,1243, 순유입/NNG,2387,1.336379022867983,Hawkish
11,8, 소매/NNG;판매/NNG;개선/NNG,19,1.9965374103664697,Hawkish
43,4, 차유/NNG,47,15.609292481046946,Hawkish
74,82, 보증인/NNG,156,1.3103660165598119,Hawkish
35,23, 물류센터/NNG,58,2.2096066201684255,Hawkish
40,2, 치전/NNG,42,29.040544150785017,Hawkish
11,10, 그랜드바겐/NNG,21,1.5972299282931757,Hawkish
34,34, 주주배정/NNG,68,1.4520272075392509,Hawkish
36,27, 실권주/NNG,63,1.9360362767190011,Hawkish
52,52, 성원/NNG,104,1.4520272075392509,Hawkish
15,11, 무기명식/NNG,26,1.9800371011898874,Hawkish
61,60, 행사가격/NNG,121,1.4762276609982383,Hawkish
15,15, 부진/NNG;영향/NNG;하락/NNG,30,1.4520272075392506,Hawkish
14,7, 핵폐기/NNG,21,2.9040544150785017,Hawkish
33,32, 금형/NNG,65,1.4974030577748523,Hawkish
149,161, 인민/NNG,310,1.3438015771636544,Hawkish
51,56, 대항/NNG,107,1.3223819211518177,Hawkish
135,133, 동발/NNG,268,1.4738622031413446,Hawkish
18,18, 전과/NNG,36,1.4520272075392509,Hawkish
36,14, 하역/NNG,50,3.733784247958074,Hawkish
11,11, 자금난/NNG;우려/NNG,22,1.4520272075392509,Hawkish
129,128, 평평/NNG,257,1.4633711700981513,Hawkish
9,8, 시설공사/NNG,17,1.6335306084816572,Hawkish
26,24, 우려/NNG;위험/NNG,50,1.5730294748341882,Hawkish
126,128, 수축/NNG,254,1.4293392824214501,Hawkish
9,9, 가품/NNG,18,1.4520272075392509,Hawkish
13,5, 기모/NNG,18,3.775270739602052,Hawkish
30,20, 보수화/NNG,50,2.178040811308876,Hawkish
74,0, 과/VV,74,inf,Hawkish
224,191, 가중치/NNG,415,1.7029010182659277,Hawkish
10,8, 불대/NNG,18,1.8150340094240636,Hawkish
79,40, 각사/NNG,119,2.8677537348900204,Hawkish
13,3, 포루/NNG,16,6.292117899336753,Hawkish
38,42, 편입비/NNG,80,1.3137389020593222,Hawkish
112,80, 해외부문/NNG,192,2.032838090554951,Hawkish
43,44, 국제/NNG;원자재/NNG;가격/NNG;급등/NNG,87,1.419026589186086,Hawkish
15,2, 금리/NNG;상승/NNG;요인/NNG;우세/NNG,17,10.89020405654438,Hawkish
65,48, 채권/NNG;금리/NNG;상승/NNG;압력/NNG,113,1.9662868435427352,Hawkish
157,134, 금리/NNG;인상/NNG;금리/NNG;인상/NNG,291,1.7012557580870327,Hawkish
10,7, 완만/NNG;속도/NNG;금리/NNG;인상/NNG,17,2.07432458219893,Hawkish
14,10, 우려/NNG;채권/NNG;금리/NNG;상승/NNG,24,2.032838090554951,Hawkish
10,8, 경기/NNG;이중침체/NNG;우려/NNG,18,1.8150340094240636,Hawkish
19,19, 금리/NNG;인상/NNG;부작용/NNG,38,1.4520272075392509,Hawkish
28,18, 원자재/NNG;수요/NNG;증가/NNG,46,2.258708989505501,Hawkish
19,11, 금리/NNG;상승/NNG;모멘텀/NNG,30,2.5080469948405244,Hawkish
12,9, 자금/NNG;유입/NNG;급증/NNG,21,1.9360362767190011,Hawkish
28,16, 경기/NNG;수축/NNG,44,2.541047613193689,Hawkish
20,22, 투자/NNG;작/VV,42,1.3200247341265916,Hawkish
10,9, 응당/MAG,19,1.6133635639325008,Hawkish
112,124, 포화/NNG,236,1.3115084455193233,Hawkish
21,14, 파란색/NNG,35,2.1780408113088763,Hawkish
9,7, 가계/NNG;부채/NNG;매우/MAG;높/VA,16,1.866892123979037,Hawkish
10,9, 부동산/NNG;가격/NNG;회복/NNG,19,1.6133635639325008,Hawkish
22,15, 개선/NNG;쉽/VA;않/VX,37,2.129639904390901,Hawkish
15,3, 실업률/NNG;고점/NNG,18,7.260136037696253,Hawkish
390,428, 완충/NNG,818,1.3231089040661397,Hawkish
79,66, 기시/NNG,145,1.7380325666000123,Hawkish
15,16, 순채권국/NNG,31,1.3612755070680476,Hawkish
26,22, 동급/NNG,48,1.7160321543645694,Hawkish
22,1, 소취/NNG,23,31.944598565863515,Hawkish
40,41, 인플레이션/NNG;우려/NNG;금리/NNG;인상/NNG,81,1.416611909794391,Hawkish
20,16, 원자재/NNG;강세/NNG,36,1.8150340094240636,Hawkish
10,8, 가계/NNG;위험/NNG,18,1.8150340094240636,Hawkish
52,32, 경제공작회의/NNG,84,2.359544212251283,Hawkish
15,14, 기명식/NNG,29,1.5557434366491973,Hawkish
23,9, 통화/NNG;완화/NNG;축소/NNG,32,3.710736197044752,Hawkish
143,153, 물가/NNG;억제/NNG,296,1.3571234684843978,Hawkish
14,14, 투지/NNG,28,1.4520272075392509,Hawkish
28,17, 국민주/NNG,45,2.3915742241822953,Hawkish
76,58, 상용화/NNG,134,1.902656340913501,Hawkish
11,11, 하락/NNG;증시/NNG;상승/NNG,22,1.4520272075392509,Hawkish
15,9, 권단/NNG,24,2.420045345898751,Hawkish
71,62, 선박펀드/NNG,133,1.6628053505691422,Hawkish
15,4, 금리/NNG;채권/NNG;금리/NNG;상승/NNG,19,5.44510202827219,Hawkish
110,19, 채권분석/NNG,129,8.40647330680619,Hawkish
36,35, 누수/NNG,71,1.4935136991832296,Hawkish
56,50, 어울리/VV,106,1.626270472443961,Hawkish
21,15, 병존/NNG,36,2.032838090554951,Hawkish
11,11, 살핀다/VV,22,1.4520272075392509,Hawkish
33,30, 조세부담/NNG,63,1.5972299282931757,Hawkish
333,341, 절/NNG,674,1.4179620531101773,Hawkish
87,94, 부담액/NNG,181,1.3438975218714342,Hawkish
15,11, 실효금리/NNG,26,1.9800371011898874,Hawkish
21,20, 얼추/MAG,41,1.5246285679162133,Hawkish
30,27, 뜯/VV,57,1.6133635639325008,Hawkish
42,41, 부풀려/VV,83,1.4874425052841107,Hawkish
15,4, 조/VV,19,5.44510202827219,Hawkish
29,22, 장기추세선/NNG,51,1.914035864483558,Hawkish
31,25, 반대편/NNG,56,1.8005137373486713,Hawkish
15,12, 거릴/XSV,27,1.8150340094240633,Hawkish
11,11, 인/VV,22,1.4520272075392509,Hawkish
22,23, 옮겨야/VV,45,1.388895589820153,Hawkish
183,192, 확고히/MAG,375,1.3839634321858483,Hawkish
13,12, 그래왔/VV,25,1.5730294748341882,Hawkish
652,615, 폴/NNG,1267,1.5393849419765717,Hawkish
8,8, 가계/NNG;재무/NNG;건전성/NNG;악화/NNG,16,1.4520272075392506,Hawkish
14,11, 이중침체/NNG;우려/NNG;완화/NNG,25,1.8480346277772284,Hawkish
18,14, 경제/NNG;이중침체/NNG;빠지/VV,32,1.866892123979037,Hawkish
15,4, 노동/NNG;생산성/NNG;증가/NNG,19,5.44510202827219,Hawkish
96,107, fed/NNG;경기/NNG;회복/NNG,203,1.3027533824651223,Hawkish
14,9, 불안/NNG;금리/NNG;상승/NNG,23,2.258708989505501,Hawkish
9,9, 통화/NNG;강세/NNG;압력/NNG,18,1.4520272075392509,Hawkish
29,28, 저축률/NNG;하락/NNG,57,1.503885322094224,Hawkish
43,46, 고유가/NNG;부담/NNG,89,1.357329780960604,Hawkish
18,16, 민간/NNG;성장/NNG,34,1.6335306084816572,Hawkish
18,18, 공급/NNG;위축/NNG,36,1.4520272075392509,Hawkish
8,8, 자산/NNG;상승/NNG,16,1.4520272075392506,Hawkish
66,63, 절상/NNG;추세/NNG,129,1.521171360279215,Hawkish
275,278, 물가/NNG;급등/NNG,553,1.4363578491845106,Hawkish
9,10, 회복/NNG;힘들/VA,19,1.3068244867853258,Hawkish
43,48, 하락/NNG;없/VA,91,1.3007743734205788,Hawkish
8,8, 가계/NNG;많/VA,16,1.4520272075392506,Hawkish
92,96, 물가/NNG;높/VA,188,1.3915260738917818,Hawkish
469,409, 기대수익률/NNG,878,1.6650385338286275,Hawkish
62,1, 시채/NNG,63,90.02568686743355,Hawkish
91,86, 균형재정/NNG,177,1.5364473940240908,Hawkish
13,13, 증기/NNG,26,1.4520272075392509,Hawkish
491,527, 시현/NNG,1018,1.352837493172243,Hawkish
38,37, 행실/NNG,75,1.4912711861213928,Hawkish
17,14, 출하비율/NNG,31,1.7631758948690905,Hawkish
64,42, 경기선/NNG,106,2.212612887678858,Hawkish
85,65, 제지/NNG,150,1.8988048098590204,Hawkish
9,7, 자금/NNG;유입/NNG;가능성/NNG;높/VA,16,1.866892123979037,Hawkish
63,68, 통화정책/NNG;금리/NNG;인상/NNG,131,1.3452605011025411,Hawkish
13,11, 선진국/NNG;수요/NNG;회복/NNG,24,1.7160321543645694,Hawkish
107,75, 글로벌/NNG;금리/NNG;인상/NNG,182,2.0715588160893312,Hawkish
30,29, 금리/NNG;상승/NNG;작/VA,59,1.5020971112475008,Hawkish
9,10, 투자수익률/NNG;상승/NNG,19,1.3068244867853258,Hawkish
13,6, 기대수익률/NNG;높/VV,19,3.1460589496683764,Hawkish
120,131, 성장/NNG;추세/NNG,251,1.3301012588145809,Hawkish
16,15, 소득/NNG;향상/NNG,31,1.5488290213752007,Hawkish
21,20, 관용/NNG,41,1.5246285679162133,Hawkish
34,13, 오보/NNG,47,3.797609619718041,Hawkish
20,16, 인수설/NNG,36,1.8150340094240636,Hawkish
34,30, 위기/NNG;완화/NNG,64,1.645630835211151,Hawkish
53,45, 재보/NNG,98,1.710165377768451,Hawkish
9,10, 각가/MAG,19,1.3068244867853258,Hawkish
279,18, 인니/NNG,297,22.506421716858384,Hawkish
19,13, 사모투자전문회사/NNG,32,2.122193611018905,Hawkish
45,35, 손자/NNG,80,1.8668921239790368,Hawkish
83,79, 투자심리/NNG;약화/NNG,162,1.525547572477947,Hawkish
35,23, 월말효과/NNG,58,2.2096066201684255,Hawkish
168,128, 프리/NNG,296,1.9057857098952666,Hawkish
20,20, 한림/NNG,40,1.4520272075392509,Hawkish
25,1, 국고채/NNG;수급/NNG;호조/NNG,26,36.30068018848127,Hawkish
62,68, 백금/NNG,130,1.3239071598151992,Hawkish
68,38, 원자로/NNG,106,2.598364476649186,Hawkish
25,25, 석권/NNG,50,1.4520272075392509,Hawkish
23,24, 세종시수정안/NNG,47,1.3915260738917818,Hawkish
22,18, 비농업/NNG;고용/NNG;줄/VV,40,1.774699920325751,Hawkish
30,25, 쌀쌀/NNG,55,1.742432649047101,Hawkish
75,45, 경제활동인구/NNG,120,2.4200453458987514,Hawkish
167,146, 특정금전신탁/NNG,313,1.660880436020924,Hawkish
27,12, 익일환매제/NNG,39,3.267061216963314,Hawkish
126,137, 예측가능성/NNG,263,1.3354410813864643,Hawkish
20,14, 전망/NNG;금리/NNG;하락/NNG,34,2.07432458219893,Hawkish
14,13, 자금/NNG;이탈/NNG;막/VV,27,1.5637216081191931,Hawkish
18,20, 펀더멘털/NNG;긍정적/VAX,38,1.3068244867853258,Hawkish
12,11, 펀더멘털/NNG;위험/NNG,23,1.58402968095191,Hawkish
15,13, 위험/NNG;덜/VV,28,1.6754160086991354,Hawkish
32,31, 쑥쑥/MAG,63,1.4988667948792267,Hawkish
9,9, 미풍/NNG,18,1.4520272075392509,Hawkish
60,62, 슬/NNG,122,1.405187620199275,Hawkish
38,21, 구주/NNG,59,2.6274778041186444,Hawkish
17,15, 노드/NNG,32,1.645630835211151,Hawkish
26,19, 채권시장/NNG;경기/NNG;회복/NNG,45,1.9869845997905538,Hawkish
17,13, 물량/NNG;부담/NNG;우려/NNG,30,1.8988048098590204,Hawkish
178,180, 주택사업/NNG,358,1.4358935718999257,Hawkish
139,15, 개사/NNG,154,13.455452123197057,Hawkish
20,20, 견조/NNG;경기/NNG;회복/NNG,40,1.4520272075392509,Hawkish
202,210, 리얼/NNG,412,1.3967118853472793,Hawkish
135,147, 감액/NNG,282,1.3334943742707406,Hawkish
12,7, 우려/NNG;환율/NNG;상승/NNG,19,2.489189498638716,Hawkish
10,11, 금리/NNG;낙폭/NNG;줄/VV,21,1.3200247341265916,Hawkish
69,77, 단번에/MAG,146,1.3011672379247832,Hawkish
43,39, 주관적/VAX,82,1.6009530749791738,Hawkish
31,20, 당분간/MAG;금리/NNG;인상/NNG;없/VA,51,2.250642171685839,Hawkish
42,35, 전망/NNG;인상/NNG,77,1.742432649047101,Hawkish
11,9, 금리/NNG;인상/NNG;전망/NNG;금리/NNG;인상/NNG,20,1.774699920325751,Hawkish
115,100, 선제/NNG;금리/NNG;인상/NNG,215,1.6698312886701385,Hawkish
24,19, 둔다는/VV,43,1.834139630575896,Hawkish
37,27, 정책/NNG;불확실성/NNG;해소/NNG,64,1.9898150621834176,Hawkish
30,19, 채권시장/NNG;경계/NNG,49,2.2926745382198694,Hawkish
16,11, 전망/NNG;긴축/NNG,27,2.1120395746025467,Hawkish
17,17, 작/VA;하락/NNG,34,1.4520272075392509,Hawkish
13,14, 중책/NNG,27,1.3483109784293044,Hawkish
69,66, 쌀가격/NNG,135,1.5180284442455805,Hawkish
35,29, 애그플레이션/NNG,64,1.752446629788751,Hawkish
12,4, 악화/NNG;하락/NNG,16,4.356081622617753,Hawkish
146,153, 간격/NNG,299,1.3855945902008537,Hawkish
737,578, 재할인율/NNG,1315,1.8514602975024705,Hawkish
162,138, 재할인율/NNG;인상/NNG,300,1.7045536784156423,Hawkish
26,15, 경제/NNG;활동/NNG;회복/NNG,41,2.5168471597347013,Hawkish
340,275, 금리/NNG;상향/NNG,615,1.7952336384121645,Hawkish
12,7, 우려/NNG;안전자산/NNG;선호/NNG;강화/NNG,19,2.489189498638716,Hawkish
479,467, 용역/NNG,946,1.4893383991676683,Hawkish
16,17, 유증/NNG,33,1.3666138423898828,Hawkish
26,18, 각서/NNG,44,2.097372633112251,Hawkish
45,35, 식별/NNG,80,1.8668921239790368,Hawkish
47,38, 총대/NNG,85,1.7959283882722312,Hawkish
14,14, 바젤협약/NNG,28,1.4520272075392509,Hawkish
21,12, 떠올려/VV,33,2.5410476131936885,Hawkish
16,10, 채권시장/NNG;견조/NNG,26,2.323243532062801,Hawkish
113,80, 수요/NNG;압력/NNG,193,2.0509884306491917,Hawkish
585,214, 추천종목/NNG,799,3.9693267121984195,Hawkish
18,16, 금리/NNG;인상/NNG;우려/NNG;상승/NNG,34,1.6335306084816572,Hawkish
48,53, 국채선물시장/NNG;하락/NNG,101,1.3150435087147934,Hawkish
20,19, 영업장/NNG,39,1.5284496921465798,Hawkish
219,142, 액면/NNG,361,2.239394073599267,Hawkish
12,5, 유상/NNG,17,3.484865298094202,Hawkish
35,33, 대상자산/NNG,68,1.5400288564810236,Hawkish
23,17, 노/NNG,40,1.9645073984354566,Hawkish
635,188, 매수전략/NNG,823,4.904453599933108,Hawkish
49,54, 지원자/NNG,103,1.3175802438782092,Hawkish
146,107, 성탄절/NNG,253,1.9812707691657068,Hawkish
57,43, 감사보고서/NNG,100,1.9247802518543555,Hawkish
54,30, 연말효과/NNG,84,2.613648973570651,Hawkish
27,21, 대외/NNG;금리/NNG;상승/NNG,48,1.8668921239790368,Hawkish
94,90, 반정부/NNG,184,1.5165617500965507,Hawkish
17,14, 횡/NNG,31,1.7631758948690905,Hawkish
24,5, 재무/NNG;안정성/NNG;저하/NNG,29,6.969730596188404,Hawkish
12,9, 회복/NNG;힘입/VV;상승/NNG,21,1.9360362767190011,Hawkish
18,12, 풍작/NNG,30,2.1780408113088763,Hawkish
295,193, 정정불안/NNG,488,2.2194198249952275,Hawkish
819,350, 국영/NNG,1169,3.3977436656418467,Hawkish
32,25, 글로벌/NNG;수요/NNG;회복/NNG,57,1.858594825650241,Hawkish
171,161, 폐장/NNG,332,1.5422152328522478,Hawkish
12,12, 금리/NNG;인상/NNG;압력/NNG;크/VV,24,1.4520272075392509,Hawkish
217,215, 유동성/NNG;축소/NNG,432,1.4655344373768253,Hawkish
12,11, 개선/NNG;한계/NNG,23,1.58402968095191,Hawkish
32,31, 연단/NNG,63,1.4988667948792267,Hawkish
9,9, 금리/NNG;당분간/MAG;경기/NNG;회복/NNG,18,1.4520272075392509,Hawkish
39,37, 무근/NNG,76,1.5305151647035347,Hawkish
54,53, 시큐리티/NNG,107,1.4794239473041424,Hawkish
154,160, 동화/NNG,314,1.3975761872565289,Hawkish
24,22, 초심/NNG,46,1.58402968095191,Hawkish
81,77, 매도차익/NNG,158,1.5274571923464846,Hawkish
18,16, 전망/NNG;경계/NNG,34,1.6335306084816572,Hawkish
101,105, 펜딩/NNG,206,1.3967118853472793,Hawkish
9,7, 상여/NNG,16,1.866892123979037,Hawkish
13,13, 권면/NNG,26,1.4520272075392509,Hawkish
66,61, 하락/NNG;금리/NNG;인상/NNG,127,1.5710458311080417,Hawkish
52,56, 저명/NNG,108,1.3483109784293044,Hawkish
13,11, 채권시장/NNG;채권/NNG;금리/NNG;하락/NNG,24,1.7160321543645694,Hawkish
31,29, 부동산/NNG;악재/NNG,60,1.552167014955751,Hawkish
19,16, 개선/NNG;경기/NNG;회복/NNG,35,1.7242823089528605,Hawkish
76,42, 갤러리/NNG,118,2.6274778041186444,Hawkish
78,2, 아제/NNG,80,56.62906109403078,Hawkish
230,157, 구제역/NNG,387,2.1271736161403036,Hawkish
121,73, 포천/NNG,194,2.4067848234554705,Hawkish
30,32, 결별/NNG,62,1.3612755070680476,Hawkish
90,76, 매출/NNG;호조/NNG,166,1.7195059036649023,Hawkish
33,18, 호조/NNG;강세/NNG,51,2.662049880488626,Hawkish
15,11, 대출/NNG;우려/NNG,26,1.9800371011898874,Hawkish
36,40, 열석/NNG,76,1.3068244867853258,Hawkish
10,9, 경기/NNG;회복/NNG;견고/NNG,19,1.6133635639325008,Hawkish
215,223, 회복/NNG;추세/NNG,438,1.3999365453853763,Hawkish
12,10, 금호/NNG,22,1.742432649047101,Hawkish
16,17, 기은/NNG,33,1.3666138423898828,Hawkish
14,4, 유동화전문유한회사/NNG,18,5.082095226387378,Hawkish
77,86, 물동량/NNG,163,1.3000708718665386,Hawkish
10,8, 은행/NNG;대출/NNG;규제/NNG;강화/NNG,18,1.8150340094240636,Hawkish
13,11, 예상밖/NNG;악화/NNG,24,1.7160321543645694,Hawkish
26,13, 높/VA;대외/NNG;불확실성/NNG,39,2.9040544150785017,Hawkish
65,59, 기술적/VAX;부담/NNG,124,1.5996909913568016,Hawkish
13,6, 지그재그/MAG,19,3.1460589496683764,Hawkish
43,10, 선도금리/NNG,53,6.243716992418778,Hawkish
162,118, 도소매/NNG,280,1.9934610815369376,Hawkish
25,24, 건설/NNG;부진/NNG,49,1.5125283411867194,Hawkish
33,30, 심리/NNG;꺾/VV,63,1.5972299282931757,Hawkish
55,51, 오프/NNG,106,1.5659116944050742,Hawkish
382,261, 권역/NNG,643,2.125189246283501,Hawkish
57,62, 온화/NNG,119,1.3349282391893114,Hawkish
38,36, 법인설립/NNG,74,1.5326953857358758,Hawkish
24,25, 전력수급/NNG,49,1.393946119237681,Hawkish
44,26, 교외/NNG,70,2.457276812758732,Hawkish
208,214, 푸르/VA,422,1.4113161643372159,Hawkish
139,148, 채권시장/NNG;금리/NNG;인상/NNG,287,1.3637282557294315,Hawkish
155,141, 인플레이션/NNG;잡/VV,296,1.596200121763006,Hawkish
102,105, 출도/NNG,207,1.410540715895272,Hawkish
16,14, 절상/NNG;압력/NNG;높/VA,30,1.6594596657591438,Hawkish
103,79, 강진/NNG,182,1.8931493971714284,Hawkish
70,66, 매몰/NNG,136,1.5400288564810236,Hawkish
11,12, 방송법/NNG,23,1.331024940244313,Hawkish
32,31, 원자력발전/NNG,63,1.4988667948792267,Hawkish
30,26, 인수의향서/NNG,56,1.6754160086991354,Hawkish
29,22, 국채/NNG;매입/NNG;중단/NNG,51,1.914035864483558,Hawkish
29,31, 기대/NNG;증시/NNG;상승/NNG,60,1.3583480328592992,Hawkish
147,133, 대형화/NNG,280,1.6048721767539085,Hawkish
32,34, 제조원가/NNG,66,1.3666138423898828,Hawkish
26,18, 볼트/NNG,44,2.097372633112251,Hawkish
12,11, 물가/NNG;압력/NNG;낮/VA,23,1.58402968095191,Hawkish
21,8, 글로벌/NNG;주식시장/NNG;강세/NNG,29,3.8115714197905333,Hawkish
16,0, 크레딧/NNG;투자심리/NNG;개선/NNG,16,inf,Hawkish
104,96, 토목/NNG,200,1.5730294748341882,Hawkish
21,20, 전망/NNG;과도/NNG,41,1.5246285679162133,Hawkish
41,40, 베어플래트닝/NNG,81,1.488327887727732,Hawkish
35,34, 한일통화스왑/NNG,69,1.4947338901139346,Hawkish
95,79, 랩어카운트/NNG,174,1.746108667294036,Hawkish
12,5, 수증/NNG,17,3.484865298094202,Hawkish
17,13, 무효화/NNG,30,1.8988048098590204,Hawkish
55,48, 김/NNG,103,1.6637811753053915,Hawkish
31,34, 이온/NNG,65,1.3239071598151992,Hawkish
52,45, 정형/NNG,97,1.677898106489801,Hawkish
16,14, 장부가액/NNG,30,1.6594596657591438,Hawkish
73,65, 수주/NNG;감소/NNG,138,1.6307382484671589,Hawkish
61,68, 보궐선거/NNG,129,1.3025538185278573,Hawkish
20,17, 북극/NNG,37,1.7082673029873539,Hawkish
63,66, 경매시장/NNG,129,1.3860259708329212,Hawkish
438,470, 우량주/NNG,908,1.3531657806429616,Hawkish
16,7, 우려/NNG;원자재/NNG;가격/NNG;하락/NNG,23,3.3189193315182877,Hawkish
82,24, 도시개발공사/NNG,106,4.96109295909244,Hawkish
18,6, 크래프트/NNG,24,4.356081622617753,Hawkish
161,152, 재건/NNG,313,1.538002502722496,Hawkish
34,32, 부두/NNG,66,1.5427789080104541,Hawkish
289,267, 연임/NNG,556,1.5716698987971667,Hawkish
19,11, 긴축/NNG;우려/NNG;하락/NNG,30,2.5080469948405244,Hawkish
327,331, 비전/NNG,658,1.4344800509526738,Hawkish
9,10, 장유/NNG,19,1.3068244867853258,Hawkish
98,69, 재정/NNG;적자/NNG;우려/NNG,167,2.062299512157197,Hawkish
14,8, 희색/NNG,22,2.541047613193689,Hawkish
148,137, 해체/NNG,285,1.5686133336920374,Hawkish
1036,827, 부당/NNG,1863,1.8189845066634387,Hawkish
36,32, 무역장벽/NNG,68,1.6335306084816572,Hawkish
24,23, 공사현장/NNG,47,1.5151588252583488,Hawkish
122,128, 국채/NNG;발행/NNG;성공/NNG,250,1.3839634321858485,Hawkish
9,10, 긴축/NNG;조치/NNG;우려/NNG,19,1.3068244867853258,Hawkish
9,7, 채권시장/NNG;긴축/NNG,16,1.866892123979037,Hawkish
11,9, gdp/NNG;둔화/NNG,20,1.774699920325751,Hawkish
19,2, 포사격/NNG,21,13.794258471622884,Hawkish
16,16, 발포/NNG,32,1.4520272075392506,Hawkish
125,120, 재정/NNG;적자/NNG;줄/VV,245,1.5125283411867196,Hawkish
82,64, 재정/NNG;위험/NNG,146,1.8604098596596652,Hawkish
24,25, 블록세일/NNG,49,1.393946119237681,Hawkish
23,20, 호시절/NNG,43,1.6698312886701383,Hawkish
10,6, 금융시스템/NNG;우려/NNG,16,2.420045345898751,Hawkish
92,86, 우려/NNG;확대/NNG,178,1.5533314313210589,Hawkish
11,9, 채권/NNG;금리/NNG;고점/NNG,20,1.774699920325751,Hawkish
12,6, 수요/NNG;양호/NNG,18,2.9040544150785017,Hawkish
46,19, 통화정책/NNG;경계/NNG,65,3.5154342919371335,Hawkish
21,20, 글로벌/NNG;경기/NNG;회복/NNG;둔화/NNG,41,1.5246285679162133,Hawkish
22,15, 우려/NNG;긴축/NNG,37,2.129639904390901,Hawkish
12,7, 재정/NNG;축소/NNG,19,2.489189498638716,Hawkish
43,23, 당분간/MAG;금융/NNG;완화/NNG,66,2.714659561921208,Hawkish
187,92, 일봉/NNG,279,2.951403128367825,Hawkish
11,12, 하락/NNG;배제/NNG,23,1.331024940244313,Hawkish
68,72, 이격/NNG,140,1.3713590293426259,Hawkish
13,14, 피로/NNG;높/VA,27,1.3483109784293044,Hawkish
24,19, 투자/NNG;매력/NNG;낮/VA,43,1.834139630575896,Hawkish
13,3, 단기물/NNG;축소/NNG,16,6.292117899336753,Hawkish
24,8, 금융규제안/NNG,32,4.356081622617753,Hawkish
25,9, 부실/NNG;방지/NNG,34,4.033408909831253,Hawkish
60,42, 머물렀으나/VV,102,2.07432458219893,Hawkish
10,10, 부진/NNG;확대/NNG,20,1.4520272075392509,Hawkish
134,118, 카드사태/NNG,252,1.6489122526293187,Hawkish
34,13, 상승국면/NNG;전환/NNG,47,3.797609619718041,Hawkish
16,16, 부동산/NNG;부정적/VAX,32,1.4520272075392506,Hawkish
37,19, 경기/NNG;둔화/NNG;우려/NNG;높/VA,56,2.827631930471173,Hawkish
28,28, 세계/NNG;경기/NNG;불확실성/NNG,56,1.4520272075392509,Hawkish
31,26, 낮/VA;인플레이션/NNG;압력/NNG,57,1.731263208989107,Hawkish
165,112, 결정문/NNG,277,2.1391472253926467,Hawkish
9,7, 세계/NNG;경제/NNG;이중침체/NNG;우려/NNG,16,1.866892123979037,Hawkish
50,54, 금리/NNG;인상/NNG;걸림돌/NNG,104,1.3444696366104174,Hawkish
42,7, 대내외/NNG;경기/NNG;개선/NNG,49,8.712163245235505,Hawkish
24,24, 건설/NNG;경기/NNG;부진/NNG,48,1.4520272075392509,Hawkish
10,9, 경제/NNG;구조적/VAX;취약/NNG,19,1.6133635639325008,Hawkish
14,5, 금리/NNG;매력/NNG;감소/NNG,19,4.065676181109902,Hawkish
12,9, 상향/NNG;금리/NNG;인상/NNG,21,1.9360362767190011,Hawkish
18,8, 수요/NNG;압력/NNG;높/VA,26,3.2670612169633144,Hawkish
222,198, 견조/NNG;성장/NNG,420,1.6280305054227961,Hawkish
21,21, 채권투자/NNG;늘/VV,42,1.4520272075392509,Hawkish
18,6, 물가/NNG;상승률/NNG;확대/NNG,24,4.356081622617753,Hawkish
28,20, 업종비중/NNG,48,2.032838090554951,Hawkish
131,77, 채권자산/NNG,208,2.470332002436907,Hawkish
72,34, 자문형랩/NNG,106,3.074881145377237,Hawkish
21,11, 금리/NNG;상승/NNG;환율/NNG;하락/NNG,32,2.7720519416658425,Hawkish
17,18, 안전자산/NNG;수요/NNG;증가/NNG,35,1.3713590293426259,Hawkish
39,40, 국고채/NNG;수익률/NNG;하락/NNG,79,1.4157265273507695,Hawkish
21,10, 글로벌/NNG;경기/NNG;확장/NNG,31,3.0492571358324265,Hawkish
32,1,노호/NNG,33,46.46487064125602,Hawkish
232,246, 메이저/NNG,478,1.3693915128012446,Hawkish
13,7, 우려/NNG;채권/NNG;금리/NNG;하락/NNG,20,2.6966219568586087,Hawkish
23,18, 금리/NNG;인상/NNG;과도/NNG,41,1.855368098522376,Hawkish
22,20, 경기/NNG;둔화/NNG;불안/NNG,42,1.5972299282931757,Hawkish
11,12, 가격/NNG;단기/NNG;급등/NNG,23,1.331024940244313,Hawkish
23,25, 올리/NNG,48,1.3358650309361106,Hawkish
21,14, 대감/NNG,35,2.1780408113088763,Hawkish
130,130, 채권/NNG;금리/NNG;소폭/MAG;상승/NNG,260,1.4520272075392509,Hawkish
41,38, 번번히/MAG,79,1.5666609344502442,Hawkish
13,3, 베이지북/NNG;경기/NNG;둔화/NNG,16,6.292117899336753,Hawkish
34,29, 내구재/NNG;수주/NNG;감소/NNG,63,1.7023767260805012,Hawkish
35,31, 수요/NNG;강세/NNG,66,1.6393855568991544,Hawkish
11,6, 경기/NNG;둔화/NNG;우려/NNG;강세/NNG,17,2.662049880488626,Hawkish
12,4, 예상/NNG;하회/NNG;하락/NNG,16,4.356081622617753,Hawkish
43,40, 단기/NNG;모멘텀/NNG,83,1.5609292481046946,Hawkish
20,12, 경기/NNG;모멘텀/NNG;둔화/NNG;우려/NNG,32,2.420045345898751,Hawkish
35,22, 주택매매지수/NNG,57,2.3100432847215355,Hawkish
152,166, 공공요금/NNG;인상/NNG,318,1.3295670816022056,Hawkish
17,5, 채권시장/NNG;채권/NNG;금리/NNG;상승/NNG,22,4.936892505633453,Hawkish
9,7, 민간/NNG;고용/NNG;예상/NNG;상회/NNG,16,1.866892123979037,Hawkish
34,21, 서비스업/NNG;지수/NNG;호조/NNG,55,2.350901193158787,Hawkish
21,21, 호조/NNG;약세/NNG,42,1.4520272075392509,Hawkish
11,12, 전망/NNG;경상/NNG;수지/NNG;흑자/NNG,23,1.331024940244313,Hawkish
12,5, 외국인/NNG;환율/NNG;하락/NNG,17,3.484865298094202,Hawkish
87,90, 경제/NNG;견조/NNG;성장/NNG,177,1.4036263006212757,Hawkish
53,50, 물가/NNG;불안/NNG;우려/NNG,103,1.539148839991606,Hawkish
12,11, fed/NNG;경기/NNG;둔화/NNG;우려/NNG,23,1.58402968095191,Hawkish
146,128, 결정시/NNG,274,1.6562185335994581,Hawkish
82,4, 통안채/NNG;축소/NNG,86,29.766557754554643,Hawkish
18,17, 경기/NNG;불안/NNG;우려/NNG,35,1.5374405726886184,Hawkish
9,10, 장기물/NNG;입찰/NNG;호조/NNG,19,1.3068244867853258,Hawkish
16,12, 경제/NNG;우호적/VAX,28,1.9360362767190007,Hawkish
8,8, 금리/NNG;완만/NNG;하락/NNG,16,1.4520272075392506,Hawkish
79,51, 위기관리대책회의/NNG,130,2.249218615600016,Hawkish
51,1, 대외/NNG;요인/NNG;강세/NNG,52,74.05338758450179,Hawkish
10,8, 국채/NNG;금리/NNG;상승/NNG;제한/NNG,18,1.8150340094240636,Hawkish
119,92, 베어/NNG,211,1.8781656271431613,Hawkish
22,23, 오버랩/NNG,45,1.388895589820153,Hawkish
148,2, 비고/NNG,150,107.45001335790457,Hawkish
16,13, 열전/NNG,29,1.7871104092790777,Hawkish
138,132, 수수께끼/NNG,270,1.5180284442455805,Hawkish
21,14, 구성비중/NNG,35,2.1780408113088763,Hawkish
314,1, 우축/NNG,315,455.9365431673247,Hawkish
21,12, 피라미드/NNG,33,2.5410476131936885,Hawkish
12,13, 미래현금흐름/NNG,25,1.3403328069593086,Hawkish
41,36, 양지/NNG,77,1.6536976530308134,Hawkish
123,8, 기준등급/NNG,131,22.324918315915983,Hawkish
223,13, 시장주체/NNG,236,24.907851329327148,Hawkish
229,22, 계통/NNG,251,15.114283205749475,Hawkish
112,12, 거래주체/NNG,124,13.552253937033006,Hawkish
1887,362, 수량/NNG,2249,7.568992653664547,Hawkish
240,43, 정금/NNG,283,8.104337902544655,Hawkish
23,11, 국철/NNG,34,3.0360568884911605,Hawkish
137,0, 기통/NNG,137,inf,Hawkish
235,5, 기업명/NNG,240,68.24527875434478,Hawkish
449,121, 발행일/NNG,570,5.388100960207633,Hawkish
108,0, 명발/NNG,108,inf,Hawkish
121,4, 행금/NNG,125,43.92382302806234,Hawkish
257,90, 에이스/NNG,347,4.146344359306528,Hawkish
64,68, 통관기준/NNG,132,1.3666138423898828,Hawkish
27,0, 회전신용/NNG,27,inf,Hawkish
23,5, 비회/NNG,28,6.679325154680553,Hawkish
28,18, 금리/NNG;인상/NNG;매파/NNG,46,2.258708989505501,Hawkish
9,9, 서비스업/NNG;하락/NNG,18,1.4520272075392509,Hawkish
145,1, 크레딧/NNG;축소/NNG,146,210.54394509319135,Hawkish
39,41, 수출/NNG;모멘텀/NNG,80,1.3811966120495314,Hawkish
108,101, 물가/NNG;인상/NNG,209,1.5526627565766247,Hawkish
12,6, 높/VA;거품/NNG,18,2.9040544150785017,Hawkish
12,7, 행성/NNG,19,2.489189498638716,Hawkish
82,72, 원환/NNG,154,1.6536976530308134,Hawkish
12,7, 선단/NNG,19,2.489189498638716,Hawkish
120,80, 중단기물/NNG,200,2.178040811308876,Hawkish
90,34, 복리채/NNG,124,3.8436014317215457,Hawkish
1100,1004, 본인/NNG,2104,1.5908664624434024,Hawkish
655,198, 간섭/NNG,853,4.803423338071764,Hawkish
1376,942, 합니다/XSV,2318,2.12100789551381,Hawkish
812,17, 작성자/NNG,829,69.35565250128656,Hawkish
13,3, 인상/NNG;가능성/NNG;높/VA;금리/NNG;인상/NNG,16,6.292117899336753,Hawkish
30,4, 금리/NNG;인상/NNG;물가/NNG;안정/NNG,34,10.89020405654438,Hawkish
20,7, 물가/NNG;불안/NNG;금리/NNG;인상/NNG,27,4.14864916439786,Hawkish
14,8, 경제/NNG;회복/NNG;기대/NNG;높/VV,22,2.541047613193689,Hawkish
14,12, 이중침체/NNG;가능성/NNG;낮/VA,26,1.6940317421291258,Hawkish
10,10, 소비자/NNG;물가/NNG;불안/NNG,20,1.4520272075392509,Hawkish
19,13, 물가/NNG;인상/NNG;압력/NNG,32,2.122193611018905,Hawkish
9,10, 가계/NNG;부채/NNG;과도/NNG,19,1.3068244867853258,Hawkish
14,6, 예대마진/NNG;개선/NNG,20,3.3880634842582515,Hawkish
35,28, 변동성/NNG;감소/NNG,63,1.8150340094240638,Hawkish
16,11, 제조업/NNG;증가/NNG,27,2.1120395746025467,Hawkish
21,21, 재고/NNG;확충/NNG,42,1.4520272075392509,Hawkish
118,100, 채권/NNG;금리/NNG;인상/NNG,218,1.7133921048963159,Hawkish
367,234, 출처/NNG,601,2.2773247229354916,Hawkish
122,84, 프랑스국채/NNG,206,2.108896658568912,Hawkish
40,21, 채권/NNG;금리/NNG;상승/NNG;제한/NNG,61,2.765766109598573,Hawkish
24,13, 끝자락/NNG,37,2.680665613918617,Hawkish
21,15, 소심/NNG,36,2.032838090554951,Hawkish
10,10, 응기/NNG,20,1.4520272075392509,Hawkish
27,21, 식상/NNG,48,1.8668921239790368,Hawkish
39,20, 일드/NNG,59,2.831453054701539,Hawkish
155,153, 단단/NNG,308,1.4710079553502213,Hawkish
44,34, 희미/NNG,78,1.879094033286089,Hawkish
49,48, 하이라이트/NNG,97,1.4822777743629851,Hawkish
50,37, 어필/NNG,87,1.9621989291070956,Hawkish
10,11, 당겨서/VV,21,1.3200247341265916,Hawkish
107,49, 수출입금융/NNG,156,3.17075328993265,Hawkish
142,90, 변/NNG,232,2.2909762607841513,Hawkish
24,1, 인일/NNG,25,34.84865298094202,Hawkish
57,21, 트론/NNG,78,3.941216706177966,Hawkish
17,8, 행신/NNG,25,3.0855578160209083,Hawkish
33,0, 부정적/VAX;안정/NNG;부정적/VAX,33,inf,Hawkish
35,0, 안정/NNG;부정적/VAX;안정/NNG,35,inf,Hawkish
24,25, 성장/NNG;물가/NNG;상승/NNG,49,1.393946119237681,Hawkish
22,18, 불확실성/NNG;축소/NNG,40,1.774699920325751,Hawkish
11,9, 급락/NNG;불안/NNG,20,1.774699920325751,Hawkish
14,13, 물가/NNG;강하/VA,27,1.5637216081191931,Hawkish
23,12, 우려/NNG;양호/NNG,35,2.7830521477835637,Hawkish
51,55, 미연/NNG,106,1.3464252288091234,Hawkish
14,11, 산국/NNG,25,1.8480346277772284,Hawkish
163,158, 생산설비/NNG,321,1.497977435625936,Hawkish
33,24, 계감/NNG,57,1.9965374103664695,Hawkish
12,4, 경제/NNG;경계/NNG,16,4.356081622617753,Hawkish
39,0, 사분기/NNG,39,inf,Hawkish
63,29, 듀레이션갭/NNG,92,3.154403933619752,Hawkish
117,120, 스틸/NNG,237,1.4157265273507693,Hawkish
99,12, 치마/NNG,111,11.979224462198818,Hawkish
25,7, 크레딧/NNG;비중/NNG;확대/NNG,32,5.1858114554973245,Hawkish
15,9, 예상/NNG;금리/NNG;상승/NNG,24,2.420045345898751,Hawkish
44,25, 경기/NNG;둔화/NNG;우려/NNG;완화/NNG,69,2.5555678852690815,Hawkish
21,15, 대외/NNG;경기/NNG;불확실성/NNG,36,2.032838090554951,Hawkish
18,14, 내구재/NNG;수주/NNG;호조/NNG,32,1.866892123979037,Hawkish
25,18, 근원/NNG;소비자/NNG;물가/NNG;하락/NNG,43,2.0167044549156263,Hawkish
41,34, 변동성/NNG;확대/NNG;우려/NNG,75,1.7509739855620376,Hawkish
72,70, 주봉/NNG,142,1.4935136991832296,Hawkish
14,11, 본고/NNG,25,1.8480346277772284,Hawkish
24,19, 구성비/NNG,43,1.834139630575896,Hawkish
102,54, 파생시장/NNG,156,2.7427180586852513,Hawkish
14,15, 금리/NNG;인상/NNG;가능성/NNG;매우/MAG;높/VA,29,1.3552253937033008,Hawkish
34,31, 금리/NNG;인상/NNG;제한/NNG,65,1.5925459695591786,Hawkish
19,15, 부채비율/NNG;하락/NNG,34,1.839234462883051,Hawkish
41,41, 컨센서스/NNG;상회/NNG,82,1.4520272075392509,Hawkish
231,234, 플러스/NNG;전환/NNG,465,1.4334114741092603,Hawkish
129,136, 일민/NNG,265,1.377290513033554,Hawkish
10,6, 평인/NNG,16,2.420045345898751,Hawkish
14,11, 개선/NNG;부진/NNG,25,1.8480346277772284,Hawkish
25,24, 중앙은행자금/NNG,49,1.5125283411867194,Hawkish
50,33, 투자/NNG;수요/NNG;증가/NNG,83,2.2000412235443196,Hawkish
96,89, 금융센터/NNG,185,1.5662315946490797,Hawkish
46,42, 지점망/NNG,88,1.5903155130191793,Hawkish
48,14, 포자/NNG,62,4.978378997277432,Hawkish
23,0, 동교/NNG,23,inf,Hawkish
35,19, 동지점/NNG,54,2.674786961256515,Hawkish
25,3, 수원/NNG,28,12.100226729493755,Hawkish
29,7, 고운/VA,36,6.015541288376896,Hawkish
30,14, 동학/NNG,44,3.1114868732983947,Hawkish
19,0, 대훈/NNG,19,inf,Hawkish
25,1, 범우/NNG,26,36.30068018848127,Hawkish
16,0, 북대구/NNG,16,inf,Hawkish
28,19, 맞은편/NNG,47,2.1398295690052116,Hawkish
16,1, 청동/NNG,17,23.23243532062801,Hawkish
32,15, 상안/NNG,47,3.0976580427504015,Hawkish
50,6, 계동/NNG,56,12.100226729493755,Hawkish
55,33, 성북/NNG,88,2.4200453458987514,Hawkish
36,19, 장위/NNG,55,2.751209445863844,Hawkish
81,86, 잠실/NNG,167,1.3676070210544107,Hawkish
65,63, 양천/NNG,128,1.4981233093658934,Hawkish
23,0, 아르누보/NNG,23,inf,Hawkish
30,29, 공제조합/NNG,59,1.5020971112475008,Hawkish
25,2, 양재/NNG,27,18.150340094240637,Hawkish
54,7, 금정/NNG,61,11.20135274387422,Hawkish
26,6, 원지점/NNG,32,6.292117899336753,Hawkish
66,47, 원주/NNG,113,2.0390169297359693,Hawkish
26,4, 대잠/NNG,30,9.438176849005131,Hawkish
38,35, 메디컬/NNG,73,1.5764866824711867,Hawkish
27,10, 학동/NNG,37,3.9204734603559768,Hawkish
95,32, 월봉/NNG,127,4.310705772382152,Hawkish
9,8, 자기/NNG,17,1.6335306084816572,Hawkish
10,11, 상관도/NNG,21,1.3200247341265916,Hawkish
51,10, 양곡/NNG,61,7.405338758450179,Hawkish
59,38, 수요측면/NNG;물가/NNG;상승/NNG;압력/NNG,97,2.254463295916205,Hawkish
19,5, 원화/NNG;절상/NNG;금리/NNG;인상/NNG,24,5.517703388649153,Hawkish
12,9, 채권/NNG;금리/NNG;하락/NNG;제한/NNG,21,1.9360362767190011,Hawkish
19,19, 수요측면/NNG;인플레이션/NNG;압력/NNG,38,1.4520272075392509,Hawkish
27,27, 가격/NNG;변동성/NNG;확대/NNG,54,1.4520272075392506,Hawkish
11,6, 수출/NNG;투자/NNG;증가/NNG,17,2.662049880488626,Hawkish
10,7, 지수/NNG;낙폭/NNG;축소/NNG,17,2.07432458219893,Hawkish
15,13, 상환/NNG;부담/NNG;경감/NNG,28,1.6754160086991354,Hawkish
20,9, 채권/NNG;매수/NNG;확대/NNG,29,3.2267271278650016,Hawkish
16,8, 투자/NNG;매력/NNG;약화/NNG,24,2.9040544150785013,Hawkish
8,8, 물가/NNG;우려/NNG;크/VV,16,1.4520272075392506,Hawkish
14,11, 수익성/NNG;증가/NNG,25,1.8480346277772284,Hawkish
190,191,선행/NNG,381,1.4444249708505639,Hawkish
94,104, 개인/NNG;소득/NNG;증가/NNG,198,1.3124092068143227,Hawkish
346,368, 농축수산물/NNG,714,1.3652212331754914,Hawkish
48,32, 완제품/NNG,80,2.1780408113088763,Hawkish
10,6, 핵심/NNG;소비자/NNG;물가/NNG;상승/NNG,16,2.420045345898751,Hawkish
11,6, 가격/NNG;상승/NNG;금리/NNG;인상/NNG,17,2.662049880488626,Hawkish
11,5, 신규/NNG;주문/NNG;지수/NNG;상승/NNG,16,3.1944598565863513,Hawkish
12,9, 경기/NNG;선행/NNG;지수/NNG;둔화/NNG,21,1.9360362767190011,Hawkish
65,62, 소비자/NNG;물가/NNG;급등/NNG,127,1.5222865885492145,Hawkish
11,7, 가격/NNG;상승/NNG;일시적/VAX,18,2.2817570404188228,Hawkish
17,2, 속편/NNG,19,12.342231264083633,Hawkish
23,24, 괴물/NNG,47,1.3915260738917818,Hawkish
33,35, 동거/NNG,68,1.3690542242512935,Hawkish
18,0, 역계/NNG,18,inf,Hawkish
13,12, 호스/NNG,25,1.5730294748341882,Hawkish
480,524, 동요/NNG,1004,1.3301012588145809,Hawkish
23,16, 상계관세/NNG,39,2.087289110837673,Hawkish
36,40, 조바심/NNG,76,1.3068244867853258,Hawkish
15,11, 능/NNG,26,1.9800371011898874,Hawkish
50,41, 몬/VV,91,1.7707648872429889,Hawkish
12,4, 수출/NNG;모멘텀/NNG;약화/NNG,16,4.356081622617753,Hawkish
37,0, 안정/NNG;긍정적/VAX;안정/NNG,37,inf,Hawkish
13,12, 소비/NNG;완만/NNG;증가/NNG,25,1.5730294748341882,Hawkish
11,11, 자산/NNG;비중/NNG;높/VV,22,1.4520272075392509,Hawkish
13,14, 기대/NNG;풀/NNG;꺾/VV,27,1.3483109784293044,Hawkish
12,8, 내수/NNG;모멘텀/NNG,20,2.1780408113088763,Hawkish
27,22, 하락/NNG;지지/NNG,49,1.7820333910708988,Hawkish
17,16, 성장/NNG;하락/NNG,33,1.5427789080104541,Hawkish
23,18, 원화/NNG;강세/NNG;금리/NNG;인상/NNG,41,1.855368098522376,Hawkish
47,52, 전망/NNG;감소/NNG,99,1.3124092068143227,Hawkish
11,5, 시중/NNG;유동성/NNG;감소/NNG,16,3.1944598565863513,Hawkish
35,25,투자분석/NNG,60,2.0328380905549515,Hawkish
110,106, 역발상/NNG,216,1.506820687069034,Hawkish
26,3, 밑줄/NNG,29,12.584235798673506,Hawkish
21,0, 바스캣/NNG,21,inf,Hawkish
596,647, 식료품/NNG,1243,1.3375706579496036,Hawkish
65,2, 역축/NNG,67,47.19088424502565,Hawkish
53,50, 항셍/NNG,103,1.539148839991606,Hawkish
70,57, 인수금액/NNG,127,1.783191307504343,Hawkish
35,0, 일계/NNG,35,inf,Hawkish
14,9, 전미부동산협회/NNG,23,2.258708989505501,Hawkish
160,169, 수시입출금식/NNG,329,1.3747003148300598,Hawkish
12,8, 잠정/NNG;주택/NNG;판매/NNG;증가/NNG,20,2.1780408113088763,Hawkish
18,15, 장기물/NNG;발행/NNG;확대/NNG,33,1.742432649047101,Hawkish
14,10, 소비자/NNG;물가/NNG;증가/NNG,24,2.032838090554951,Hawkish
10,9, 자본재/NNG;주문/NNG;증가/NNG,19,1.6133635639325008,Hawkish
41,37, 위험/NNG;제한적/VAX,78,1.6090031218678182,Hawkish
12,13, 예상/NNG;크/VV,25,1.3403328069593086,Hawkish
14,4, 금리/NNG;인상/NNG;압력/NNG;완화/NNG,18,5.082095226387378,Hawkish
89,88, 인상/NNG;추세/NNG,177,1.4685275167158331,Hawkish
52,28, 견인력/NNG,80,2.6966219568586087,Hawkish
42,21, 쇄/NNG,63,2.9040544150785017,Hawkish
23,20, 금리/NNG;인상/NNG;금리/NNG;상승/NNG,43,1.6698312886701383,Hawkish
30,19, 펀더멘털/NNG;부진/NNG,49,2.2926745382198694,Hawkish
94,97, 통안채/NNG;내리/VV,191,1.4071191495741193,Hawkish
26,16, 상향/NNG;압력/NNG,42,2.359544212251283,Hawkish
11,10, 물가/NNG;심각/NNG,21,1.5972299282931757,Hawkish
15,15, 금리/NNG;위협/NNG,30,1.4520272075392506,Hawkish
26,29, 원화/NNG;강세/NNG;부담/NNG,55,1.3018174964145008,Hawkish
116,109, 긴축/NNG;완화/NNG,225,1.5452766612344322,Hawkish
28,20, 투자분석/NNG,48,2.032838090554951,Hawkish
113,25, 복사/NNG,138,6.563162978077414,Hawkish
21,14, 경제/NNG;성장/NNG;속도/NNG;둔화/NNG,35,2.1780408113088763,Hawkish
28,22, 경제/NNG;수출/NNG;호조/NNG,50,1.8480346277772284,Hawkish
19,2, 낮/VA;경기/NNG;상승/NNG,21,13.794258471622884,Hawkish
22,20, 정책/NNG;실기/NNG,42,1.5972299282931757,Hawkish
26,24, 이분법/NNG,50,1.5730294748341882,Hawkish
16,10, 종착지/NNG,26,2.323243532062801,Hawkish
25,18, 금리/NNG;인상/NNG;불확실/NNG,43,2.0167044549156263,Hawkish
43,5, 국채/NNG;축소/NNG,48,12.487433984837557,Hawkish
164,155, 인플레이션/NNG;압력/NNG;높/VA,319,1.5363384647512073,Hawkish
82,88, 민간/NNG;소비/NNG;증가/NNG,170,1.3530253524797564,Hawkish
29,27, 민간/NNG;소비/NNG;감소/NNG,56,1.559584778468084,Hawkish
78,67, 인플레이션/NNG;방어/NNG,145,1.6904197341501725,Hawkish
55,61, 내수/NNG;증가/NNG,116,1.3092048592567016,Hawkish
18,8, 금리/NNG;인상/NNG;가능성/NNG;증가/NNG,26,3.2670612169633144,Hawkish
18,19, 기업/NNG;구조조정/NNG;지연/NNG,37,1.375604722931922,Hawkish
11,12, 부채/NNG;부담/NNG;경감/NNG,23,1.331024940244313,Hawkish
58,52, 설비/NNG;투자/NNG;부진/NNG,110,1.6195688084091644,Hawkish
88,96, 과도기/NNG,184,1.331024940244313,Hawkish
74,81, 결집/NNG,155,1.3265433747889452,Hawkish
46,46, 시행착오/NNG,92,1.4520272075392506,Hawkish
16,4, 가격/NNG;부담/NNG;만만/NNG;않/VX,20,5.8081088301570025,Hawkish
11,12, 축시/NNG,23,1.331024940244313,Hawkish
33,21, 긴축/NNG;금리/NNG;인상/NNG,54,2.2817570404188223,Hawkish
9,7, 직접/NNG;금리/NNG;인상/NNG,16,1.866892123979037,Hawkish
111,114, 쿠폰금리/NNG,225,1.4138159652355862,Hawkish
22,15, 달여/VV,37,2.129639904390901,Hawkish
52,51, 안함/NNG,103,1.4804983292557066,Hawkish
16,4, 변동비/NNG,20,5.8081088301570025,Hawkish
97,86, 배율/NNG,183,1.6377516178058993,Hawkish
35,33, 장악력/NNG,68,1.5400288564810236,Hawkish
56,36, 브리프/NNG,92,2.258708989505501,Hawkish
694,748, 업종별/NNG,1442,1.347201713946845,Hawkish
41,24, 발행인/NNG,65,2.48054647954622,Hawkish
16,4, 장기물/NNG;발행비중/NNG;확대/NNG,20,5.8081088301570025,Hawkish
10,11, 주택시장/NNG;침체/NNG;우려/NNG,21,1.3200247341265916,Hawkish
13,10, 경상/NNG;수지/NNG;호조/NNG,23,1.887635369801026,Hawkish
16,11, 자금/NNG;과도/NNG,27,2.1120395746025467,Hawkish
15,15, 수요/NNG;악화/NNG,30,1.4520272075392506,Hawkish
773,783, 중국발/NNG,1556,1.4334827987584176,Hawkish
17,18, 원화/NNG;절상/NNG;압력/NNG;완화/NNG,35,1.3713590293426259,Hawkish
9,7, 채권/NNG;매도/NNG;압력/NNG,16,1.866892123979037,Hawkish
15,10, 경제/NNG;양호/NNG;성장/NNG,25,2.178040811308876,Hawkish
21,10, 생산능력/NNG;확대/NNG,31,3.0492571358324265,Hawkish
30,15, 모방/NNG,45,2.9040544150785013,Hawkish
19,19, 강경책/NNG,38,1.4520272075392509,Hawkish
29,31, 비이성/NNG,60,1.3583480328592992,Hawkish
15,16, 중력/NNG,31,1.3612755070680476,Hawkish
9,7, 어중간/NNG,16,1.866892123979037,Hawkish
43,41, 단면/NNG,84,1.5228578030289703,Hawkish
29,30, 변혁/NNG,59,1.4036263006212757,Hawkish
20,4, 총인구/NNG,24,7.260136037696254,Hawkish
73,71, 금리/NNG;인상/NNG;위안/NNG;절상/NNG,144,1.4929293823995113,Hawkish
19,17, 불확실/NNG;금리/NNG;인상/NNG,36,1.622853937837986,Hawkish
15,11, 변동성/NNG;강하/VA,26,1.9800371011898874,Hawkish
22,21, 가격/NNG;성장/NNG,43,1.5211713602792152,Hawkish
10,6, 적절/NNG;성장/NNG,16,2.420045345898751,Hawkish
16,14, 많/VA;성장/NNG,30,1.6594596657591438,Hawkish
50,44, 주택시장/NNG;개선/NNG,94,1.6500309176582397,Hawkish
9,8, 일고/NNG,17,1.6335306084816572,Hawkish
13,10, 기술적/VAX;조정/NNG;압력/NNG,23,1.887635369801026,Hawkish
17,9, 신기원/NNG,26,2.7427180586852518,Hawkish
16,7, 총고정자본형성/NNG,23,3.3189193315182877,Hawkish
19,12, 인플레이션/NNG;압력/NNG;금리/NNG;인상/NNG,31,2.299043078603814,Hawkish
18,16, 금리/NNG;상승/NNG;금리/NNG;인상/NNG,34,1.6335306084816572,Hawkish
25,6, 예상/NNG;못하/VX;금리/NNG;인상/NNG,31,6.050113364746878,Hawkish
8,8, 다원화/NNG;절상/NNG,16,1.4520272075392506,Hawkish
11,7, 일시적/VAX;증가/NNG,18,2.2817570404188228,Hawkish
175,194, 내수/NNG;확대/NNG,369,1.3098183573163347,Hawkish
11,6, 소비자/NNG;물가/NNG;가격/NNG;상승/NNG,17,2.662049880488626,Hawkish
18,11, 통화정책/NNG;불확실성/NNG;완화/NNG,29,2.376044521427865,Hawkish
11,6, 근원/NNG;물가/NNG;안정/NNG,17,2.662049880488626,Hawkish
9,8, 경제/NNG;더디/VA;회복/NNG,17,1.6335306084816572,Hawkish
20,9, 월도/NNG,29,3.2267271278650016,Hawkish
9,9, 저공비행/NNG,18,1.4520272075392509,Hawkish
12,13, 레버리징/NNG,25,1.3403328069593086,Hawkish
52,10, 풋/MAG,62,7.550541479204104,Hawkish
14,9, 금리/NNG;인상/NNG;상향/NNG,23,2.258708989505501,Hawkish
11,6, 높/VA;재정/NNG;긴축/NNG,17,2.662049880488626,Hawkish
23,18, 레버리지/NNG;확대/NNG,41,1.855368098522376,Hawkish
17,15, 개선/NNG;안정/NNG,32,1.645630835211151,Hawkish
14,6, 호조/NNG;금리/NNG;상승/NNG,20,3.3880634842582515,Hawkish
18,2, 경제/NNG;경기/NNG;개선/NNG,20,13.068244867853258,Hawkish
31,19, 금리/NNG;인상/NNG;가능성/NNG;부담/NNG,50,2.369097022827199,Hawkish
41,32, 글로벌/NNG;유동성/NNG;증가/NNG,73,1.8604098596596652,Hawkish
22,18, 금리/NNG;인상/NNG;가능성/NNG;경계/NNG,40,1.774699920325751,Hawkish
33,30, 호조/NNG;금리/NNG;인상/NNG,63,1.5972299282931757,Hawkish
69,29, 개요/NNG,98,3.454823355869252,Hawkish
20,18, 홀수/NNG,38,1.6133635639325008,Hawkish
32,34, 온전/NNG,66,1.3666138423898828,Hawkish
44,42, 버터플라이/NNG,86,1.5211713602792152,Hawkish
29,24, 중기채/NNG,53,1.7545328757765946,Hawkish
11,11, 시초/NNG,22,1.4520272075392509,Hawkish
37,33, 적자국/NNG,70,1.6280305054227964,Hawkish
14,15, 수성장/NNG,29,1.3552253937033008,Hawkish
108,74, 자산효과/NNG,182,2.119174843435663,Hawkish
198,201, 상저하고/NNG,399,1.4303551596655306,Hawkish
25,27, 국가재정운용계획/NNG,52,1.3444696366104174,Hawkish
20,14, 소매업자/NNG,34,2.07432458219893,Hawkish
16,8, 출소/NNG,24,2.9040544150785013,Hawkish
10,7, 운송량/NNG,17,2.07432458219893,Hawkish
64,63, 통화유통속도/NNG,127,1.4750752584525721,Hawkish
59,46, 페이스/NNG,105,1.8623827227133867,Hawkish
18,9, 매입비중/NNG,27,2.9040544150785017,Hawkish
97,72, 수요조사/NNG,169,1.9562033212681573,Hawkish
203,85, 개발공사/NNG,288,3.4677826250643284,Hawkish
16,2, 불태화정책/NNG,18,11.616217660314005,Hawkish
119,93, 콜차입/NNG,212,1.857970297819041,Hawkish
55,59, 은행간시장/NNG,114,1.353584684994217,Hawkish
40,38, 거래제/NNG,78,1.5284496921465798,Hawkish
12,12, 안국/NNG,24,1.4520272075392509,Hawkish
11,12, 행전/NNG,23,1.331024940244313,Hawkish
96,101, 영업용/NNG,197,1.3801446725125552,Hawkish
20,7, 공단채/NNG,27,4.14864916439786,Hawkish
17,10, 순감/NNG,27,2.4684462528167264,Hawkish
96,78, 커버리지비율/NNG,174,1.787110409279078,Hawkish
22,4, 순안정자금조달비율/NNG,26,7.986149641465879,Hawkish
78,40, 순현금/NNG,118,2.831453054701539,Hawkish
76,83, 유출액/NNG,159,1.3295670816022056,Hawkish
50,44, 이익잉여금/NNG,94,1.6500309176582397,Hawkish
106,52, 규제비율/NNG,158,2.959901615368473,Hawkish
22,16, 순응성/NNG,38,1.9965374103664697,Hawkish
13,13, 전행/NNG,26,1.4520272075392509,Hawkish
516,573, 세율/NNG,1089,1.3075847104541944,Hawkish
475,11, 종목명/NNG,486,62.7011748710131,Hawkish
196,155, 은행세/NNG,351,1.8361118237270528,Hawkish
8,8, 기물별/NNG,16,1.4520272075392506,Hawkish
16,17, 중반기/NNG,33,1.3666138423898828,Hawkish
54,44, 호전과/NNG,98,1.7820333910708988,Hawkish
15,9, 공급비중/NNG,24,2.420045345898751,Hawkish
74,73, 수요처/NNG,147,1.4719179912041722,Hawkish
17,17, 단기/NNG;금리/NNG;하방/NNG;경직/NNG,34,1.4520272075392509,Hawkish
20,11, 국제/NNG;상품/NNG;가격/NNG;상승/NNG,31,2.640049468253183,Hawkish
16,12, 경기/NNG;선행/NNG;지수/NNG;저점/NNG,28,1.9360362767190007,Hawkish
15,11, 경기/NNG;둔화/NNG;불확실성/NNG,26,1.9800371011898874,Hawkish
27,21, 금리/NNG;불확실성/NNG;해소/NNG,48,1.8668921239790368,Hawkish
15,14, 기대/NNG;인플레이션/NNG;높/VV,29,1.5557434366491973,Hawkish
27,23, 장기물/NNG;비중/NNG;확대/NNG,50,1.7045536784156423,Hawkish
86,79, 무역/NNG;적자/NNG;확대/NNG,165,1.5806878461819693,Hawkish
71,59, 재정/NNG;지출/NNG;축소/NNG,130,1.747354775174353,Hawkish
21,17, 성장/NNG;둔화/NNG;위험/NNG,38,1.7936806681367214,Hawkish
33,18, 수출/NNG;가격/NNG;상승/NNG,51,2.662049880488626,Hawkish
8,8, 경기/NNG;물가/NNG;상승/NNG,16,1.4520272075392506,Hawkish
15,16, 위험/NNG;프리미엄/NNG;높/VA,31,1.3612755070680476,Hawkish
16,15, 자금/NNG;조달/NNG;확대/NNG,31,1.5488290213752007,Hawkish
10,6, 위축/NNG;금리/NNG;상승/NNG,16,2.420045345898751,Hawkish
32,13, 금리/NNG;인상/NNG;확대/NNG,45,3.5742208185581554,Hawkish
48,50, 전망/NNG;작/VA;않/VX,98,1.393946119237681,Hawkish
26,22, 유동성/NNG;통제/NNG,48,1.7160321543645694,Hawkish
11,8, 금리/NNG;상하단/NNG,19,1.9965374103664697,Hawkish
54,45, 양적/VAX;성장/NNG,99,1.742432649047101,Hawkish
30,16, 소비/NNG;견조/NNG,46,2.722551014136095,Hawkish
11,11, 소비/NNG;안정/NNG,22,1.4520272075392509,Hawkish
54,41, 위축/NNG;우려/NNG,95,1.912426078222428,Hawkish
29,27, 성장/NNG;높/VA,56,1.559584778468084,Hawkish
528,542, 프랑/NNG,1070,1.4145209697061336,Hawkish
20,5, 전망/NNG;물가/NNG;상승/NNG,25,5.808108830157003,Hawkish
40,41, 채권/NNG;금리/NNG;약세/NNG,81,1.416611909794391,Hawkish
11,8, 절상/NNG;속도/NNG;가속/NNG,19,1.9965374103664697,Hawkish
14,3, 채권투자/NNG;증가/NNG,17,6.776126968516503,Hawkish
11,8, 축이/VV,19,1.9965374103664697,Hawkish
37,21, 허들/NNG,58,2.55833365137868,Hawkish
130,91, 모기지발/NNG,221,2.07432458219893,Hawkish
12,12, 유자/NNG,24,1.4520272075392509,Hawkish
14,13, 국수/NNG,27,1.5637216081191931,Hawkish
32,35, 산술평균/NNG,67,1.327567732607315,Hawkish
40,44, 금리/NNG;인상/NNG;가능성/NNG;줄/VV,84,1.3200247341265916,Hawkish
9,10, 불확실성/NNG;약세/NNG,19,1.3068244867853258,Hawkish
29,30, 공급/NNG;우려/NNG,59,1.4036263006212757,Hawkish
29,22, 가격/NNG;하향/NNG,51,1.914035864483558,Hawkish
18,14, 건설/NNG;하락/NNG,32,1.866892123979037,Hawkish
8,8, 스펀/NNG,16,1.4520272075392506,Hawkish
347,179, 순투자/NNG,526,2.8148236928274866,Hawkish
51,45, 만기보유증권/NNG,96,1.645630835211151,Hawkish
117,121, 빡빡/NNG,238,1.4040263081164657,Hawkish
22,18, 할리/NNG,40,1.774699920325751,Hawkish
117,124, 양식/NNG,241,1.3700579296942932,Hawkish
824,915, 자본비율/NNG,1739,1.3076179442757845,Hawkish
27,26, 유사점/NNG,53,1.5078744078292219,Hawkish
303,259, 배우자/NNG,562,1.698703644341286,Hawkish
32,34, 고용/NNG;증가/NNG;고용/NNG;증가/NNG,66,1.3666138423898828,Hawkish
10,9, 신흥국/NNG;인플레이션/NNG;압력/NNG,19,1.6133635639325008,Hawkish
20,15, 자본/NNG;유출입/NNG;통제/NNG,35,1.936036276719001,Hawkish
11,8, 재정/NNG;건전성/NNG;개선/NNG,19,1.9965374103664697,Hawkish
10,9, 소비/NNG;여력/NNG;축소/NNG,19,1.6133635639325008,Hawkish
24,22, 가동률/NNG;상승/NNG,46,1.58402968095191,Hawkish
39,38, 재정/NNG;개선/NNG,77,1.4902384498429153,Hawkish
56,39, 재정/NNG;감축/NNG,95,2.0849621441589243,Hawkish
26,29, 세부안/NNG,55,1.3018174964145008,Hawkish
40,0, 장기물/NNG;순매수/NNG;강화/NNG,40,inf,Hawkish
57,52, 징벌/NNG,109,1.5916452082641788,Hawkish
10,6, 언와/NNG,16,2.420045345898751,Hawkish
40,42, 떼/NNG,82,1.3828830547992865,Hawkish
62,60, 국가통계국/NNG,122,1.5004281144572258,Hawkish
11,7, 인플레이션/NNG;우려/NNG;확대/NNG,18,2.2817570404188228,Hawkish
22,18, 성장/NNG;전망/NNG;상향/NNG,40,1.774699920325751,Hawkish
31,32, 물가/NNG;금리/NNG;인상/NNG,63,1.4066513573036492,Hawkish
10,7, 물가/NNG;소폭/MAG;상승/NNG,17,2.07432458219893,Hawkish
11,11, 신용/NNG;대출/NNG;감소/NNG,22,1.4520272075392509,Hawkish
13,10, 대중/NNG;무역/NNG;적자/NNG,23,1.887635369801026,Hawkish
10,7, 물가/NNG;높/VA;상승/NNG,17,2.07432458219893,Hawkish
11,9, 수요/NNG;긍정적/VAX,20,1.774699920325751,Hawkish
38,25, 일시적/VAX;둔화/NNG,63,2.2070813554596613,Hawkish
14,13, 이익/NNG;확보/NNG,27,1.5637216081191931,Hawkish
13,10, 긴축/NNG;압력/NNG,23,1.887635369801026,Hawkish
13,4, 재고/NNG;상승/NNG,17,4.719088424502566,Hawkish
10,11, 판매/NNG;상승/NNG,21,1.3200247341265916,Hawkish
22,13, 소비자/NNG;물가/NNG;예상/NNG;낮/VA,35,2.457276812758732,Hawkish
17,3, 장기물/NNG;비중/NNG;축소/NNG,20,8.228154176055755,Hawkish
44,18, 예대/NNG;금리/NNG;인상/NNG,62,3.549399840651502,Hawkish
32,28, 컨센서스/NNG;하회/NNG,60,1.6594596657591438,Hawkish
41,38, 물가/NNG;고공행진/NNG,79,1.5666609344502442,Hawkish
19,21, 몰아갈/VV,40,1.3137389020593222,Hawkish
77,80, 수뇌부/NNG,157,1.3975761872565289,Hawkish
26,8, 변이/NNG,34,4.719088424502566,Hawkish
61,60, 유진/NNG,121,1.4762276609982383,Hawkish
14,12, 투자/NNG;규제/NNG;강화/NNG,26,1.6940317421291258,Hawkish
30,27, 하락/NNG;가능성/NNG;높/VA,57,1.6133635639325008,Hawkish
48,20, 안정/NNG;긍정적/VAX,68,3.484865298094202,Hawkish
14,14, 긍정적/VAX;성장/NNG,28,1.4520272075392509,Hawkish
19,18, 강하/VA;매파/NNG,37,1.5326953857358758,Hawkish
88,93, 금리/NNG;인상/NNG;악재/NNG,181,1.3739612286392908,Hawkish
21,21, 전망/NNG;악재/NNG,42,1.4520272075392509,Hawkish
116,76, 집세/NNG,192,2.2162520536125405,Hawkish
41,39, 경제동향자료/NNG,80,1.5264901412592125,Hawkish
82,80, 매수의견/NNG,162,1.488327887727732,Hawkish
17,5, 세계/NNG;경제/NNG;신흥국/NNG;경제/NNG;호조/NNG,22,4.936892505633453,Hawkish
25,12, 국제/NNG;원자재/NNG;가격/NNG;오르/VV,37,3.025056682373439,Hawkish
19,16, 수요측면/NNG;물가/NNG;압력/NNG,35,1.7242823089528605,Hawkish
14,3, 채소/NNG;가격/NNG;안정/NNG,17,6.776126968516503,Hawkish
108,107, 경기/NNG;연착륙/NNG,215,1.4655975552732625,Hawkish
11,5, 서다/NNG,16,3.1944598565863513,Hawkish
30,24, 매월/NNG,54,1.8150340094240633,Hawkish
22,19, 기다림/VV,41,1.6812946613612378,Hawkish
18,6, 금리/NNG;인상/NNG;원화/NNG;절상/NNG,24,4.356081622617753,Hawkish
34,18, 절상/NNG;효과/NNG,52,2.7427180586852518,Hawkish
11,6, 불확실성/NNG;해소/NNG;강세/NNG,17,2.662049880488626,Hawkish
15,15, 구제금융/NNG;우려/NNG,30,1.4520272075392506,Hawkish
34,33, 구체안/NNG,67,1.4960280320101373,Hawkish
13,13, 조세조약/NNG,26,1.4520272075392509,Hawkish
12,9, 체결국/NNG,21,1.9360362767190011,Hawkish
19,2, 화전/NNG,21,13.794258471622884,Hawkish
23,16, 법인세법/NNG,39,2.087289110837673,Hawkish
294,306, 세법/NNG,600,1.395084964106339,Hawkish
22,23, 건전성/NNG;높/VA,45,1.388895589820153,Hawkish
30,25, 세모/NNG,55,1.742432649047101,Hawkish
139,98, 빈도/NNG,237,2.059507978040366,Hawkish
27,27, 가격규제/NNG,54,1.4520272075392506,Hawkish
540,555, 손익/NNG,1095,1.412783228957109,Hawkish
18,6, 챌린지/NNG,24,4.356081622617753,Hawkish
37,3, 모집주선/NNG,40,17.90833555965076,Hawkish
19,21, 산품/NNG,40,1.3137389020593222,Hawkish
9,9, 경상/NNG;수지/NNG;상품/NNG;수지/NNG;흑자/NNG,18,1.4520272075392509,Hawkish
24,19, 신규/NNG;주택/NNG;판매/NNG;증가/NNG,43,1.834139630575896,Hawkish
20,22, 단기/NNG;불확실성/NNG;해소/NNG,42,1.3200247341265916,Hawkish
27,26, 기대/NNG;인플레이션/NNG;오르/VV,53,1.5078744078292219,Hawkish
20,17, 소매/NNG;판매/NNG;상승/NNG,37,1.7082673029873539,Hawkish
10,10, 인상/NNG;가능성/NNG;강하/VA,20,1.4520272075392509,Hawkish
25,27, 준이/NNG,52,1.3444696366104174,Hawkish
37,13, 면화/NNG,50,4.1326928214578675,Hawkish
24,15, 준/NNG,39,2.3232435320628015,Hawkish
39,36, 유통량/NNG,75,1.5730294748341884,Hawkish
33,3, 생산함수/NNG,36,15.972299282931756,Hawkish
36,33, 최소화/NNG,69,1.58402968095191,Hawkish
59,62, 물가/NNG;상승/NNG;금리/NNG;인상/NNG,121,1.381767826529287,Hawkish
16,10, 저금리/NNG;부작용/NNG;우려/NNG,26,2.323243532062801,Hawkish
50,41, 재정/NNG;건전성/NNG;강화/NNG,91,1.7707648872429889,Hawkish
11,10, 경기/NNG;회복/NNG;상승/NNG,21,1.5972299282931757,Hawkish
8,8, 금리/NNG;물가/NNG;안정/NNG,16,1.4520272075392506,Hawkish
24,16, 금리/NNG;인상/NNG;제약/NNG,40,2.1780408113088763,Hawkish
16,12, 장기물/NNG;비중/NNG;늘/VV,28,1.9360362767190007,Hawkish
29,25, 예상/NNG;완화/NNG,54,1.684351560745531,Hawkish
11,12, 금리/NNG;반등/NNG,23,1.331024940244313,Hawkish
25,22, 성장/NNG;견조/NNG,47,1.6500309176582397,Hawkish
48,21, 채권/NNG;금리/NNG;하향/NNG;안정/NNG,69,3.3189193315182877,Hawkish
14,15, 금리/NNG;인상/NNG;부담/NNG;덜/VV,29,1.3552253937033008,Hawkish
13,8, 인플레이션/NNG;부담/NNG;크/VV,21,2.359544212251283,Hawkish
24,15, 차기/NNG;금리/NNG;인상/NNG,39,2.3232435320628015,Hawkish
17,17, 무궁화/NNG,34,1.4520272075392509,Hawkish
24,4, 포텐셜/NNG,28,8.712163245235505,Hawkish
11,12, 역경/NNG,23,1.331024940244313,Hawkish
128,129, 언더퍼폼/NNG,257,1.4407711826746052,Hawkish
65,58, 부국/NNG,123,1.6272718705181257,Hawkish
17,1, 권신/NNG,18,24.684462528167266,Hawkish
18,7, 금리/NNG;하락/NNG;지지/NNG,25,3.733784247958074,Hawkish
15,16, 가격/NNG;부담/NNG;해소/NNG,31,1.3612755070680476,Hawkish
29,20, 주택/NNG;경기/NNG;바닥/NNG,49,2.1054394509319136,Hawkish
31,30, 회복/NNG;쉽/VA;않/VX,61,1.5004281144572258,Hawkish
35,34, 강하/VA;우려/NNG,69,1.4947338901139346,Hawkish
122,58,도발/NNG,180,3.0542641262032517,Hawkish
33,6, 해안포/NNG,39,7.986149641465878,Hawkish
916,663, 도발/NNG,1579,2.0061190378672005,Hawkish
39,41, 하부/NNG,80,1.3811966120495314,Hawkish
11,11, 되/NNG,22,1.4520272075392509,Hawkish
9,7, 안전자산/NNG;선호/NNG;금리/NNG;하락/NNG,16,1.866892123979037,Hawkish
25,6, 가변성/NNG,31,6.050113364746878,Hawkish
19,11, 행로/NNG,30,2.5080469948405244,Hawkish
26,27, 현존/NNG,53,1.3982484220748341,Hawkish
52,54, 계승/NNG,106,1.3982484220748341,Hawkish
82,52, 투자등급채/NNG,134,2.2897352118888183,Hawkish
316,56, 연합자산관리/NNG,372,8.193582099685774,Hawkish
51,55, 공동투자/NNG,106,1.3464252288091234,Hawkish
33,25, 소비자/NNG;심리/NNG;지수/NNG;상승/NNG,58,1.916675913951811,Hawkish
48,25, 금리/NNG;인상/NNG;원화/NNG;강세/NNG,73,2.787892238475362,Hawkish
17,7, 채권시장/NNG;지정학/NNG;위험/NNG,24,3.526351789738181,Hawkish
18,14, 금융시장/NNG;영향/NNG;제한적/VAX,32,1.866892123979037,Hawkish
10,6, 가격/NNG;임금/NNG;상승/NNG,16,2.420045345898751,Hawkish
21,6, 경기/NNG;물가/NNG;안정/NNG,27,5.082095226387377,Hawkish
49,45, 북한리스크/NNG;완화/NNG,94,1.581096292653851,Hawkish
26,5, 듀레이션/NNG;증가/NNG,31,7.550541479204104,Hawkish
34,32, 활기차/VA,66,1.5427789080104541,Hawkish
174,62, 포격/NNG,236,4.075044098577898,Hawkish
33,24, 교체기/NNG,57,1.9965374103664695,Hawkish
37,35, 기껏해야/MAG,72,1.5350001908272082,Hawkish
35,33, 한미연합훈련/NNG,68,1.5400288564810236,Hawkish
14,15, 수익/NNG;방어/NNG,29,1.3552253937033008,Hawkish
11,12, 금리/NNG;하방/NNG;경직/NNG;강화/NNG,23,1.331024940244313,Hawkish
16,5, 경제/NNG;자생력/NNG;회복/NNG,21,4.646487064125602,Hawkish
14,7, 유로존/NNG;위험/NNG;완화/NNG,21,2.9040544150785017,Hawkish
12,10, 일시적/VAX;개선/NNG,22,1.742432649047101,Hawkish
46,27, 높/VA;긴축/NNG,73,2.473824131363168,Hawkish
202,210, 민간/NNG;고용/NNG;증가/NNG,412,1.3967118853472793,Hawkish
27,18, 배가/NNG,45,2.1780408113088763,Hawkish
236,234, 유통수익률/NNG,470,1.4644376964925776,Hawkish
15,8, 유동성/NNG;증가/NNG;둔화/NNG,23,2.722551014136095,Hawkish
28,8, 하락/NNG;경기/NNG;둔화/NNG,36,5.082095226387378,Hawkish
17,15, 물가/NNG;상승/NNG;꺾/VV,32,1.645630835211151,Hawkish
55,45, 재정위기/NNG;불안/NNG,100,1.774699920325751,Hawkish
9,7, 저평가/NNG;축소/NNG,16,1.866892123979037,Hawkish
10,11, 하락/NNG;양호/NNG,21,1.3200247341265916,Hawkish
18,18, 경기/NNG;확대/NNG,36,1.4520272075392509,Hawkish
18,2, 원외/NNG,20,13.068244867853258,Hawkish
19,9, 부진/NNG;경제/NNG;회복/NNG,28,3.0653907714717517,Hawkish
19,18, 어렵/VA;금리/NNG;상승/NNG,37,1.5326953857358758,Hawkish
12,6, 대차/VA,18,2.9040544150785017,Hawkish
18,18, 실타래/NNG,36,1.4520272075392509,Hawkish
13,5, 금리/NNG;상승/NNG;압력/NNG;제한/NNG,18,3.775270739602052,Hawkish
10,6, 임금/NNG;안정/NNG,16,2.420045345898751,Hawkish
19,16, 쉽/VA;개선/NNG,35,1.7242823089528605,Hawkish
53,22, 경제/NNG;강세/NNG,75,3.498065545435468,Hawkish
8,8, 대내외/NNG;경제/NNG;여건/NNG;불확실성/NNG,16,1.4520272075392506,Hawkish
14,11, 지닐/VV,25,1.8480346277772284,Hawkish
194,198, 멘/NNG,392,1.42269332455866,Hawkish
25,23, 재정위기/NNG;불확실성/NNG,48,1.5782904429774465,Hawkish
10,6, 호조/NNG;효과/NNG,16,2.420045345898751,Hawkish
25,27, 원계/NNG,52,1.3444696366104174,Hawkish
14,11, 장지/NNG,25,1.8480346277772284,Hawkish
10,10, 호불호/NNG,20,1.4520272075392509,Hawkish
28,11, 건/VA,39,3.6960692555544568,Hawkish
32,32, 기대/NNG;인플레이션/NNG;안정/NNG,64,1.4520272075392506,Hawkish
29,30, 대외/NNG;불확실성/NNG;완화/NNG,59,1.4036263006212757,Hawkish
13,12, 대외/NNG;경기/NNG;회복/NNG,25,1.5730294748341882,Hawkish
125,132, 내수/NNG;경기/NNG;회복/NNG,257,1.3750257647151995,Hawkish
10,10, 지수/NNG;호전/NNG,20,1.4520272075392509,Hawkish
9,10, 하락/NNG;증가/NNG,19,1.3068244867853258,Hawkish
13,6, 대내외/NNG;경기/NNG;둔화/NNG,19,3.1460589496683764,Hawkish
24,26, 배당락일/NNG,50,1.3403328069593086,Hawkish
90,39, 장기부채/NNG,129,3.350832017398271,Hawkish
90,69, 미정/NNG,159,1.8939485315729356,Hawkish
34,22, 원면/NNG,56,2.244042048015206,Hawkish
13,12, 자본/NNG;유입/NNG;억제/NNG,25,1.5730294748341882,Hawkish
46,45, 가격/NNG;상승/NNG;둔화/NNG,91,1.4842944788179007,Hawkish
28,26, 거시건전성부담금/NNG,54,1.5637216081191931,Hawkish
28,13, 차이나플레이션/NNG,41,3.1274432162383863,Hawkish
21,22, 경제/NNG;인플레이션/NNG;압력/NNG,43,1.3860259708329212,Hawkish
24,25, 가격/NNG;감소/NNG,49,1.393946119237681,Hawkish
97,103, 힘없이/MAG,200,1.3674430983622072,Hawkish
17,12, 선진국/NNG;금리/NNG;상승/NNG,29,2.0570385440139387,Hawkish
31,30, 펀더멘털/NNG;취약/NNG,61,1.5004281144572258,Hawkish
30,28, 지정학/NNG;위험/NNG;우려/NNG,58,1.5557434366491973,Hawkish
621,665, 대북/NNG,1286,1.3559532268900374,Hawkish
10,10, 일동/NNG,20,1.4520272075392509,Hawkish
31,18, 금리/NNG;대출/NNG;금리/NNG;인상/NNG,49,2.5007135240953766,Hawkish
137,130, 물가/NNG;상승/NNG;억제/NNG,267,1.5302132879452106,Hawkish
30,33, 서서히/MAG;완화/NNG,63,1.3200247341265916,Hawkish
23,14, 예산처/NNG,37,2.3854732695287693,Hawkish
40,30, 지출비중/NNG,70,1.936036276719001,Hawkish
54,46, 경제/NNG;전망/NNG;상향/NNG,100,1.7045536784156423,Hawkish
16,11, 재정/NNG;적자/NNG;증가/NNG,27,2.1120395746025467,Hawkish
14,11, 전망/NNG;견조/NNG,25,1.8480346277772284,Hawkish
22,18, 악화/NNG;금리/NNG;인상/NNG,40,1.774699920325751,Hawkish
421,436, 뮤추얼펀드/NNG,857,1.4020721430596894,Hawkish
15,12, 만기물별/NNG,27,1.8150340094240633,Hawkish
16,12, 경기/NNG;상승/NNG;모멘텀/NNG,28,1.9360362767190007,Hawkish
11,7, 민간/NNG;부채/NNG;부담/NNG,18,2.2817570404188228,Hawkish
17,18, 기대/NNG;점차/MAG;크/VV,35,1.3713590293426259,Hawkish
10,8, 국채시장/NNG;활성화/NNG,18,1.8150340094240636,Hawkish
31,15, 고용시장/NNG;위축/NNG,46,3.0008562289144516,Hawkish
25,19, 일시적/VAX;중단/NNG,44,1.9105621151832248,Hawkish
9,10, 전망/NNG;호조/NNG,19,1.3068244867853258,Hawkish
14,12, 유로존/NNG;높/VA,26,1.6940317421291258,Hawkish
12,13, 구인구직비율/NNG,25,1.3403328069593086,Hawkish
20,3, 인플레이션/NNG;압력/NNG;해소/NNG,23,9.680181383595004,Hawkish
16,14, 수요측면/NNG;압력/NNG,30,1.6594596657591438,Hawkish
9,8, 물가/NNG;우려/NNG;높/VA,17,1.6335306084816572,Hawkish
18,16, 바젤은행감독위원회/NNG,34,1.6335306084816572,Hawkish
44,37, 수신/NNG;금리/NNG;인상/NNG,81,1.726735057614244,Hawkish
10,8, 쟈/NNG,18,1.8150340094240636,Hawkish
12,11, 옥수/NNG,23,1.58402968095191,Hawkish
44,39, 인플레이션/NNG;금리/NNG;인상/NNG;우려/NNG,83,1.6381845418391547,Hawkish
15,4, 국제/NNG;원자재/NNG;가격/NNG;불안/NNG,19,5.44510202827219,Hawkish
26,13, 금리/NNG;인상/NNG;우려/NNG;확대/NNG,39,2.9040544150785017,Hawkish
11,6, 통화신용정책/NNG;물가/NNG;안정/NNG,17,2.662049880488626,Hawkish
20,21, 제조업/NNG;지수/NNG;상승/NNG,41,1.3828830547992865,Hawkish
48,50, 내구재/NNG;주문/NNG;증가/NNG,98,1.393946119237681,Hawkish
113,87, 인플레이션/NNG;통제/NNG,200,1.885966373010751,Hawkish
65,68, 성장/NNG;확대/NNG,133,1.3879671836772247,Hawkish
24,26, 장미빛/NNG,50,1.3403328069593086,Hawkish
53,49, 예언/NNG,102,1.5705600408077611,Hawkish
75,77, 위로/NNG,152,1.414312215135634,Hawkish
76,30, 나열/NNG,106,3.678468925766102,Hawkish
133,61, 란/NNG,194,3.165895386929842,Hawkish
19,21, 설왕설래/NNG,40,1.3137389020593222,Hawkish
98,1, 명만/NNG,99,142.2986663388466,Hawkish
198,165, 기일/NNG,363,1.7424326490471012,Hawkish
28,21, 금리/NNG;상단/NNG;막/VV,49,1.9360362767190011,Hawkish
151,151, 통안채/NNG;오르/VV,302,1.4520272075392506,Hawkish
11,9, 전망/NNG;매파/NNG,20,1.774699920325751,Hawkish
57,54, 강하/VA;자신/NNG,111,1.5326953857358756,Hawkish
119,83, 자문사/NNG,202,2.081822140929769,Hawkish
12,10, 랩어카운트상품/NNG,22,1.742432649047101,Hawkish
605,6, 코시/NNG,611,146.41274342687444,Hawkish
585,7, 멕/NNG,592,121.3479880586374,Hawkish
208,28, 핀/VV,236,10.786487827434435,Hawkish
208,1, 리필/NNG,209,302.0216591681642,Hawkish
32,6, 이레/VV,38,7.744145106876003,Hawkish
70,2, 시네/VV,72,50.820952263873785,Hawkish
63,0, 인국/NNG,63,inf,Hawkish
355,12, 헝/MAG,367,42.95580488970283,Hawkish
21,15, 자산운용시장/NNG,36,2.032838090554951,Hawkish
147,150, 전망/NNG;긍정적/VAX,297,1.4229866633884658,Hawkish
46,29, 투자/NNG;과열/NNG,75,2.303215570579501,Hawkish
64,46, 인해서/VV,110,2.0202117670111313,Hawkish
21,20, 성수품/NNG,41,1.5246285679162133,Hawkish
12,13, 수요견인/NNG;인플레이션/NNG;압력/NNG,25,1.3403328069593086,Hawkish
23,23, 금리/NNG;인상/NNG;억제/NNG,46,1.4520272075392506,Hawkish
9,7, 물가/NNG;심상/NNG;않/VX,16,1.866892123979037,Hawkish
50,37, 높/VA;물가/NNG;상승/NNG,87,1.9621989291070956,Hawkish
94,75,기습/NNG,169,1.819874100115861,Hawkish
26,15, 이루어진다면/VV,41,2.5168471597347013,Hawkish
20,0, 통화정책/NNG;경제/NNG;견조/NNG;성장/NNG,20,inf,Hawkish
18,15, 금리/NNG;인상/NNG;물가/NNG;상승/NNG,33,1.742432649047101,Hawkish
28,7, 예상/NNG;깨/VV;금리/NNG;인상/NNG,35,5.808108830157003,Hawkish
60,60, 인플레이션/NNG;기대/NNG;높/VA,120,1.4520272075392506,Hawkish
20,17, 금리/NNG;물가/NNG;상승/NNG,37,1.7082673029873539,Hawkish
15,10, 국고채/NNG;고점/NNG,25,2.178040811308876,Hawkish
14,11, 둔화/NNG;효과/NNG,25,1.8480346277772284,Hawkish
33,30, 주연/NNG,63,1.5972299282931757,Hawkish
15,10, 결정시점/NNG,25,2.178040811308876,Hawkish
29,19, 물가안정정책/NNG,48,2.2162520536125405,Hawkish
106,53, 베이비스텝/NNG,159,2.9040544150785017,Hawkish
24,20, 잠재성장력/NNG,44,1.742432649047101,Hawkish
43,38, 평가금액/NNG,81,1.6430834190575734,Hawkish
15,11, 수입/NNG;물가/NNG;상승/NNG;압력/NNG,26,1.9800371011898874,Hawkish
18,17, 물가/NNG;상승/NNG;압력/NNG;둔화/NNG,35,1.5374405726886184,Hawkish
14,3, 베이비스텝/NNG;금리/NNG;인상/NNG,17,6.776126968516503,Hawkish
22,15, 안정/NNG;금리/NNG;인상/NNG,37,2.129639904390901,Hawkish
21,18, 대출/NNG;금리/NNG;상향/NNG,39,1.6940317421291258,Hawkish
18,4, 도매/NNG;재고/NNG;감소/NNG,22,6.534122433926629,Hawkish
42,28, 전세가격/NNG;안정/NNG,70,2.1780408113088763,Hawkish
18,20, 제조업/NNG;호조/NNG,38,1.3068244867853258,Hawkish
15,11, 절상/NNG;확대/NNG,26,1.9800371011898874,Hawkish
132,40, 보험자산/NNG,172,4.791689784879527,Hawkish
11,6, 실적/NNG;영향/NNG;줄/VV,17,2.662049880488626,Hawkish
10,9, 개선/NNG;불확실성/NNG,19,1.6133635639325008,Hawkish
21,17, 공급/NNG;압력/NNG,38,1.7936806681367214,Hawkish
21,22, 주택/NNG;경기/NNG;개선/NNG,43,1.3860259708329212,Hawkish
23,6, 고등급/NNG,29,5.566104295567127,Hawkish
46,34, 구정/NNG,80,1.9645073984354566,Hawkish
11,10, 만개/NNG,21,1.5972299282931757,Hawkish
143,145, 홍수/NNG,288,1.4319992460559507,Hawkish
132,120, 갑/NNG,252,1.5972299282931757,Hawkish
17,0, 평신/NNG,17,inf,Hawkish
10,7, 수요/NNG;압력/NNG;증가/NNG,17,2.07432458219893,Hawkish
15,15, 양호/NNG;상승/NNG,30,1.4520272075392506,Hawkish
69,43, 설날/NNG,112,2.3299971469815888,Hawkish
291,321, 격화/NNG,612,1.3163237301991337,Hawkish
88,11, 이집트사태/NNG,99,11.616217660314007,Hawkish
378,164, 순매수금액/NNG,542,3.3467456368892488,Hawkish
65,60, 자본비용/NNG,125,1.5730294748341882,Hawkish
65,67, 공백기/NNG,132,1.4086831117918104,Hawkish
20,13, 금용/NNG,33,2.2338880115988475,Hawkish
14,9, 경기/NNG;지수/NNG;상승/NNG,23,2.258708989505501,Hawkish
11,6, 우려/NNG;물가/NNG;상승/NNG,17,2.662049880488626,Hawkish
12,11, 자산/NNG;듀레이션/NNG;늘/VV,23,1.58402968095191,Hawkish
11,8, 하락/NNG;바닥/NNG,19,1.9965374103664697,Hawkish
9,7, 정치/NNG;불안/NNG;안전자산/NNG;선호/NNG,16,1.866892123979037,Hawkish
8,8, 안전자산/NNG;선호/NNG;강화/NNG;강세/NNG,16,1.4520272075392506,Hawkish
22,18, 소비/NNG;심리/NNG;둔화/NNG,40,1.774699920325751,Hawkish
60,34, 유로존/NNG;금리/NNG;인상/NNG,94,2.5624009544810304,Hawkish
15,13, 통화정책/NNG;매파/NNG,28,1.6754160086991354,Hawkish
29,10, 단기물/NNG;금리/NNG;부담/NNG,39,4.210878901863827,Hawkish
34,37, 단기물/NNG;부담/NNG,71,1.3342952717928251,Hawkish
49,2, 원전사태/NNG,51,35.57466658471165,Hawkish
20,1, 방사능유출사태/NNG,21,29.040544150785017,Hawkish
33,2, 과도/NNG;축소/NNG,35,23.958448924397636,Hawkish
11,6, 유엔군/NNG,17,2.662049880488626,Hawkish
336,313, 긴축안/NNG,649,1.5587256924383013,Hawkish
24,18, 금리/NNG;인상/NNG;가능성/NNG;금리/NNG;인상/NNG,42,1.9360362767190011,Hawkish
34,30, 채권시장/NNG;안전자산/NNG;선호/NNG,64,1.645630835211151,Hawkish
297,230, 보입니다/VV,527,1.8750090462572067,Hawkish
28,28, 채권시장/NNG;가격/NNG;부담/NNG,56,1.4520272075392509,Hawkish
566,383, ecb/NNG;금리/NNG;인상/NNG,949,2.1458156644052635,Hawkish
13,12, 높/VA;가격/NNG;부담/NNG,25,1.5730294748341882,Hawkish
18,15, 증시주변자금/NNG,33,1.742432649047101,Hawkish
466,7, 저작물/NNG,473,96.66352553047014,Hawkish
448,78, 전송/NNG,526,8.339848576635697,Hawkish
69,67, 대주/NNG,136,1.4953713032866913,Hawkish
18,18, 산업활동/NNG;부진/NNG,36,1.4520272075392509,Hawkish
20,22, 채권시장/NNG;매파/NNG,42,1.3200247341265916,Hawkish
88,36, 틱스/NNG,124,3.549399840651502,Hawkish
13,9, 유로존/NNG;재정/NNG;우려/NNG,22,2.097372633112251,Hawkish
9,10, 글로벌/NNG;통화/NNG;긴축/NNG,19,1.3068244867853258,Hawkish
22,15, 금리/NNG;인상/NNG;약세/NNG,37,2.129639904390901,Hawkish
24,5, 경기/NNG;불확실성/NNG;증가/NNG,29,6.969730596188404,Hawkish
652,579,긴축/NNG,1231,1.6350979953637161,Hawkish
142,140, 분사/NNG,282,1.4727704533612402,Hawkish
104,60, 경쟁심/NNG,164,2.5168471597347013,Hawkish
443,141, 대지진/NNG,584,4.562042928651689,Hawkish
32,24, 의연/NNG,56,1.9360362767190007,Hawkish
12,7, 헛발/NNG,19,2.489189498638716,Hawkish
11,12, 디딜/VV,23,1.331024940244313,Hawkish
28,0, 유통비중/NNG,28,inf,Hawkish
147,164, 카드업계/NNG,311,1.3015121921235968,Hawkish
87,44, 리트/NNG,131,2.8710537967253367,Hawkish
21,4, 환발/NNG,25,7.6231428395810665,Hawkish
27,7, 교통공사/NNG,34,5.60067637193711,Hawkish
47,18, 할인채/NNG,65,3.7914043752413766,Hawkish
11,10, 보증사채/NNG,21,1.5972299282931757,Hawkish
82,66, 비상장/NNG,148,1.8040338033063419,Hawkish
94,103, 언론사/NNG,197,1.325151043773685,Hawkish
22,1, 원호/NNG,23,31.944598565863515,Hawkish
25,9, 수실/NNG,34,4.033408909831253,Hawkish
23,0, 상호기금/NNG,23,inf,Hawkish
75,77, 번역/NNG,152,1.414312215135634,Hawkish
31,34, 사회보장제도/NNG,65,1.3239071598151992,Hawkish
10,7, 근사/NNG,17,2.07432458219893,Hawkish
66,60, 국방비/NNG,126,1.5972299282931757,Hawkish
29,29, 제하/VV,58,1.4520272075392509,Hawkish
10,6, 순현재가치/NNG,16,2.420045345898751,Hawkish
27,17, 인구증가율/NNG,44,2.3061608590329277,Hawkish
10,6, 맘껏/MAG,16,2.420045345898751,Hawkish
175,157, 사회보장/NNG,332,1.6185016644545789,Hawkish
26,23, 욕/NNG,49,1.6414220606965444,Hawkish
37,37, 신용/NNG;대출/NNG;증가/NNG,74,1.4520272075392509,Hawkish
23,7, 콜/NNG;금리/NNG;상승/NNG,30,4.7709465390575385,Hawkish
1672,813, 콜/NNG;금리/NNG;인상/NNG,2485,2.986210936046282,Hawkish
123,2, 크레딧/NNG;확대/NNG,125,89.29967326366393,Hawkish
11,5, 통제/NNG;실패/NNG,16,3.1944598565863513,Hawkish
24,21, 강하/VA;긴축/NNG,45,1.6594596657591438,Hawkish
69,25, 대내외/NNG;경기/NNG;불확실성/NNG,94,4.007595092808333,Hawkish
35,39, 물가/NNG;압력/NNG;높/VA,74,1.3031013400993277,Hawkish
92,90, 파이/VV,182,1.4842944788179007,Hawkish
41,34, 되돌아보/VV,75,1.7509739855620376,Hawkish
54,52, 단추/NNG,106,1.5078744078292219,Hawkish
16,2, 은행인수어음/NNG,18,11.616217660314005,Hawkish
29,21, 페이퍼/NNG,50,2.0051804294589655,Hawkish
13,11, 통화/NNG;증가율/NNG;둔화/NNG,24,1.7160321543645694,Hawkish
14,10, 노동/NNG;비용/NNG;감소/NNG,24,2.032838090554951,Hawkish
12,12, 양호/NNG;경제/NNG;성장/NNG,24,1.4520272075392509,Hawkish
11,11, 변동성/NNG;부담/NNG,22,1.4520272075392509,Hawkish
15,11, 물가/NNG;호조/NNG,26,1.9800371011898874,Hawkish
23,15, 황부/NNG,38,2.2264417182268508,Hawkish
22,23, 진과/NNG,45,1.388895589820153,Hawkish
34,36, 어가/NNG,70,1.3713590293426259,Hawkish
585,567, 견실/NNG,1152,1.4981233093658937,Hawkish
46,43, 열중/NNG,89,1.5533314313210589,Hawkish
32,30, 보유한도/NNG,62,1.5488290213752007,Hawkish
12,8, 도급순위/NNG,20,2.1780408113088763,Hawkish
62,52, 르네상스/NNG,114,1.731263208989107,Hawkish
109,119, 불거져/VV,228,1.3300081144687255,Hawkish
72,13, 자본총계/NNG,85,8.041996841755852,Hawkish
61,12, 자산총계/NNG,73,7.381138304991191,Hawkish
20,2, 통화정책/NNG;방향/NNG;물가/NNG;안정/NNG,22,14.520272075392509,Hawkish
30,30, 소비자/NNG;물가/NNG;상승/NNG;압력/NNG,60,1.4520272075392506,Hawkish
11,9, 물가/NNG;상승률/NNG;상향/NNG,20,1.774699920325751,Hawkish
13,13, 국고채/NNG;입찰/NNG;경계/NNG,26,1.4520272075392509,Hawkish
13,3, 물가/NNG;상승률/NNG;고점/NNG,16,6.292117899336753,Hawkish
14,7, 물가/NNG;상승/NNG;경계/NNG,21,2.9040544150785017,Hawkish
39,32, 경제/NNG;견실/NNG;성장/NNG,71,1.769658159188462,Hawkish
38,38, 높/VA;금리/NNG;오르/VV,76,1.4520272075392509,Hawkish
38,13, 물가/NNG;고점/NNG,51,4.24438722203781,Hawkish
41,37, 부채/NNG;감소/NNG,78,1.6090031218678182,Hawkish
10,7, 물가/NNG;상향/NNG,17,2.07432458219893,Hawkish
16,6, 기업분할/NNG,22,3.8720725534380014,Hawkish
46,32, 이의신청/NNG,78,2.087289110837673,Hawkish
21,18, 채로/NNG,39,1.6940317421291258,Hawkish
33,28, 가격/NNG;하락/NNG;우려/NNG,61,1.7113177803141169,Hawkish
18,8, 찾아낸/VV,26,3.2670612169633144,Hawkish
14,2, 국가기금/NNG,16,10.164190452774756,Hawkish
18,8, 아이비/NNG,26,3.2670612169633144,Hawkish
10,9, 소비자/NNG;기대/NNG;지수/NNG;상승/NNG,19,1.6133635639325008,Hawkish
14,13, 불확실성/NNG;해소/NNG;긍정적/VAX,27,1.5637216081191931,Hawkish
13,7, 채권시장/NNG;물가/NNG;상승/NNG,20,2.6966219568586087,Hawkish
642,686, 희/NNG,1328,1.3588942671139927,Hawkish
17,14, 해준다/XSV,31,1.7631758948690905,Hawkish
17,18, 경기/NNG;회복/NNG;불안/NNG,35,1.3713590293426259,Hawkish
10,8, 불안/NNG;유가/NNG;급락/NNG,18,1.8150340094240636,Hawkish
11,10, 부채/NNG;유예/NNG,21,1.5972299282931757,Hawkish
12,10, 부진/NNG;불안/NNG,22,1.742432649047101,Hawkish
42,29, 강하/VA;경계/NNG,71,2.102935955746501,Hawkish
81,75, 진심/NNG,156,1.5681893841423908,Hawkish
162,131, 소프트패치/NNG,293,1.7956366993996842,Hawkish
19,17, 생방송/NNG,36,1.622853937837986,Hawkish
10,9, 정보격차/NNG,19,1.6133635639325008,Hawkish
473,99, 캐피탈채/NNG,572,6.9374633249097535,Hawkish
22,23, 티셔츠/NNG,45,1.388895589820153,Hawkish
45,25, 억압/NNG,70,2.6136489735706516,Hawkish
10,9, 경기/NNG;상하방/NNG;위험/NNG,19,1.6133635639325008,Hawkish
33,32, 물가/NNG;압력/NNG;완화/NNG,65,1.4974030577748523,Hawkish
20,21, 금리/NNG;하락/NNG;작/VA,41,1.3828830547992865,Hawkish
12,7, 부채비율/NNG;축소/NNG,19,2.489189498638716,Hawkish
13,3, 경기/NNG;불확실성/NNG;금리/NNG;인상/NNG,16,6.292117899336753,Hawkish
22,13,소프트패치/NNG,35,2.457276812758732,Hawkish
23,11, 기업/NNG;펀더멘털/NNG;개선/NNG,34,3.0360568884911605,Hawkish
25,1, 상향/NNG;등급/NNG;상향/NNG,26,36.30068018848127,Hawkish
17,4, 하락/NNG;소폭/MAG;확대/NNG,21,6.171115632041817,Hawkish
32,23, 미/NNG;경기/NNG;둔화/NNG,55,2.0202117670111313,Hawkish
12,4, 소프트패치/NNG;우려/NNG,16,4.356081622617753,Hawkish
36,31, 재투자/NNG;중단/NNG,67,1.6862251442391303,Hawkish
16,1, 불확실성/NNG;증가/NNG;금리/NNG;인상/NNG,17,23.23243532062801,Hawkish
96,96, 생산/NNG;차질/NNG,192,1.4520272075392509,Hawkish
18,19, 소비/NNG;경기/NNG;둔화/NNG,37,1.375604722931922,Hawkish
23,25, 재정위기/NNG;우려/NNG;완화/NNG,48,1.3358650309361106,Hawkish
99,43, 총채/NNG,142,3.3430393847996704,Hawkish
37,22, 기관채/NNG,59,2.4420457581341948,Hawkish
33,29, 총액/NNG;한도/NNG;대출/NNG;축소/NNG,62,1.6523068223722508,Hawkish
35,38, 경제/NNG;고성장/NNG,73,1.3373934806282575,Hawkish
35,24, 주문/NNG;증가/NNG,59,2.1175396776614073,Hawkish
126,91, 위험가중치/NNG,217,2.010499210438963,Hawkish
146,78, 이상거래/NNG,224,2.717897080778598,Hawkish
127,100, 거래금액/NNG,227,1.8440745535748486,Hawkish
286,0, 채여/VV,286,inf,Hawkish
66,21, 만기액/NNG,87,4.563514080837645,Hawkish
401,19, 만기금액/NNG,420,30.645416327538925,Hawkish
99,78, 과중/NNG,177,1.8429576095690492,Hawkish
49,5, 행계/NNG,54,14.229866633884658,Hawkish
37,11, 계속사업/NNG,48,4.8840915162683896,Hawkish
371,304, 영업이익률/NNG,675,1.772046361832441,Hawkish
51,14, 이노베이션/NNG,65,5.289527684607271,Hawkish
46,12, 부채총계/NNG,58,5.566104295567127,Hawkish
35,21, 리스사/NNG,56,2.4200453458987514,Hawkish
9,7, 하락/NNG;커브/NNG;플래트닝/NNG,16,1.866892123979037,Hawkish
52,6, 크레딧/NNG;시장/NNG;약세/NNG,58,12.584235798673506,Hawkish
17,0, 크레딧/NNG;거래/NNG;감소/NNG,17,inf,Hawkish
20,15, 장기물/NNG;수요/NNG;증가/NNG,35,1.936036276719001,Hawkish
9,10, 발행/NNG;금리/NNG;인상/NNG,19,1.3068244867853258,Hawkish
12,9, 금융위기/NNG;확대/NNG,21,1.9360362767190011,Hawkish
13,10, 부채비율/NNG;감소/NNG,23,1.887635369801026,Hawkish
82,81, 수익성/NNG;저하/NNG,163,1.469953469360723,Hawkish
39,22, 여력/NNG;감소/NNG,61,2.574048231546854,Hawkish
51,48, 정배열/NNG,99,1.542778908010454,Hawkish
38,42, 고용자/NNG,80,1.3137389020593222,Hawkish
62,38, 입찰일/NNG,100,2.369097022827199,Hawkish
19,7, 핵심/NNG;물가/NNG;상승/NNG,26,3.941216706177967,Hawkish
23,20, 고용시장/NNG;둔화/NNG,43,1.6698312886701383,Hawkish
34,31, 연체율/NNG;증가/NNG,65,1.5925459695591786,Hawkish
14,11, 이중침체/NNG;없/VA,25,1.8480346277772284,Hawkish
8,8, 작/VA;우려/NNG,16,1.4520272075392506,Hawkish
49,54, 빗나간/VV,103,1.3175802438782092,Hawkish
79,10, 순매도우위/NNG,89,11.471014939560082,Hawkish
88,1, 봉차트/NNG,89,127.77839426345406,Hawkish
61,65, 자금조달계획/NNG,126,1.362671687075297,Hawkish
58,33, 가지급금/NNG,91,2.5520478193114102,Hawkish
36,21, 개구리/NNG,57,2.4891894986387157,Hawkish
9,10, 끓이/VV,19,1.3068244867853258,Hawkish
13,11, 제친/VV,24,1.7160321543645694,Hawkish
47,36, 자본이익/NNG,83,1.8957021876206883,Hawkish
12,9, 구식/NNG,21,1.9360362767190011,Hawkish
39,35, 인공/NNG,74,1.6179731741151653,Hawkish
17,16, 뭉쳐/VV,33,1.5427789080104541,Hawkish
11,12, 젓/VV,23,1.331024940244313,Hawkish
39,25, 합시다/XSV,64,2.2651624437612314,Hawkish
12,8, 인플레이션/NNG;경기/NNG;회복/NNG,20,2.1780408113088763,Hawkish
39,40, 국채/NNG;금리/NNG;위험/NNG,79,1.4157265273507695,Hawkish
10,6, 인상/NNG;최대/NNG,16,2.420045345898751,Hawkish
19,10, 안정/NNG;강세/NNG,29,2.7588516943245764,Hawkish
25,26, 위험/NNG;안정/NNG,51,1.3961800072492796,Hawkish
34,32, 국채/NNG;위험/NNG,66,1.5427789080104541,Hawkish
40,39, 인플레이션/NNG;압력/NNG;둔화/NNG,79,1.4892586743992315,Hawkish
11,8, 금리/NNG;조정/NNG;압력/NNG,19,1.9965374103664697,Hawkish
23,5, 물가안정대책회의/NNG,28,6.679325154680553,Hawkish
15,12, 격한/VA,27,1.8150340094240633,Hawkish
43,34, 거국/NNG,77,1.8363873507114052,Hawkish
24,24, 괴롭힐/VV,48,1.4520272075392509,Hawkish
28,4, 만기월/NNG,32,10.164190452774756,Hawkish
41,30, 만기보장수익률/NNG,71,1.984437183636976,Hawkish
152,124, 우발채무/NNG,276,1.7799043189190817,Hawkish
137,113, 현금창출력/NNG,250,1.7604223666626315,Hawkish
21,19, 전환우선주/NNG,40,1.604872176753909,Hawkish
19,3, 화인/NNG,22,9.196172314415255,Hawkish
16,13, 리스크온오프/NNG,29,1.7871104092790777,Hawkish
34,20, 군중/NNG,54,2.4684462528167264,Hawkish
97,104, 대체에너지/NNG,201,1.3542946070318014,Hawkish
11,7, 추가증거금/NNG,18,2.2817570404188228,Hawkish
12,4, 정치가/NNG,16,4.356081622617753,Hawkish
56,26, 투기자금/NNG,82,3.1274432162383863,Hawkish
96,105, 중과/NNG,201,1.327567732607315,Hawkish
28,26, 해낼/VV,54,1.5637216081191931,Hawkish
132,140, 불허/NNG,272,1.3690542242512935,Hawkish
10,8, 언젠간/MAG,18,1.8150340094240636,Hawkish
48,37, 조일/VV,85,1.8837109719428118,Hawkish
39,41, 세계/NNG;경제/NNG;부진/NNG,80,1.3811966120495314,Hawkish
29,16, 미/NNG;경제/NNG;둔화/NNG,45,2.631799313664892,Hawkish
8,8, 인플레이션/NNG;거품/NNG,16,1.4520272075392506,Hawkish
12,12, 주택시장/NNG;약세/NNG,24,1.4520272075392509,Hawkish
29,26, 물가/NNG;전망/NNG;상향/NNG,55,1.6195688084091644,Hawkish
16,11, 긴축/NNG;지연/NNG,27,2.1120395746025467,Hawkish
30,7, 그리스긴축안/NNG,37,6.222973746596789,Hawkish
10,10, 제조업/NNG;경기/NNG;둔화/NNG;우려/NNG,20,1.4520272075392509,Hawkish
39,36, 말잔액/NNG,75,1.5730294748341884,Hawkish
14,11, 반올림/NNG,25,1.8480346277772284,Hawkish
27,1, 인순/NNG,28,39.20473460355977,Hawkish
36,0, 축역/NNG,36,inf,Hawkish
47,49, 인포/NNG,96,1.3927607909049955,Hawkish
44,0, 총합계/NNG,44,inf,Hawkish
14,6, 채이/VV,20,3.3880634842582515,Hawkish
31,29, 총합/NNG,60,1.552167014955751,Hawkish
9,8, 계주/NNG,17,1.6335306084816572,Hawkish
138,128, 사회당/NNG,266,1.5654668331282549,Hawkish
19,7, 무림/NNG,26,3.941216706177967,Hawkish
53,58, 주택/NNG;판매/NNG;증가/NNG,111,1.3268524482686257,Hawkish
34,25, 하락/NNG;부정적/VAX,59,1.9747570022533814,Hawkish
25,20, 구매력/NNG;개선/NNG,45,1.8150340094240636,Hawkish
76,70, 차입/NNG;부담/NNG,146,1.5764866824711867,Hawkish
141,152, 가격대/NNG,293,1.3469462912041734,Hawkish
25,20, 지니계수/NNG,45,1.8150340094240636,Hawkish
12,6, 탈리/NNG,18,2.9040544150785017,Hawkish
19,4, 총수요관리/NNG,23,6.897129235811442,Hawkish
10,8, 경기/NNG;부양/NNG;아니/VCN,18,1.8150340094240636,Hawkish
15,14, 정책/NNG;대응/NNG;강화/NNG,29,1.5557434366491973,Hawkish
15,14, 금리/NNG;목표/NNG;상향/NNG,29,1.5557434366491973,Hawkish
15,12, 연쇄점/NNG,27,1.8150340094240633,Hawkish
57,51, 기업/NNG;실적/NNG;회복/NNG,108,1.622853937837986,Hawkish
16,12, 금리/NNG;변동성/NNG;작/VA,28,1.9360362767190007,Hawkish
24,23, 경기/NNG;모멘텀/NNG;회복/NNG,47,1.5151588252583488,Hawkish
44,48, 외식비/NNG,92,1.331024940244313,Hawkish
19,14, 인수주체/NNG,33,1.9706083530889835,Hawkish
69,60, 그룹사/NNG,129,1.6698312886701385,Hawkish
17,12, 어려/VV,29,2.0570385440139387,Hawkish
243,250, 현금성자산/NNG,493,1.4113704457281517,Hawkish
18,15, 인플레이션/NNG;심리/NNG;확산/NNG,33,1.742432649047101,Hawkish
20,11, 부진/NNG;금리/NNG;하락/NNG,31,2.640049468253183,Hawkish
27,21, 경제/NNG;물가/NNG;안정/NNG,48,1.8668921239790368,Hawkish
140,130, 경제/NNG;체질/NNG;개선/NNG,270,1.5637216081191934,Hawkish
12,8, 국채/NNG;수요/NNG;감소/NNG,20,2.1780408113088763,Hawkish
44,26, 불합격/NNG,70,2.457276812758732,Hawkish
17,4, 크레딧/NNG;금리/NNG;하락/NNG,21,6.171115632041817,Hawkish
9,9, 대외/NNG;불확실/NNG,18,1.4520272075392509,Hawkish
205,216, 타이트/NNG,421,1.3780813775256777,Hawkish
14,7, 빚진/VV,21,2.9040544150785017,Hawkish
25,27, 얼음/NNG,52,1.3444696366104174,Hawkish
30,16, 민영/NNG,46,2.722551014136095,Hawkish
31,31, 가져온다/VV,62,1.452027207539251,Hawkish
116,124, 종교/NNG,240,1.3583480328592992,Hawkish
113,96, 평등/NNG,209,1.709157025540993,Hawkish
10,7, 다녀/VV,17,2.07432458219893,Hawkish
67,73, 방학/NNG,140,1.3326825055497233,Hawkish
21,20, 재능/NNG,41,1.5246285679162133,Hawkish
96,92, 과목/NNG,188,1.5151588252583488,Hawkish
150,142, 황금/NNG,292,1.5338315572597718,Hawkish
84,56, 짊어지/VV,140,2.1780408113088763,Hawkish
73,64, 고용주/NNG,137,1.6562185335994581,Hawkish
9,8, 인플레이션/NNG;기대/NNG;통제/NNG,17,1.6335306084816572,Hawkish
17,16, 경제/NNG;성장/NNG;걸림돌/NNG,33,1.5427789080104541,Hawkish
19,10, 하락/NNG;물가/NNG;안정/NNG,29,2.7588516943245764,Hawkish
16,7, 기업/NNG;가격/NNG;인상/NNG,23,3.3189193315182877,Hawkish
22,21, 통화/NNG;공급/NNG;증가/NNG,43,1.5211713602792152,Hawkish
10,8, 가계/NNG;부/NNG;감소/NNG,18,1.8150340094240636,Hawkish
20,21, 금리/NNG;하락/NNG;크/VV,41,1.3828830547992865,Hawkish
10,10, 대출/NNG;받/VV;힘들/VA,20,1.4520272075392509,Hawkish
27,27, 인플레이션/NNG;방지/NNG,54,1.4520272075392506,Hawkish
43,29, 인플레이션/NNG;성장/NNG,72,2.153005859454751,Hawkish
29,19, 긴축정책/NNG;효과/NNG,48,2.2162520536125405,Hawkish
20,11, 수익성/NNG;양호/NNG,31,2.640049468253183,Hawkish
19,15, 경제/NNG;일시적/VAX,34,1.839234462883051,Hawkish
13,13, 매파/NNG;인상/NNG,26,1.4520272075392509,Hawkish
140,153, 대출/NNG;제한/NNG,293,1.328652346767942,Hawkish
45,36, 경기체/NNG,81,1.8150340094240633,Hawkish
36,3, 긍정적/VAX;안정/NNG,39,17.42432649047101,Hawkish
92,93, 이끌어냈/VV,185,1.4364140117592585,Hawkish
57,26, 적자감축안/NNG,83,3.1832904165283575,Hawkish
9,7, 도호/NNG,16,1.866892123979037,Hawkish
50,50, 위험/NNG;축소/NNG,100,1.4520272075392509,Hawkish
12,13, 수출/NNG;급락/NNG,25,1.3403328069593086,Hawkish
10,10, 심리/NNG;살/VV;못하/VX,20,1.4520272075392509,Hawkish
23,18, 경영정상화계획/NNG,41,1.855368098522376,Hawkish
17,17, 위임장/NNG,34,1.4520272075392509,Hawkish
18,18, 결전/NNG,36,1.4520272075392509,Hawkish
17,8, 차입/NNG;상환/NNG;부담/NNG,25,3.0855578160209083,Hawkish
9,7, 우발채무/NNG;위험/NNG,16,1.866892123979037,Hawkish
76,80, 산업/NNG;성장/NNG,156,1.3794258471622882,Hawkish
51,17, 경기/NNG;모멘텀/NNG;개선/NNG,68,4.356081622617753,Hawkish
9,8, 요청안/NNG,17,1.6335306084816572,Hawkish
50,36, 감축계획/NNG,86,2.0167044549156263,Hawkish
38,21, 의회예산국/NNG,59,2.6274778041186444,Hawkish
72,67, 최종안/NNG,139,1.5603874469078518,Hawkish
40,28, 이라크전쟁/NNG,68,2.07432458219893,Hawkish
186,46, 덴/VV,232,5.871240447876101,Hawkish
99,99, 콩/NNG,198,1.4520272075392509,Hawkish
58,20, 핀/NNG,78,4.210878901863827,Hawkish
34,34, 누려왔/VV,68,1.4520272075392509,Hawkish
30,33, 개인기업/NNG,63,1.3200247341265916,Hawkish
35,32, 데드라인/NNG,67,1.5881547582460558,Hawkish
12,13, 금리/NNG;인상/NNG;경계/NNG;높/VA,25,1.3403328069593086,Hawkish
70,67, 부채한도/NNG;상향/NNG,137,1.5170433511604113,Hawkish
12,12, 부진/NNG;경기/NNG;둔화/NNG;우려/NNG,24,1.4520272075392509,Hawkish
16,14, 뜻한다/VV,30,1.6594596657591438,Hawkish
17,5, 까지/VA,22,4.936892505633453,Hawkish
97,58, 담보자산/NNG,155,2.4283903298501266,Hawkish
92,89, 청구권/NNG,181,1.5009719448720344,Hawkish
35,31, 립/NNG,66,1.6393855568991544,Hawkish
58,58, 투사/NNG,116,1.4520272075392509,Hawkish
22,7, 허상/NNG,29,4.5635140808376455,Hawkish
21,19, 형상/NNG,40,1.604872176753909,Hawkish
28,30, 왈/MAG,58,1.3552253937033008,Hawkish
18,20, 주름/NNG,38,1.3068244867853258,Hawkish
17,11, 금리/NNG;대출/NNG;금리/NNG;오르/VV,28,2.244042048015206,Hawkish
11,7, 경제/NNG;성장률/NNG;증가/NNG,18,2.2817570404188228,Hawkish
20,4, 위험/NNG;신용위험/NNG,24,7.260136037696254,Hawkish
23,20, 마진/NNG;줄/VV,43,1.6698312886701383,Hawkish
28,16, 등록발행/NNG,44,2.541047613193689,Hawkish
23,21, 신탁계정/NNG,44,1.5903155130191793,Hawkish
14,13, 유동성/NNG;양호/NNG,27,1.5637216081191931,Hawkish
27,22, 하락/NNG;불안/NNG,49,1.7820333910708988,Hawkish
19,15, 금리/NNG;하락/NNG;금리/NNG;인하/NNG,34,1.839234462883051,Hawkish
24,25, 하락/NNG;저점/NNG,49,1.393946119237681,Hawkish
14,12, 급락/NNG;되돌/VV,26,1.6940317421291258,Hawkish
13,8, 글로벌/NNG;주식시장/NNG;급락/NNG,21,2.359544212251283,Hawkish
8,8, 통화/NNG;절상/NNG;절하/NNG,16,1.4520272075392506,Hawkish
43,43, 절하/NNG;추세/NNG,86,1.4520272075392506,Hawkish
9,10, 불안/NNG;쉽/VA,19,1.3068244867853258,Hawkish
172,139, 경기민감업종/NNG,311,1.7967530913435332,Hawkish
21,19, 일신/NNG,40,1.604872176753909,Hawkish
32,20, 호국/NNG,52,2.323243532062801,Hawkish
77,53, 용선료/NNG,130,2.1095489618966474,Hawkish
20,11, 주택사업비중/NNG,31,2.640049468253183,Hawkish
15,7, 선투/NNG,22,3.1114868732983947,Hawkish
12,11, 남긴다/VV,23,1.58402968095191,Hawkish
11,9, 망설임/NNG,20,1.774699920325751,Hawkish
34,27, 다다를/VV,61,1.8284787057901677,Hawkish
11,10, 여태껏/MAG,21,1.5972299282931757,Hawkish
57,63, 실적/NNG;악화/NNG;우려/NNG,120,1.313738902059322,Hawkish
31,16, 급락/NNG;가능성/NNG;낮/VA,47,2.8133027146072984,Hawkish
10,8, 영업이익/NNG;흑자/NNG,18,1.8150340094240636,Hawkish
12,8, 업황/NNG;부정적/VAX,20,2.1780408113088763,Hawkish
11,7, 수주/NNG;둔화/NNG,18,2.2817570404188228,Hawkish
15,15, 추스리/VV,30,1.4520272075392506,Hawkish
12,9, 전망/NNG;경제/NNG;회복/NNG,21,1.9360362767190011,Hawkish
28,26, 에너지관련기업/NNG,54,1.5637216081191931,Hawkish
10,8, 금리/NNG;변동성/NNG;제한적/VAX,18,1.8150340094240636,Hawkish
12,11, 부외/NNG,23,1.58402968095191,Hawkish
49,42, 적임자/NNG,91,1.694031742129126,Hawkish
10,7, 소비/NNG;활력/NNG,17,2.07432458219893,Hawkish
61,51, 은행/NNG;대출/NNG;증가/NNG,112,1.7367384247038098,Hawkish
9,8, 올라선다/VV,17,1.6335306084816572,Hawkish
19,11, 가계/NNG;부채/NNG;문제/NNG;연착륙/NNG,30,2.5080469948405244,Hawkish
10,8, 가계/NNG;부채/NNG;문제/NNG;완화/NNG,18,1.8150340094240636,Hawkish
25,21, 대출/NNG;수요/NNG;감소/NNG,46,1.7286038184991082,Hawkish
16,14, 전세가격/NNG;인상/NNG,30,1.6594596657591438,Hawkish
9,7, 전세난/NNG;완화/NNG,16,1.866892123979037,Hawkish
77,79, 가격/NNG;통제/NNG,156,1.4152670250699029,Hawkish
19,12, 집세/NNG;상승/NNG,31,2.299043078603814,Hawkish
48,48, 황당/NNG,96,1.4520272075392509,Hawkish
24,22, 강렬/NNG,46,1.58402968095191,Hawkish
16,9, 부채/NNG;상환능력/NNG;약화/NNG,25,2.5813817022920014,Hawkish
18,9, 급락/NNG;저점/NNG,27,2.9040544150785017,Hawkish
33,36, 경영진단/NNG,69,1.331024940244313,Hawkish
90,91, 토마토/NNG,181,1.436070864599259,Hawkish
204,199, 프라임/NNG,403,1.4885103032060663,Hawkish
17,12, 파랑새/NNG,29,2.0570385440139387,Hawkish
17,2, 행정리/NNG,19,12.342231264083633,Hawkish
126,61, 모델포트폴리오/NNG,187,2.9992693139335347,Hawkish
44,5, 토지수익연계채권/NNG,49,12.777839426345405,Hawkish
14,2, 외인/NNG;자금/NNG;이탈/NNG;우려/NNG,16,10.164190452774756,Hawkish
17,14, 채권시장/NNG;소폭/MAG;약세/NNG,31,1.7631758948690905,Hawkish
12,4, 우려/NNG;쉽/VA;해소/NNG,16,4.356081622617753,Hawkish
39,40, 펀더멘털/NNG;훼손/NNG,79,1.4157265273507695,Hawkish
13,9, 심리/NNG;우려/NNG,22,2.097372633112251,Hawkish
60,50, 회복/NNG;어렵/VA,110,1.742432649047101,Hawkish
43,43, 상품군/NNG,86,1.4520272075392506,Hawkish
111,34, 하인/NNG,145,4.740441765789907,Hawkish
13,10, 수출/NNG;증가율/NNG;하락/NNG,23,1.887635369801026,Hawkish
40,25, 성장성/NNG;둔화/NNG,65,2.3232435320628015,Hawkish
10,8, 안정/NNG;낮/VA,18,1.8150340094240636,Hawkish
20,20, 뭐니뭐니/MAG,40,1.4520272075392509,Hawkish
9,9, 유로존/NNG;우려/NNG;완화/NNG,18,1.4520272075392509,Hawkish
123,113, 잡아가/VV,236,1.580525190507326,Hawkish
16,4, 채권시장/NNG;강세/NNG;지지/NNG,20,5.8081088301570025,Hawkish
46,26, 기어/NNG,72,2.568971213338674,Hawkish
11,10, 신호등/NNG,21,1.5972299282931757,Hawkish
58,56, 성장/NNG;경로/NNG;불확실성/NNG;높/VA,114,1.503885322094224,Hawkish
17,2, 금리/NNG;인하/NNG;논의/NNG;없/VA,19,12.342231264083633,Hawkish
55,58, 선진국/NNG;경제/NNG;회복/NNG,113,1.3769223519768758,Hawkish
15,14, 채권/NNG;금리/NNG;부담/NNG,29,1.5557434366491973,Hawkish
16,1, 위험/NNG;우려/NNG;높/VA,17,23.23243532062801,Hawkish
17,15, 수출/NNG;높/VA;신장/NNG,32,1.645630835211151,Hawkish
16,3, 높/VA;부진/NNG,19,7.744145106876003,Hawkish
27,28, 상해/NNG,55,1.4001690929842776,Hawkish
31,18, 소프트랜딩/NNG,49,2.5007135240953766,Hawkish
12,11, 숭/NNG,23,1.58402968095191,Hawkish
19,15, 가격변수/NNG;변동성/NNG;확대/NNG,34,1.839234462883051,Hawkish
21,14, 금리/NNG;변동성/NNG;제한/NNG,35,2.1780408113088763,Hawkish
10,6, 대출/NNG;확산/NNG,16,2.420045345898751,Hawkish
26,5, 보수성/NNG,31,7.550541479204104,Hawkish
79,66, 볼커룰/NNG,145,1.7380325666000123,Hawkish
131,2, 순포지션/NNG,133,95.10778209382093,Hawkish
24,25, 리포/NNG,49,1.393946119237681,Hawkish
14,11, 지급금액/NNG,25,1.8480346277772284,Hawkish
11,7, 연결대상/NNG,18,2.2817570404188228,Hawkish
30,33, 과한/VA,63,1.3200247341265916,Hawkish
21,19, 은행/NNG;신용등급/NNG;강등/NNG,40,1.604872176753909,Hawkish
12,10, 은행/NNG;자금/NNG;확보/NNG,22,1.742432649047101,Hawkish
16,7, 러프/NNG,23,3.3189193315182877,Hawkish
72,70, 베/NNG,142,1.4935136991832296,Hawkish
336,1, 일독/NNG,337,487.88114173318826,Hawkish
21,18, 룩/NNG,39,1.6940317421291258,Hawkish
572,378, 신종자본증권/NNG,950,2.1972475204033106,Hawkish
26,25, 개인/NNG;소비/NNG;지출/NNG;증가/NNG,51,1.510108295840821,Hawkish
21,22, 신규/NNG;고용/NNG;증가/NNG,43,1.3860259708329212,Hawkish
55,47, 우려/NNG;낮/VV,102,1.6991807747799743,Hawkish
21,19, 소비자/NNG;물가/NNG;상승/NNG;둔화/NNG,40,1.604872176753909,Hawkish
11,9, 달리/MAG;경기/NNG;부양/NNG,20,1.774699920325751,Hawkish
34,36, 충분히/MAG;완화/NNG,70,1.3713590293426259,Hawkish
15,14, 지수/NNG;둔화/NNG,29,1.5557434366491973,Hawkish
26,22, 위인/NNG,48,1.7160321543645694,Hawkish
263,271, 연정/NNG,534,1.409162935729974,Hawkish
16,11, 구설수/NNG,27,2.1120395746025467,Hawkish
78,81, 서브/NNG,159,1.3982484220748341,Hawkish
44,1, 엘에스엠/NNG,45,63.88919713172703,Hawkish
94,19, 폴라리스/NNG,113,7.183713553088925,Hawkish
137,79, 쉬/MAG,216,2.5180724991503465,Hawkish
83,12, 핑/MAG,95,10.043188185479817,Hawkish
13,8, 소비자/NNG;신용/NNG;증가/NNG,21,2.359544212251283,Hawkish
46,11, 긴축/NNG;우려/NNG;완화/NNG,57,6.072113776982321,Hawkish
217,10, 르포/NNG,227,31.508990403601743,Hawkish
11,11, 가진다는/VV,22,1.4520272075392509,Hawkish
49,51, 국채/NNG;상승/NNG,100,1.395084964106339,Hawkish
44,38, 예산/NNG;적자/NNG,82,1.6812946613612378,Hawkish
70,78, 예상/NNG;호조/NNG,148,1.3031013400993277,Hawkish
79,61, 조달비중/NNG,140,1.8804942523868986,Hawkish
17,9, 청주/NNG,26,2.7427180586852518,Hawkish
29,5, 로지스틱스/NNG,34,8.421757803727655,Hawkish
60,54, 링크/NNG,114,1.6133635639325008,Hawkish
42,15, 안정/NNG;부정적/VAX,57,4.065676181109902,Hawkish
12,11, 손실/NNG;제한/NNG,23,1.58402968095191,Hawkish
29,32, 베이시스스왑/NNG,61,1.315899656832446,Hawkish
127,61, 예보기금특별계정채권/NNG,188,3.0230730386472926,Hawkish
14,13, 금리/NNG;변동/NNG;제한/NNG,27,1.5637216081191931,Hawkish
10,10, 위기/NNG;불확실성/NNG,20,1.4520272075392509,Hawkish
78,85, 국고채/NNG;낮/VA,163,1.3324484963301362,Hawkish
11,12, 어렵/VA;한계/NNG,23,1.331024940244313,Hawkish
76,82, 감독청/NNG,158,1.3457813143046715,Hawkish
25,18, 다가갈수록/VV,43,2.0167044549156263,Hawkish
34,29, 채무비율/NNG,63,1.7023767260805012,Hawkish
92,38, 신재정협약/NNG,130,3.5154342919371335,Hawkish
10,6, 대기매수자금/NNG,16,2.420045345898751,Hawkish
22,24, 경기/NNG;하방/NNG;위험/NNG;우려/NNG,46,1.331024940244313,Hawkish
9,9, 가격/NNG;우호적/VAX,18,1.4520272075392509,Hawkish
19,8, 가용자금/NNG,27,3.448564617905721,Hawkish
138,19, 랜/NNG,157,10.546302875811401,Hawkish
26,20, 미인/NNG,46,1.887635369801026,Hawkish
331,162, 캐/VV,493,2.9667963314536543,Hawkish
506,0, 본일/NNG,506,inf,Hawkish
693,10, 국중/NNG,703,100.62548548247008,Hawkish
9,9, 판매/NNG;위축/NNG,18,1.4520272075392509,Hawkish
25,26, 망치/VV,51,1.3961800072492796,Hawkish
27,18, 제품군/NNG,45,2.1780408113088763,Hawkish
23,15, 양호/NNG;증가/NNG,38,2.2264417182268508,Hawkish
15,5, 금융시장/NNG;신용경색/NNG;우려/NNG,20,4.356081622617752,Hawkish
11,8, 반등/NNG;전환/NNG,19,1.9965374103664697,Hawkish
45,29, 사당/NNG,74,2.253145666871251,Hawkish
21,16, 재정동맹/NNG,37,1.9057857098952666,Hawkish
22,6, 주택건설업지수/NNG,28,5.324099760977252,Hawkish
20,12, 가집행/NNG,32,2.420045345898751,Hawkish
51,14, 금리/NNG;인하/NNG;가능성/NNG;약화/NNG,65,5.289527684607271,Hawkish
36,18, 채권투자/NNG;심리/NNG;위축/NNG,54,2.9040544150785017,Hawkish
9,10, 글로벌/NNG;경제/NNG;개선/NNG,19,1.3068244867853258,Hawkish
85,58, 경제/NNG;침체/NNG;우려/NNG,143,2.127970907600626,Hawkish
22,23, 주택/NNG;경기/NNG;위축/NNG,45,1.388895589820153,Hawkish
30,29, 경제/NNG;전망/NNG;밝/VA,59,1.5020971112475008,Hawkish
18,17, 주이/NNG,35,1.5374405726886184,Hawkish
20,1, 투증/NNG,21,29.040544150785017,Hawkish
28,14, 낙인효과/NNG,42,2.9040544150785017,Hawkish
56,59, 순공급/NNG,115,1.3781953156304754,Hawkish
34,33, 대출부/NNG,67,1.4960280320101373,Hawkish
41,43, 신뢰감/NNG,84,1.3844910583513785,Hawkish
24,17, 볼륨/NNG,41,2.0499207635848244,Hawkish
39,41, 특색/NNG,80,1.3811966120495314,Hawkish
9,10, 아킬레스/NNG,19,1.3068244867853258,Hawkish
10,6, 묵직/NNG,16,2.420045345898751,Hawkish
56,4, 토제/NNG,60,20.328380905549512,Hawkish
430,431, 서브프라임/NNG;부실/NNG,861,1.4486582348999486,Hawkish
19,16, 안정성/NNG;저하/NNG,35,1.7242823089528605,Hawkish
17,11, 중화학/NNG,28,2.244042048015206,Hawkish
48,21, 오일허브/NNG,69,3.3189193315182877,Hawkish
25,11, 여수/NNG,36,3.3000618353164795,Hawkish
13,8, 입찰계획/NNG,21,2.359544212251283,Hawkish
18,15, 전망/NNG;회복/NNG,33,1.742432649047101,Hawkish
39,34, 동지/NNG,73,1.66556062041267,Hawkish
42,44, 남동/NNG,86,1.3860259708329212,Hawkish
37,41, 가격/NNG;불안/NNG,78,1.3103660165598119,Hawkish
11,5, 바닥/NNG;개선/NNG,16,3.1944598565863513,Hawkish
35,36, 기업실사/NNG,71,1.4116931184409385,Hawkish
8,8, 인플레이션/NNG;기대/NNG;지역/NNG;지정학/NNG;위험/NNG,16,1.4520272075392506,Hawkish
23,8, 크레딧/NNG;선호/NNG,31,4.174578221675346,Hawkish
71,77, 마쳤으며/VV,148,1.3388822303284,Hawkish
12,13, 통회/NNG,25,1.3403328069593086,Hawkish
9,7, 높/VA;기대/NNG;충족/NNG,16,1.866892123979037,Hawkish
18,8, 어렵/VA;가능성/NNG;높/VA,26,3.2670612169633144,Hawkish
21,14, 기대/NNG;우세/NNG,35,2.1780408113088763,Hawkish
50,54, 수출/NNG;상승/NNG,104,1.3444696366104174,Hawkish
16,16, 수출/NNG;높/VA,32,1.4520272075392506,Hawkish
12,8, 경기/NNG;둔화/NNG;물가/NNG;상승/NNG,20,2.1780408113088763,Hawkish
26,27, 양적완화/NNG;반대/NNG,53,1.3982484220748341,Hawkish
15,13, 영업이익/NNG;적자/NNG,28,1.6754160086991354,Hawkish
31,23, 수출/NNG;호전/NNG,54,1.9570801492920338,Hawkish
20,17, 자인/NNG,37,1.7082673029873539,Hawkish
12,11, 기대/NNG;인플레이션/NNG;낮/VV,23,1.58402968095191,Hawkish
17,16, 수요/NNG;압력/NNG;완화/NNG,33,1.5427789080104541,Hawkish
36,32, 건설/NNG;투자/NNG;부진/NNG,68,1.6335306084816572,Hawkish
15,7, 견실/NNG;경제/NNG;성장/NNG,22,3.1114868732983947,Hawkish
12,11, 매파/NNG;우려/NNG,23,1.58402968095191,Hawkish
11,9, 가격선/NNG,20,1.774699920325751,Hawkish
201,205, 예정이율/NNG,406,1.423694969343363,Hawkish
16,12, 흥/MAG,28,1.9360362767190007,Hawkish
15,4, 신명/NNG,19,5.44510202827219,Hawkish
19,13, 농업금융/NNG,32,2.122193611018905,Hawkish
10,7, 소비/NNG;완만/NNG;회복/NNG,17,2.07432458219893,Hawkish
9,9, 대출자산/NNG;성장/NNG,18,1.4520272075392509,Hawkish
21,14, 대출자산/NNG;증가/NNG,35,2.1780408113088763,Hawkish
13,4, 금융시장/NNG;완화/NNG,17,4.719088424502566,Hawkish
13,13, 여력/NNG;강화/NNG,26,1.4520272075392509,Hawkish
13,13, 성장/NNG;제한/NNG,26,1.4520272075392509,Hawkish
20,15, 그중/NNG,35,1.936036276719001,Hawkish
33,29, 활개/NNG,62,1.6523068223722508,Hawkish
14,10, 경제/NNG;금융시장/NNG;안정/NNG,24,2.032838090554951,Hawkish
11,12, 물가/NNG;긍정적/VAX,23,1.331024940244313,Hawkish
9,10, 수요/NNG;잡/VV,19,1.3068244867853258,Hawkish
11,10, 소비/NNG;심리/NNG;하락/NNG,21,1.5972299282931757,Hawkish
14,5, 가격/NNG;매력/NNG;높/VV,19,4.065676181109902,Hawkish
14,14, 바닥/NNG;탈피/NNG,28,1.4520272075392509,Hawkish
20,11, 소비/NNG;부담/NNG,31,2.640049468253183,Hawkish
38,34, 퇴직연금제도/NNG,72,1.622853937837986,Hawkish
130,130, 공채/NNG,260,1.4520272075392509,Hawkish
139,138, 목록/NNG,277,1.462549143825767,Hawkish
17,8, 이란사태/NNG,25,3.0855578160209083,Hawkish
29,21, 바라본/VV,50,2.0051804294589655,Hawkish
16,8, 외국인/NNG;채권투자/NNG;감소/NNG,24,2.9040544150785013,Hawkish
33,35, 경제/NNG;금리/NNG;인하/NNG,68,1.3690542242512935,Hawkish
11,12, 금리/NNG;압력/NNG,23,1.331024940244313,Hawkish
22,22, 매각자금/NNG,44,1.4520272075392509,Hawkish
68,59, 지상파/NNG,127,1.6735228832655775,Hawkish
19,18, 부동산/NNG;과열/NNG;억제/NNG,37,1.5326953857358758,Hawkish
26,15, 유동성/NNG;관리/NNG;강화/NNG,41,2.5168471597347013,Hawkish
34,11, 재무/NNG;안정성/NNG;개선/NNG,45,4.488084096030412,Hawkish
13,5, 하락/NNG;무역/NNG;적자/NNG,18,3.775270739602052,Hawkish
104,112, 일자리/NNG;감소/NNG,216,1.3483109784293044,Hawkish
66,52, 업황/NNG;호조/NNG,118,1.842957609569049,Hawkish
20,15,기간조정/NNG,35,1.936036276719001,Hawkish
20,7, 군들/NNG,27,4.14864916439786,Hawkish
8,8, 수출/NNG;경기/NNG;부정적/VAX,16,1.4520272075392506,Hawkish
10,6, 해지/NNG;금리/NNG;상승/NNG,16,2.420045345898751,Hawkish
19,21, 투자/NNG;모멘텀/NNG,40,1.3137389020593222,Hawkish
40,3, 크레딧/NNG;시장/NNG;강세/NNG,43,19.360362767190008,Hawkish
114,119, 경기/NNG;회복/NNG;자신/NNG,233,1.3910176610039882,Hawkish
102,102, 제조업/NNG;부진/NNG,204,1.4520272075392506,Hawkish
23,16, 완화/NNG;상승/NNG,39,2.087289110837673,Hawkish
64,68, 보육료/NNG,132,1.3666138423898828,Hawkish
11,10, 의리/NNG,21,1.5972299282931757,Hawkish
9,10, 경기/NNG;부양/NNG;인플레이션/NNG;억제/NNG,19,1.3068244867853258,Hawkish
113,92, 설비/NNG;투자/NNG;증가/NNG,205,1.7834682005645144,Hawkish
28,30, 재정위기/NNG;악화/NNG,58,1.3552253937033008,Hawkish
10,11, 물가/NNG;악영향/NNG,21,1.3200247341265916,Hawkish
35,30, 경제/NNG;저점/NNG,65,1.694031742129126,Hawkish
12,13, 금리/NNG;경계/NNG,25,1.3403328069593086,Hawkish
32,2, 리비전/NNG,34,23.23243532062801,Hawkish
27,27, 산업/NNG;생산/NNG;둔화/NNG,54,1.4520272075392506,Hawkish
43,42, 하락/NNG;아니/VCN,85,1.486599283909233,Hawkish
13,12, 챌린저/NNG,25,1.5730294748341882,Hawkish
59,56, 상점/NNG,115,1.5298143793717107,Hawkish
9,8, 부진/NNG;긍정적/VAX,17,1.6335306084816572,Hawkish
24,17, 변동성/NNG;경계/NNG,41,2.0499207635848244,Hawkish
9,7, 불안정성/NNG;높/VV,16,1.866892123979037,Hawkish
13,14, 부채/NNG;성장/NNG,27,1.3483109784293044,Hawkish
3376,2050, 수요예측/NNG,5426,2.391240903732932,Hawkish
66,57, 국제/NNG;유가/NNG;고공행진/NNG,123,1.6812946613612376,Hawkish
13,3, 유동성/NNG;위험/NNG;우려/NNG,16,6.292117899336753,Hawkish
22,21, 결정변수/NNG,43,1.5211713602792152,Hawkish
21,17, 수열/NNG,38,1.7936806681367214,Hawkish
11,6, 고용보고서/NNG;부진/NNG,17,2.662049880488626,Hawkish
52,25, 입량/NNG,77,3.020216591681642,Hawkish
51,10, 총요소생산성/NNG,61,7.405338758450179,Hawkish
36,24, 비주거/NNG,60,2.1780408113088763,Hawkish
11,6, 자본집약/NNG,17,2.662049880488626,Hawkish
12,7, 로그/NNG,19,2.489189498638716,Hawkish
21,18, 최적화/NNG,39,1.6940317421291258,Hawkish
28,16, 순환기/NNG,44,2.541047613193689,Hawkish
42,38, 검정/NNG,80,1.604872176753909,Hawkish
13,12, 공급측면/NNG;충격/NNG,25,1.5730294748341882,Hawkish
43,42, 직책/NNG,85,1.486599283909233,Hawkish
22,22, 상경/NNG,44,1.4520272075392509,Hawkish
44,45, 국민경제자문회의/NNG,89,1.4197599362606008,Hawkish
27,1, 새롭/VA;매파/NNG,28,39.20473460355977,Hawkish
14,7, 캐리장/NNG,21,2.9040544150785017,Hawkish
24,22, 핵심국/NNG,46,1.58402968095191,Hawkish
9,10, 정치/NNG;불확실성/NNG;우려/NNG,19,1.3068244867853258,Hawkish
32,18, 긴축/NNG;위험/NNG,50,2.5813817022920014,Hawkish
15,10, 불안/NNG;증가/NNG,25,2.178040811308876,Hawkish
20,20, 내수/NNG;감소/NNG,40,1.4520272075392509,Hawkish
38,28, 매해/MAG,66,1.9706083530889835,Hawkish
11,12, 하락/NNG;국제/NNG;유가/NNG;상승/NNG,23,1.331024940244313,Hawkish
11,11, 설비/NNG;투자/NNG;호조/NNG,22,1.4520272075392509,Hawkish
10,9, 확실/NNG;경기/NNG;회복/NNG,19,1.6133635639325008,Hawkish
25,12, 상향/NNG;하향/NNG,37,3.025056682373439,Hawkish
29,20, 팽/NNG,49,2.1054394509319136,Hawkish
10,8, 봉기/NNG,18,1.8150340094240636,Hawkish
20,3, 신우/NNG,23,9.680181383595004,Hawkish
36,8, 포승/NNG,44,6.534122433926629,Hawkish
38,42, 나타/NNG,80,1.3137389020593222,Hawkish
42,27, 흡수력/NNG,69,2.258708989505501,Hawkish
28,18, 위원수/NNG,46,2.258708989505501,Hawkish
18,19, 예비자금/NNG,37,1.375604722931922,Hawkish
15,12, 소요액/NNG,27,1.8150340094240633,Hawkish
38,36, 재고물량/NNG,74,1.5326953857358758,Hawkish
46,34, fed/NNG;인플레이션/NNG;압력/NNG,80,1.9645073984354566,Hawkish
11,9, 부진/NNG;안전자산/NNG;선호/NNG,20,1.774699920325751,Hawkish
19,13, 소비/NNG;지출/NNG;회복/NNG,32,2.122193611018905,Hawkish
22,20, 체감/NNG;경기/NNG;부진/NNG,42,1.5972299282931757,Hawkish
20,15, 성장/NNG;긍정적/VAX,35,1.936036276719001,Hawkish
53,46, 적기시정조치/NNG,99,1.6729878695560934,Hawkish
53,18, 무지/NNG,71,4.275413444421127,Hawkish
14,13, 통제장치/NNG,27,1.5637216081191931,Hawkish
16,16, 맹추격/NNG,32,1.4520272075392506,Hawkish
28,11, 재선거/NNG,39,3.6960692555544568,Hawkish
13,14, 과업/NNG,27,1.3483109784293044,Hawkish
52,51, 활성/NNG,103,1.4804983292557066,Hawkish
79,78, 로직/NNG,157,1.4706429409692412,Hawkish
53,46, 명기/NNG,99,1.6729878695560934,Hawkish
12,9, 경기/NNG;둔화/NNG;가능성/NNG;우려/NNG,21,1.9360362767190011,Hawkish
19,18, 신용위험/NNG;낮/VA,37,1.5326953857358758,Hawkish
14,11, 완화/NNG;성장/NNG,25,1.8480346277772284,Hawkish
41,42, 투자/NNG;성장/NNG,83,1.4174551311692687,Hawkish
19,21, 예상/NNG;강세/NNG,40,1.3137389020593222,Hawkish
40,25, 대로/NNG,65,2.3232435320628015,Hawkish
32,0, 채권/NNG;금리/NNG;상승/NNG;압력/NNG;높/VV,32,inf,Hawkish
40,40, 파생상품손실/NNG,80,1.4520272075392509,Hawkish
31,34, 설파/NNG,65,1.3239071598151992,Hawkish
9,10, 정치/NNG;위험/NNG;확대/NNG,19,1.3068244867853258,Hawkish
29,24, 채권/NNG;금리/NNG;바닥/NNG,53,1.7545328757765946,Hawkish
9,8, 전망/NNG;우호적/VAX,17,1.6335306084816572,Hawkish
14,13, 저질러/VV,27,1.5637216081191931,Hawkish
12,4, 사분면/NNG,16,4.356081622617753,Hawkish
16,13, 하락/NNG;원화/NNG;절상/NNG,29,1.7871104092790777,Hawkish
9,10, 환포지션/NNG,19,1.3068244867853258,Hawkish
16,17, 시나리오분석/NNG,33,1.3666138423898828,Hawkish
47,50, 다룬/VV,97,1.3649055750868957,Hawkish
296,30, 올레/NNG,326,14.326668447720609,Hawkish
16,14, 구제금융/NNG;반대/NNG,30,1.6594596657591438,Hawkish
13,14, 부채비율/NNG;증가/NNG,27,1.3483109784293044,Hawkish
31,21, 부채비율/NNG;상승/NNG,52,2.143468734938894,Hawkish
20,19, 노동/NNG;감소/NNG,39,1.5284496921465798,Hawkish
27,29, 바란다는/VV,56,1.3518874001227508,Hawkish
14,10, 뒤치락/MAG,24,2.032838090554951,Hawkish
41,35, 도장/NNG,76,1.7009461574031224,Hawkish
26,5, 극좌/NNG,31,7.550541479204104,Hawkish
66,29, 의석수/NNG,95,3.3046136447445016,Hawkish
182,198, 양질/NNG,380,1.334691675616887,Hawkish
9,7, 성장/NNG;긴축/NNG,16,1.866892123979037,Hawkish
10,7, 비용/NNG;우려/NNG,17,2.07432458219893,Hawkish
71,70, 완수/NNG,141,1.4727704533612402,Hawkish
11,6, 파시스트/NNG,17,2.662049880488626,Hawkish
112,12, 재인/NNG,124,13.552253937033006,Hawkish
23,14, 고용자수/NNG;증가/NNG;둔화/NNG,37,2.3854732695287693,Hawkish
12,7, 미/NNG;경제/NNG;부진/NNG,19,2.489189498638716,Hawkish
24,24, 지수/NNG;증가/NNG,48,1.4520272075392509,Hawkish
10,10, 비업/NNG,20,1.4520272075392509,Hawkish
29,12, 도매업/NNG,41,3.509065751553189,Hawkish
113,114, 광산업/NNG,227,1.4392901267713625,Hawkish
150,135, 순차입/NNG,285,1.613363563932501,Hawkish
11,10, 채권시장/NNG;글로벌/NNG;안전자산/NNG;선호/NNG,21,1.5972299282931757,Hawkish
15,16, 경제모형/NNG,31,1.3612755070680476,Hawkish
24,3, 목차/NNG,27,11.616217660314007,Hawkish
18,3, 만기비중/NNG,21,8.712163245235505,Hawkish
10,8, 출비/NNG,18,1.8150340094240636,Hawkish
446,392, 햇살론/NNG,838,1.652051363679862,Hawkish
15,2, 저량/NNG,17,10.89020405654438,Hawkish
19,20, 부기/NNG,39,1.3794258471622882,Hawkish
33,27, 회사채/NNG;시장/NNG;활성화/NNG,60,1.7746999203257507,Hawkish
23,14, 완만/NNG;금리/NNG;상승/NNG,37,2.3854732695287693,Hawkish
9,7, 대외/NNG;여건/NNG;호전/NNG,16,1.866892123979037,Hawkish
14,14, 채권/NNG;활성화/NNG,28,1.4520272075392509,Hawkish
13,13, 경기/NNG;견인/NNG,26,1.4520272075392509,Hawkish
21,19, 세계/NNG;경제/NNG;긍정적/VAX,40,1.604872176753909,Hawkish
15,6, 인상/NNG;압력/NNG;높/VA,21,3.6300680188481267,Hawkish
29,24, 은행그룹/NNG,53,1.7545328757765946,Hawkish
12,9, 조롱/NNG,21,1.9360362767190011,Hawkish
12,9, 금리/NNG;방향/NNG;상승/NNG,21,1.9360362767190011,Hawkish
20,17, 가격/NNG;하락/NNG;확대/NNG,37,1.7082673029873539,Hawkish
11,6, 채권시장/NNG;매수우위/NNG,17,2.662049880488626,Hawkish
21,10, 구조조정/NNG;강화/NNG,31,3.0492571358324265,Hawkish
16,17, 강등사태/NNG,33,1.3666138423898828,Hawkish
11,11, 약화/NNG;추세/NNG,22,1.4520272075392509,Hawkish
24,17, 은행동맹/NNG,41,2.0499207635848244,Hawkish
14,9, 수습책/NNG,23,2.258708989505501,Hawkish
13,13, 일괄매각/NNG,26,1.4520272075392509,Hawkish
30,28, 자본/NNG;유출/NNG;확대/NNG,58,1.5557434366491973,Hawkish
16,9, 소비/NNG;여력/NNG;증가/NNG,25,2.5813817022920014,Hawkish
16,15, 내수/NNG;완만/NNG;회복/NNG,31,1.5488290213752007,Hawkish
33,22, 구매력/NNG;증가/NNG,55,2.1780408113088763,Hawkish
9,10, 경제/NNG;하향/NNG,19,1.3068244867853258,Hawkish
16,7, 인상/NNG;높/VA,23,3.3189193315182877,Hawkish
91,92, 대안투자/NNG,183,1.4362443031094763,Hawkish
9,7, 하향/NNG;가능성/NNG;높/VA,16,1.866892123979037,Hawkish
16,15, 통화/NNG;위험/NNG,31,1.5488290213752007,Hawkish
28,28, 실사단/NNG,56,1.4520272075392509,Hawkish
36,23, 규제감독/NNG,59,2.272738237887523,Hawkish
15,4, 축목/NNG,19,5.44510202827219,Hawkish
11,12, 개별국/NNG,23,1.331024940244313,Hawkish
14,9, 대연/NNG,23,2.258708989505501,Hawkish
17,13, 산업/NNG;긍정적/VAX,30,1.8988048098590204,Hawkish
12,10, 부추김/VV,22,1.742432649047101,Hawkish
9,8, 찰나/NNG,17,1.6335306084816572,Hawkish
45,31, 기업분석/NNG,76,2.1077814302989126,Hawkish
9,9, 전자재료/NNG,18,1.4520272075392509,Hawkish
98,93, 합헌/NNG,191,1.5300931864392104,Hawkish
26,26, 대승/NNG,52,1.4520272075392509,Hawkish
12,5, 장장/MAG,17,3.484865298094202,Hawkish
28,25, 발췌/NNG,53,1.626270472443961,Hawkish
13,13, 원제/NNG,26,1.4520272075392509,Hawkish
10,7, 천연가스/NNG;가격/NNG;하락/NNG,17,2.07432458219893,Hawkish
14,6, 유가/NNG;하락/NNG;부정적/VAX,20,3.3880634842582515,Hawkish
33,30, 글로벌/NNG;수요/NNG;부진/NNG,63,1.5972299282931757,Hawkish
15,10, 단기/NNG;시장/NNG;안정/NNG,25,2.178040811308876,Hawkish
11,9, 환경/NNG;금리/NNG;인하/NNG,20,1.774699920325751,Hawkish
627,1, 황원/NNG,628,910.4210591271102,Hawkish
91,88, 경기소비재/NNG,179,1.501528135068998,Hawkish
15,10, 국채/NNG;금리/NNG;하향/NNG;안정/NNG,25,2.178040811308876,Hawkish
14,9, 유로존/NNG;국채시장/NNG;안정/NNG,23,2.258708989505501,Hawkish
19,20, 서비스업/NNG;생산/NNG;증가/NNG,39,1.3794258471622882,Hawkish
14,9, 소비/NNG;증가/NNG;둔화/NNG,23,2.258708989505501,Hawkish
56,45, 기업/NNG;투자/NNG;증가/NNG,101,1.806967191604401,Hawkish
58,13,황원/NNG,71,6.478275233636658,Hawkish
192,119, 발행기업/NNG,311,2.3427665869540855,Hawkish
178,197, 과당경쟁/NNG,375,1.3119839743248054,Hawkish
911,379, 미매각/NNG,1290,3.490228986987487,Hawkish
17,8, 부실/NNG;우려/NNG;높/VA,25,3.0855578160209083,Hawkish
55,49, 발행/NNG;금리/NNG;높/VA,104,1.6298264574420163,Hawkish
12,6, 펀더멘털/NNG;위협/NNG,18,2.9040544150785017,Hawkish
45,9, 크레딧/NNG;위험/NNG,54,7.260136037696253,Hawkish
13,14, 파일럿/NNG,27,1.3483109784293044,Hawkish
67,58, 소기/NNG,125,1.6773417742263759,Hawkish
123,78, 성명문/NNG,201,2.289735211888819,Hawkish
15,15, 등급평정/NNG,30,1.4520272075392506,Hawkish
81,49, 영업현금흐름/NNG,130,2.400289873687333,Hawkish
44,44, 청라/NNG,88,1.4520272075392509,Hawkish
19,20, 상환/NNG;부담/NNG;증가/NNG,39,1.3794258471622882,Hawkish
57,62, 수익성/NNG;회복/NNG,119,1.3349282391893114,Hawkish
49,46, 일반자금/NNG,95,1.5467246341178977,Hawkish
74,57, 고정비/NNG,131,1.8850879536474483,Hawkish
11,8, 역선택/NNG,19,1.9965374103664697,Hawkish
15,7, 유로존/NNG;재정/NNG;긴축/NNG,22,3.1114868732983947,Hawkish
17,14, 내수/NNG;경기/NNG;둔화/NNG,31,1.7631758948690905,Hawkish
36,39, 중소기업/NNG;신용위험/NNG,75,1.3403328069593086,Hawkish
15,11, 대출태도/NNG;완화/NNG,26,1.9800371011898874,Hawkish
32,6, 유유/NNG,38,7.744145106876003,Hawkish
38,1, 기위/NNG,39,55.177033886491536,Hawkish
26,0, 채부/NNG,26,inf,Hawkish
27,9, 미아/NNG,36,4.356081622617753,Hawkish
16,12, 넘어지/VV,28,1.9360362767190007,Hawkish
411,430, 최저임금/NNG,841,1.3878678658107724,Hawkish
22,21, 반기업/NNG,43,1.5211713602792152,Hawkish
62,66, 견뎌/VV,128,1.364025558597478,Hawkish
14,10, 엎/VV,24,2.032838090554951,Hawkish
52,57, 어기/VV,109,1.324656399860369,Hawkish
40,23, 단순평균/NNG,63,2.525264708763914,Hawkish
10,10, 납입자본금/NNG,20,1.4520272075392509,Hawkish
44,48, 번져/VV,92,1.331024940244313,Hawkish
14,4, 공동보증/NNG,18,5.082095226387378,Hawkish
15,15, 싸워/VV,30,1.4520272075392506,Hawkish
15,9, 특별세/NNG,24,2.420045345898751,Hawkish
38,38, 총리직/NNG,76,1.4520272075392509,Hawkish
34,33, 당인/NNG,67,1.4960280320101373,Hawkish
18,14, 외국인/NNG;자금/NNG;우려/NNG,32,1.866892123979037,Hawkish
25,19, 부채/NNG;재정/NNG;적자/NNG,44,1.9105621151832248,Hawkish
86,46, 금리/NNG;인상/NNG;종료/NNG,132,2.714659561921208,Hawkish
11,6, 차입/NNG;비용/NNG;늘/VV,17,2.662049880488626,Hawkish
12,11, 부실여신/NNG;증가/NNG,23,1.58402968095191,Hawkish
12,11, 경제/NNG;악순환/NNG,23,1.58402968095191,Hawkish
69,64, 생산/NNG;확대/NNG,133,1.5654668331282549,Hawkish
12,12, 개선/NNG;성장/NNG,24,1.4520272075392509,Hawkish
11,12, 전망/NNG;채권시장/NNG;약세/NNG,23,1.331024940244313,Hawkish
39,38, 신용공여액/NNG,77,1.4902384498429153,Hawkish
27,10, 기공/NNG,37,3.9204734603559768,Hawkish
26,25, 안정/NNG;해치/VV,51,1.510108295840821,Hawkish
16,15, 시켜온/XSV,31,1.5488290213752007,Hawkish
30,29, 금리/NNG;인하/NNG;금리/NNG;인상/NNG,59,1.5020971112475008,Hawkish
126,15, 마이너스갭/NNG,141,12.197028543329706,Hawkish
11,5, 내수/NNG;증가율/NNG;낮/VA,16,3.1944598565863513,Hawkish
63,70, 다투/VV,133,1.3068244867853258,Hawkish
39,23, 긴축/NNG;중단/NNG,62,2.4621330910448167,Hawkish
63,40, 콘탱고/NNG,103,2.28694285187432,Hawkish
72,79, 단단히/MAG,151,1.3233665688965326,Hawkish
21,4, 둔화/NNG;가능성/NNG;우려/NNG,25,7.6231428395810665,Hawkish
11,12, 국채/NNG;금리/NNG;하회/NNG,23,1.331024940244313,Hawkish
12,9, 위험/NNG;점증/NNG,21,1.9360362767190011,Hawkish
15,16, 해지/NNG;금리/NNG;인하/NNG,31,1.3612755070680476,Hawkish
581,481, 재정절벽/NNG,1062,1.7539039658634195,Hawkish
46,18, 슈퍼위원회/NNG,64,3.710736197044752,Hawkish
337,234, 세제개편/NNG,571,2.0911673886355873,Hawkish
33,24, 메디케어/NNG,57,1.9965374103664695,Hawkish
14,14, 작은정부/NNG,28,1.4520272075392509,Hawkish
28,5, 부채감축계획/NNG,33,8.131352362219804,Hawkish
27,10, 부채비율/NNG;개선/NNG,37,3.9204734603559768,Hawkish
27,26, 비용/NNG;축소/NNG,53,1.5078744078292219,Hawkish
38,38, 재정/NNG;건전/NNG,76,1.4520272075392509,Hawkish
13,13, 예상/NNG;적자/NNG,26,1.4520272075392509,Hawkish
68,75, 지출/NNG;축소/NNG,143,1.3165046681689208,Hawkish
51,46, 별도기준/NNG,97,1.6098562518369954,Hawkish
45,23, 재무비율/NNG,68,2.8409227973594033,Hawkish
11,12, 사세/NNG,23,1.331024940244313,Hawkish
34,23, 운전자본/NNG,57,2.1464750024493275,Hawkish
32,22, 투자/NNG;수요/NNG;감소/NNG,54,2.1120395746025467,Hawkish
18,10, 선제/NNG;자금/NNG;확보/NNG,28,2.6136489735706516,Hawkish
13,5, 영업이익/NNG;저하/NNG,18,3.775270739602052,Hawkish
18,11, 고정비/NNG;부담/NNG,29,2.376044521427865,Hawkish
75,66, 수주/NNG;증가/NNG,141,1.6500309176582395,Hawkish
82,73, 재무/NNG;부담/NNG,155,1.631044260523542,Hawkish
49,27, 실적/NNG;저하/NNG,76,2.6351604877564183,Hawkish
103,7, 일반은행채/NNG,110,21.36554319664898,Hawkish
41,36, 경제/NNG;회복/NNG;모멘텀/NNG,77,1.6536976530308134,Hawkish
90,90, 경제/NNG;완만/NNG;성장/NNG,180,1.4520272075392509,Hawkish
15,2, 승승/NNG,17,10.89020405654438,Hawkish
14,10, 채권/NNG;금리/NNG;과도/NNG,24,2.032838090554951,Hawkish
123,135, 강하/VA;성장/NNG,258,1.3229581224246507,Hawkish
569,4, 주호/NNG,573,206.55087027245844,Hawkish
432,22, 국태/NNG,454,28.51253425713438,Hawkish
21,8, 메디케이드/NNG,29,3.8115714197905333,Hawkish
12,13, 행대/NNG,25,1.3403328069593086,Hawkish
9,10, 유동성/NNG;무제한/NNG,19,1.3068244867853258,Hawkish
11,11, 정책/NNG;제약/NNG,22,1.4520272075392509,Hawkish
8,8, 지출/NNG;통제/NNG,16,1.4520272075392506,Hawkish
61,43, 협상력/NNG,104,2.0598525502301,Hawkish
19,19, 외시/NNG,38,1.4520272075392509,Hawkish
17,16, 돌다리/NNG,33,1.5427789080104541,Hawkish
10,8, 독신자/NNG,18,1.8150340094240636,Hawkish
20,16, 배재/NNG,36,1.8150340094240636,Hawkish
48,42, 유통물/NNG,90,1.6594596657591438,Hawkish
20,18, 샌/NNG,38,1.6133635639325008,Hawkish
23,22, 매머드/NNG,45,1.5180284442455803,Hawkish
26,13, 잔존액/NNG,39,2.9040544150785017,Hawkish
335,344, 인건비/NNG,679,1.4140381236210726,Hawkish
18,18, 경영분석/NNG,36,1.4520272075392509,Hawkish
252,191, 이자보상배율/NNG,443,1.9157636455491687,Hawkish
13,11, 위험/NNG;금리/NNG;인하/NNG,24,1.7160321543645694,Hawkish
85,82, 내수/NNG;성장/NNG,167,1.5051501541565404,Hawkish
10,7, 어렵/VA;저점/NNG,17,2.07432458219893,Hawkish
18,9, 특수은행채/NNG,27,2.9040544150785017,Hawkish
14,9, 경기/NNG;둔화/NNG;우려/NNG;높/VV,23,2.258708989505501,Hawkish
36,34, 수호/NNG,70,1.5374405726886184,Hawkish
12,4, 크레딧/NNG;수요/NNG;증가/NNG,16,4.356081622617753,Hawkish
9,9, 금리/NNG;인하/NNG;필요성/NNG;높/VA,18,1.4520272075392509,Hawkish
15,14, 경기/NNG;부양책/NNG;강화/NNG,29,1.5557434366491973,Hawkish
13,4, 경기/NNG;불확실성/NNG;완화/NNG,17,4.719088424502566,Hawkish
17,18, 경제/NNG;양적완화/NNG,35,1.3713590293426259,Hawkish
14,10, 부진/NNG;둔화/NNG,24,2.032838090554951,Hawkish
18,18, 가격/NNG;하락/NNG;방어/NNG,36,1.4520272075392509,Hawkish
47,2, 스냅샷/NNG,49,34.12263937717239,Hawkish
13,5, 긍정성/NNG,18,3.775270739602052,Hawkish
17,2, 탈이/NNG,19,12.342231264083633,Hawkish
26,18, 태아/NNG,44,2.097372633112251,Hawkish
12,6, 아비/NNG,18,2.9040544150785017,Hawkish
16,1, 인아/NNG,17,23.23243532062801,Hawkish
57,47, 경기/NNG;위축/NNG;우려/NNG,104,1.7609691665901552,Hawkish
34,35, 개선/NNG;어렵/VA,69,1.4105407158952723,Hawkish
20,13, 성장/NNG;오르/VV,33,2.2338880115988475,Hawkish
10,7, 어렵/VA;회복/NNG,17,2.07432458219893,Hawkish
28,21, 주거용건물/NNG,49,1.9360362767190011,Hawkish
27,29, 투자/NNG;자제/NNG,56,1.3518874001227508,Hawkish
22,20, 정책/NNG;기대/NNG;약화/NNG,42,1.5972299282931757,Hawkish
13,7, 마이너스/NNG;축소/NNG,20,2.6966219568586087,Hawkish
25,14, 어둠/NNG,39,2.5929057277486622,Hawkish
16,17, 경기/NNG;둔화/NNG;우려/NNG;금리/NNG;인하/NNG,33,1.3666138423898828,Hawkish
37,26, 본전/NNG,63,2.0663464107289338,Hawkish
9,7, 국채/NNG;금리/NNG;고공행진/NNG,16,1.866892123979037,Hawkish
13,4, 만리/NNG,17,4.719088424502566,Hawkish
23,20, 가계/NNG;이자/NNG;상환/NNG;부담/NNG,43,1.6698312886701383,Hawkish
19,18, 경기/NNG;전망/NNG;낙관/NNG,37,1.5326953857358758,Hawkish
104,103, 경제분석/NNG,207,1.4661245590687582,Hawkish
11,10, 무너진다/VV,21,1.5972299282931757,Hawkish
14,10, 외국인/NNG;투자/NNG;제한/NNG,24,2.032838090554951,Hawkish
17,13, 단기물/NNG;안정/NNG,30,1.8988048098590204,Hawkish
40,40, 부채비율/NNG;낮/VA,80,1.4520272075392509,Hawkish
16,15, 미적/NNG,31,1.5488290213752007,Hawkish
25,18, 견고히/MAG,43,2.0167044549156263,Hawkish
87,87, 다다른/VV,174,1.4520272075392509,Hawkish
286,305, 금리/NNG;지준율/NNG;인하/NNG,591,1.3615730536269695,Hawkish
8,8, 채권시장/NNG;fed/NNG;양적완화/NNG,16,1.4520272075392506,Hawkish
22,20, 채권시장/NNG;소폭/MAG;강세/NNG,42,1.5972299282931757,Hawkish
43,27, 고령사회/NNG,70,2.3124877749699175,Hawkish
45,26, 인구비중/NNG,71,2.5131240130487034,Hawkish
19,20, 인구비율/NNG,39,1.3794258471622882,Hawkish
10,9, 금리/NNG;역사적/VAX;최저/NNG,19,1.6133635639325008,Hawkish
16,17, 채권/NNG;금리/NNG;하향/NNG,33,1.3666138423898828,Hawkish
26,29, 안정화/NNG;추세/NNG,55,1.3018174964145008,Hawkish
12,10, 도공/NNG,22,1.742432649047101,Hawkish
85,93, 관문/NNG,178,1.3271216412993152,Hawkish
27,29, 남겨둘/VV,56,1.3518874001227508,Hawkish
54,60, 가사/NNG,114,1.3068244867853256,Hawkish
17,12, 우려/NNG;넘/VV,29,2.0570385440139387,Hawkish
39,30, 무더위/NNG,69,1.887635369801026,Hawkish
12,12, 자금/NNG;조달/NNG;비용/NNG;하락/NNG,24,1.4520272075392509,Hawkish
17,13, 우려/NNG;금리/NNG;하락/NNG,30,1.8988048098590204,Hawkish
104,28, 등급평가/NNG,132,5.3932439137172175,Hawkish
17,9, 주대/NNG,26,2.7427180586852518,Hawkish
33,29, 국채/NNG;무제한/NNG,62,1.6523068223722508,Hawkish
11,7, 수출/NNG;경기/NNG;악화/NNG,18,2.2817570404188228,Hawkish
35,35, 자구/NNG,70,1.4520272075392509,Hawkish
36,26, 정적/NNG,62,2.010499210438963,Hawkish
14,11, 재정건전화계획/NNG,25,1.8480346277772284,Hawkish
20,13, 민간/NNG;경기/NNG;회복/NNG,33,2.2338880115988475,Hawkish
26,1, 위금/NNG,27,37.752707396020526,Hawkish
36,38, 지나갈/VV,74,1.375604722931922,Hawkish
12,9, 지칠/VV,21,1.9360362767190011,Hawkish
18,11, 대외/NNG;충격/NNG;취약/NNG,29,2.376044521427865,Hawkish
11,9, 적잖/VA;영향/NNG;줄/VV,20,1.774699920325751,Hawkish
16,9, 구제금융/NNG;불확실성/NNG,25,2.5813817022920014,Hawkish
10,10, 어렵/VA;불안/NNG,20,1.4520272075392509,Hawkish
20,17, 변변/NNG,37,1.7082673029873539,Hawkish
11,7, 축강/NNG,18,2.2817570404188228,Hawkish
16,0, 생지/NNG,16,inf,Hawkish
9,7, 걸리/NNG,16,1.866892123979037,Hawkish
23,22, 신청기업/NNG,45,1.5180284442455803,Hawkish
12,6, 행사시/NNG,18,2.9040544150785017,Hawkish
45,39, 걸러/VV,84,1.6754160086991354,Hawkish
11,11, 경기/NNG;회복/NNG;모멘텀/NNG;강화/NNG,22,1.4520272075392509,Hawkish
33,28, 투자/NNG;매력/NNG;감소/NNG,61,1.7113177803141169,Hawkish
18,4, 발행/NNG;수요/NNG;증가/NNG,22,6.534122433926629,Hawkish
15,1, 크레딧/NNG;위험/NNG;높/VA,16,21.78040811308876,Hawkish
9,7, 발행/NNG;수요/NNG;많/VA,16,1.866892123979037,Hawkish
11,5, 본증/NNG,16,3.1944598565863513,Hawkish
14,13, 산입/NNG,27,1.5637216081191931,Hawkish
16,2, 인본/NNG,18,11.616217660314005,Hawkish
145,36, 리가/NNG,181,5.848442919255316,Hawkish
18,19, 절상/NNG;압력/NNG;완화/NNG,37,1.375604722931922,Hawkish
29,9, 상승국/NNG,38,4.6787543354042525,Hawkish
13,12, 사고팔/VV,25,1.5730294748341882,Hawkish
35,22, 기주/NNG,57,2.3100432847215355,Hawkish
11,6, 붉은색/NNG,17,2.662049880488626,Hawkish
9,7, 금리/NNG;인하/NNG;제한/NNG,16,1.866892123979037,Hawkish
12,11, 제한적/VAX;효과/NNG,23,1.58402968095191,Hawkish
9,10, 금리/NNG;역전/NNG;부담/NNG,19,1.3068244867853258,Hawkish
17,16, 재정/NNG;지출/NNG;감소/NNG,33,1.5427789080104541,Hawkish
222,89, 자본증권/NNG,311,3.621910562625996,Hawkish
12,7, 기업/NNG;대출/NNG;감소/NNG,19,2.489189498638716,Hawkish
11,10, 글로벌/NNG;경기/NNG;상승/NNG,21,1.5972299282931757,Hawkish
147,145, 부동산/NNG;가격/NNG;안정/NNG,292,1.4720551690225507,Hawkish
19,18, 투자/NNG;상승/NNG,37,1.5326953857358758,Hawkish
12,9, 당락/NNG,21,1.9360362767190011,Hawkish
39,42, 기업규제/NNG,81,1.3483109784293044,Hawkish
19,18, 아이오/NNG,37,1.5326953857358758,Hawkish
16,12, 하락/NNG;경기/NNG;둔화/NNG;우려/NNG,28,1.9360362767190007,Hawkish
37,19, 영업자산/NNG,56,2.827631930471173,Hawkish
19,1, 사계/NNG,20,27.588516943245768,Hawkish
34,28, 채권비율/NNG,62,1.7631758948690905,Hawkish
14,4, 국향/NNG,18,5.082095226387378,Hawkish
47,32, 원가경쟁력/NNG,79,2.1326649610732744,Hawkish
72,69, fcf/NNG,141,1.5151588252583488,Hawkish
10,8, 자못/MAG,18,1.8150340094240636,Hawkish
28,26, 부채/NNG;상환능력/NNG;악화/NNG,54,1.5637216081191931,Hawkish
17,9, 부채/NNG;상환능력/NNG;저하/NNG,26,2.7427180586852518,Hawkish
17,11, 경제/NNG;성장률/NNG;저하/NNG,28,2.244042048015206,Hawkish
21,19, 높/VA;경기/NNG;둔화/NNG,40,1.604872176753909,Hawkish
47,50, 재무구조/NNG;악화/NNG,97,1.3649055750868957,Hawkish
58,59, 수익성/NNG;하락/NNG,117,1.4274165769029923,Hawkish
11,5, 건설업/NNG;침체/NNG,16,3.1944598565863513,Hawkish
14,5, 수익성/NNG;저조/NNG,19,4.065676181109902,Hawkish
22,24, 지출/NNG;부담/NNG,46,1.331024940244313,Hawkish
10,9, 주택/NNG;건설/NNG;증가/NNG,19,1.6133635639325008,Hawkish
9,8, 저점/NNG;바닥/NNG,17,1.6335306084816572,Hawkish
9,10, 회복/NNG;개선/NNG,19,1.3068244867853258,Hawkish
20,12, 업황/NNG;둔화/NNG,32,2.420045345898751,Hawkish
29,24, 상회/NNG;상향/NNG,53,1.7545328757765946,Hawkish
27,30,한산/NNG,57,1.3068244867853256,Hawkish
9,10, 채권/NNG;감소/NNG,19,1.3068244867853258,Hawkish
16,17, 우려/NNG;금융시장/NNG;불안/NNG,33,1.3666138423898828,Hawkish
20,15, 으레/MAG,35,1.936036276719001,Hawkish
15,7, 전력공사/NNG,22,3.1114868732983947,Hawkish
129,42, 발행회사/NNG,171,4.459797851727699,Hawkish
12,13, 미발/NNG,25,1.3403328069593086,Hawkish
27,23, 수혜국/NNG,50,1.7045536784156423,Hawkish
101,81, 주가지수연동/NNG,182,1.8105524439686955,Hawkish
14,10, 국고채/NNG;금리/NNG;상승/NNG;확대/NNG,24,2.032838090554951,Hawkish
24,17, 손익분기/NNG,41,2.0499207635848244,Hawkish
37,37, 하단/NNG;내리/VV,74,1.4520272075392509,Hawkish
34,33, 분화/NNG,67,1.4960280320101373,Hawkish
22,14, 도제/NNG,36,2.2817570404188228,Hawkish
58,50, 발행주관사/NNG,108,1.684351560745531,Hawkish
14,4, 기술사/NNG,18,5.082095226387378,Hawkish
48,45, 후발주자/NNG,93,1.548829021375201,Hawkish
48,48, 사업권/NNG,96,1.4520272075392509,Hawkish
102,112, 앞날/NNG,214,1.3223819211518177,Hawkish
129,137, 아빠/NNG,266,1.3672372976099516,Hawkish
11,7, 민평/NNG;금리/NNG;상승/NNG,18,2.2817570404188228,Hawkish
13,14, 원화/NNG;강세/NNG;방어/NNG,27,1.3483109784293044,Hawkish
24,25, 수요예측/NNG;실패/NNG,49,1.393946119237681,Hawkish
10,8, 우발채무/NNG;부담/NNG,18,1.8150340094240636,Hawkish
13,10, 자산/NNG;감축/NNG,23,1.887635369801026,Hawkish
10,6, 자산/NNG;낮/VA,16,2.420045345898751,Hawkish
16,12, 당간/NNG,28,1.9360362767190007,Hawkish
14,6, 부유세/NNG,20,3.3880634842582515,Hawkish
29,29, 사치품/NNG,58,1.4520272075392509,Hawkish
16,15, 제조업/NNG;경기/NNG;개선/NNG,31,1.5488290213752007,Hawkish
12,6, 재정절벽/NNG;불확실성/NNG,18,2.9040544150785017,Hawkish
12,10, 재정절벽/NNG;위험/NNG,22,1.742432649047101,Hawkish
19,16, 일시적/VAX;부진/NNG,35,1.7242823089528605,Hawkish
60,66, 우려/NNG;낮/VA,126,1.3200247341265916,Hawkish
42,22, 매입자산/NNG,64,2.7720519416658425,Hawkish
20,4, 티/MAG,24,7.260136037696254,Hawkish
9,7, 자본/NNG;유출입/NNG;규제/NNG;강화/NNG,16,1.866892123979037,Hawkish
11,11, 부진/NNG;불확실성/NNG,22,1.4520272075392509,Hawkish
29,22, 기대수익률/NNG;낮/VV,51,1.914035864483558,Hawkish
17,14, 우려/NNG;잡/VV,31,1.7631758948690905,Hawkish
140,156,선물환/NNG,296,1.3031013400993277,Hawkish
84,71, 보유기간/NNG,155,1.7178913441309445,Hawkish
42,30, 자본자유화/NNG,72,2.032838090554951,Hawkish
10,8, 자본/NNG;유입/NNG;막/VV,18,1.8150340094240636,Hawkish
31,25, 내/NNG,56,1.8005137373486713,Hawkish
56,48, 위대/NNG,104,1.6940317421291258,Hawkish
17,9, 공공임대/NNG;주택/NNG;확대/NNG,26,2.7427180586852518,Hawkish
10,11, 채권/NNG;보유/NNG;늘/VV,21,1.3200247341265916,Hawkish
70,76, 유동성/NNG;압박/NNG,146,1.3373934806282575,Hawkish
9,8, 장기물/NNG;확대/NNG,17,1.6335306084816572,Hawkish
10,9, 미뤄서/VV,19,1.6133635639325008,Hawkish
10,9, 폐회/NNG,19,1.6133635639325008,Hawkish
25,16, 물가/NNG;상승률/NNG;농산물/NNG;가격/NNG;하락/NNG,41,2.2687925117800796,Hawkish
10,6, 물가/NNG;상승률/NNG;수요/NNG;압력/NNG,16,2.420045345898751,Hawkish
54,17, 커머셜/NNG,71,4.612321718065855,Hawkish
12,11, 상환/NNG;부담/NNG;낮/VV,23,1.58402968095191,Hawkish
12,13, 개선/NNG;확대/NNG,25,1.3403328069593086,Hawkish
52,51, 허약/NNG,103,1.4804983292557066,Hawkish
23,25, 가량/MAG,48,1.3358650309361106,Hawkish
10,9, 절연/NNG,19,1.6133635639325008,Hawkish
14,2, 대분류/NNG,16,10.164190452774756,Hawkish
29,32, 우상향/NNG;추세/NNG,61,1.315899656832446,Hawkish
12,9, 멘탈/NNG,21,1.9360362767190011,Hawkish
11,7, 이례/NNG,18,2.2817570404188228,Hawkish
117,47, 평정/NNG,164,3.614620920895582,Hawkish
8,8, 금리/NNG;인하/NNG;기대/NNG;쉽/VA,16,1.4520272075392506,Hawkish
15,1, 마이너스갭/NNG;축소/NNG,16,21.78040811308876,Hawkish
15,12, 발행시장/NNG;위축/NNG,27,1.8150340094240633,Hawkish
18,19, 다원화/NNG;강세/NNG,37,1.375604722931922,Hawkish
9,8, 지휘부/NNG,17,1.6335306084816572,Hawkish
24,26, 민병대/NNG,50,1.3403328069593086,Hawkish
34,31, 민간인/NNG,65,1.5925459695591786,Hawkish
12,12, 퇴각/NNG,24,1.4520272075392509,Hawkish
50,54, 차근차근/MAG,104,1.3444696366104174,Hawkish
13,12, 파라/NNG,25,1.5730294748341882,Hawkish
47,25, 낯선/VA,72,2.7298111501737914,Hawkish
15,6, 져/XSV,21,3.6300680188481267,Hawkish
21,20, 정복/NNG,41,1.5246285679162133,Hawkish
24,1, 시시/MAG,25,34.84865298094202,Hawkish
31,6, 북북/MAG,37,7.5021405722861285,Hawkish
93,0, 중중/NNG,93,inf,Hawkish
29,8, 남남/NNG,37,5.263598627329784,Hawkish
33,30, 세세/NNG,63,1.5972299282931757,Hawkish
503,338, 기재/NNG,841,2.1608570573735,Hawkish
189,120, 관련자/NNG,309,2.28694285187432,Hawkish
84,86, 손익분기점/NNG,170,1.4182591329453147,Hawkish
9,8, 이력효과/NNG,17,1.6335306084816572,Hawkish
30,14, 개선/NNG;금리/NNG;인하/NNG,44,3.1114868732983947,Hawkish
16,11, 회복/NNG;속도/NNG;더디/VV,27,2.1120395746025467,Hawkish
16,13, 유로존/NNG;경기/NNG;개선/NNG,29,1.7871104092790777,Hawkish
252,183, 시퀘스터/NNG,435,1.9995128759556897,Hawkish
12,12, 거침/NNG,24,1.4520272075392509,Hawkish
13,8, 수입품/NNG;가격/NNG;상승/NNG,21,2.359544212251283,Hawkish
13,14, 성장/NNG;양호/NNG,27,1.3483109784293044,Hawkish
115,127, 장모/NNG,242,1.3148277863544398,Hawkish
12,9, 수출/NNG;경기/NNG;개선/NNG,21,1.9360362767190011,Hawkish
11,5, 적음/NNG,16,3.1944598565863513,Hawkish
45,44, 소수점/NNG,89,1.4850278258924157,Hawkish
45,37, 소행/NNG,82,1.7659790361963859,Hawkish
31,19, 스승/NNG,50,2.369097022827199,Hawkish
14,13, 태어났/VV,27,1.5637216081191931,Hawkish
24,19, 교환비율/NNG,43,1.834139630575896,Hawkish
14,2, 혜성/NNG,16,10.164190452774756,Hawkish
32,17, 직선/NNG,49,2.7332276847797656,Hawkish
107,118, 대륙/NNG,225,1.3166687390398293,Hawkish
56,50, 하락/NNG;원화/NNG;강세/NNG,106,1.626270472443961,Hawkish
14,13, 성장/NNG;낙관/NNG,27,1.5637216081191931,Hawkish
15,1, 발행시장/NNG;호조/NNG,16,21.78040811308876,Hawkish
15,16, 저점/NNG;하향/NNG,31,1.3612755070680476,Hawkish
12,6, 근시일/NNG,18,2.9040544150785017,Hawkish
29,28, 부동산/NNG;연착륙/NNG,57,1.503885322094224,Hawkish
16,13, 채권/NNG;좋/VA,29,1.7871104092790777,Hawkish
19,20, 대체효과/NNG,39,1.3794258471622882,Hawkish
63,63, 종합소득세/NNG,126,1.4520272075392509,Hawkish
20,15, 누진/NNG,35,1.936036276719001,Hawkish
16,1, 대내외/NNG;경제/NNG;여건/NNG;개선/NNG,17,23.23243532062801,Hawkish
21,18, 특기/NNG,39,1.6940317421291258,Hawkish
12,6, 풍자/NNG,18,2.9040544150785017,Hawkish
55,44, 기간산업/NNG,99,1.8150340094240636,Hawkish
41,5, 아세/NNG,46,11.906623101821856,Hawkish
13,13, 경기/NNG;회복/NNG;안정/NNG,26,1.4520272075392509,Hawkish
32,32, 입찰금액/NNG,64,1.4520272075392506,Hawkish
421,12, 유효경쟁/NNG,433,50.94195453116871,Hawkish
34,27, 회상/NNG,61,1.8284787057901677,Hawkish
17,8, 매도가능금융자산/NNG,25,3.0855578160209083,Hawkish
14,11, 종속회사/NNG,25,1.8480346277772284,Hawkish
28,27, 무형자산/NNG,55,1.5058059930036674,Hawkish
19,20, 차입부채/NNG,39,1.3794258471622882,Hawkish
14,2, 차환/NNG;위험/NNG;증가/NNG,16,10.164190452774756,Hawkish
17,7, 채권/NNG;금리/NNG;되돌/VV,24,3.526351789738181,Hawkish
10,7, 인하/NNG;기대/NNG;높/VA,17,2.07432458219893,Hawkish
57,39, 수요예측/NNG;성공/NNG,96,2.122193611018905,Hawkish
31,34, 가격/NNG;위험/NNG,65,1.3239071598151992,Hawkish
37,40, 순자본/NNG,77,1.343125166973807,Hawkish
22,4, 대내외/NNG;경기/NNG;하방/NNG;위험/NNG,26,7.986149641465879,Hawkish
22,18, 완화정책/NNG;종료/NNG,40,1.774699920325751,Hawkish
40,20, 중기재정계획/NNG,60,2.9040544150785017,Hawkish
29,32, 하마평/NNG,61,1.315899656832446,Hawkish
23,19, 재정승수/NNG,42,1.7577171459685668,Hawkish
15,5, 유로존/NNG;재정/NNG;악화/NNG,20,4.356081622617752,Hawkish
49,41, 애정/NNG,90,1.7353495894981292,Hawkish
18,17, 청정/NNG,35,1.5374405726886184,Hawkish
17,15, 든다면/VV,32,1.645630835211151,Hawkish
13,12, 소폭/MAG;흑자/NNG,25,1.5730294748341882,Hawkish
11,8, 사임설/NNG,19,1.9965374103664697,Hawkish
25,12, 외국통/NNG,37,3.025056682373439,Hawkish
17,3, 문유/NNG,20,8.228154176055755,Hawkish
18,14, 금리/NNG;상승/NNG;어렵/VA,32,1.866892123979037,Hawkish
88,90, 환입/NNG,178,1.4197599362606008,Hawkish
18,17, 소비/NNG;부진/NNG;우려/NNG,35,1.5374405726886184,Hawkish
30,32, 성장/NNG;제약/NNG,62,1.3612755070680476,Hawkish
23,24, 와도/VV,47,1.3915260738917818,Hawkish
16,16, 침식/NNG,32,1.4520272075392506,Hawkish
18,19, 확전/NNG,37,1.375604722931922,Hawkish
15,10, 인도주의/NNG,25,2.178040811308876,Hawkish
17,6, 목매/VV,23,4.114077088027877,Hawkish
16,8, 보위/NNG,24,2.9040544150785013,Hawkish
37,29, 탐구/NNG,66,1.8525864372052512,Hawkish
112,112, 민족/NNG,224,1.4520272075392509,Hawkish
28,31, 모른/VV,59,1.3115084455193233,Hawkish
18,14, 기업/NNG;재고/NNG;감소/NNG,32,1.866892123979037,Hawkish
19,20, 수출/NNG;경제/NNG;성장/NNG,39,1.3794258471622882,Hawkish
14,7, 수출/NNG;증가율/NNG;높/VA,21,2.9040544150785017,Hawkish
15,16, 경제/NNG;플러스/NNG,31,1.3612755070680476,Hawkish
21,13, 수출/NNG;정체/NNG,34,2.3455824121787896,Hawkish
18,20, 신동/NNG,38,1.3068244867853258,Hawkish
18,15, 지엽/NNG,33,1.742432649047101,Hawkish
79,16, 스모/NNG,95,7.169384337225051,Hawkish
20,19, 금리/NNG;하락/NNG;어렵/VA,39,1.5284496921465798,Hawkish
72,64, 기틀/NNG,136,1.6335306084816572,Hawkish
83,79, 순환출자/NNG,162,1.525547572477947,Hawkish
41,34, 출자총액제한제도/NNG,75,1.7509739855620376,Hawkish
27,21, 출점/NNG,48,1.8668921239790368,Hawkish
11,8, 집단소송제/NNG,19,1.9965374103664697,Hawkish
74,82, 공정거래법/NNG,156,1.3103660165598119,Hawkish
24,20, 양육수당/NNG,44,1.742432649047101,Hawkish
45,42,복잡/NNG,87,1.5557434366491971,Hawkish
17,16, 금리/NNG;인하/NNG;기대/NNG;확대/NNG,33,1.5427789080104541,Hawkish
9,10, 원달러/NNG;약세/NNG,19,1.3068244867853258,Hawkish
25,26, 무급/NNG,51,1.3961800072492796,Hawkish
31,8, 영세율/NNG,39,5.626605429214597,Hawkish
16,16, 소속기업/NNG,32,1.4520272075392506,Hawkish
26,24, 노치/NNG,50,1.5730294748341882,Hawkish
11,11, 선호업종/NNG,22,1.4520272075392509,Hawkish
22,7, 트레일러/NNG,29,4.5635140808376455,Hawkish
18,8, 조제/NNG,26,3.2670612169633144,Hawkish
13,14, 채권/NNG;거래/NNG;감소/NNG,27,1.3483109784293044,Hawkish
10,9, 수출/NNG;타격/NNG;우려/NNG,19,1.6133635639325008,Hawkish
38,25, 투자/NNG;수요/NNG;많/VA,63,2.2070813554596613,Hawkish
30,25, 정책/NNG;반대/NNG,55,1.742432649047101,Hawkish
50,50, 경제/NNG;피해/NNG,100,1.4520272075392509,Hawkish
32,30, 수익/NNG;좋/VA,62,1.5488290213752007,Hawkish
17,17, 유로존/NNG;긴축/NNG,34,1.4520272075392509,Hawkish
115,126, dr/NNG,241,1.3252629275159828,Hawkish
9,9, 아마추어/NNG,18,1.4520272075392509,Hawkish
54,53, 국어/NNG,107,1.4794239473041424,Hawkish
48,50, 엘리트/NNG,98,1.393946119237681,Hawkish
12,11, 속마음/NNG,23,1.58402968095191,Hawkish
16,3, 의인/NNG,19,7.744145106876003,Hawkish
14,15, 본성/NNG,29,1.3552253937033008,Hawkish
19,19, 건들/VV,38,1.4520272075392509,Hawkish
17,16, 경제/NNG;성장/NNG;확대/NNG,33,1.5427789080104541,Hawkish
35,27, 물가/NNG;상승/NNG;막/VV,62,1.8822574912545844,Hawkish
9,7, 인다/VV,16,1.866892123979037,Hawkish
24,8, 지만/NNG,32,4.356081622617753,Hawkish
34,21, 치인/VV,55,2.350901193158787,Hawkish
9,9, 세계/NNG;경제/NNG;미약/NNG;회복/NNG,18,1.4520272075392509,Hawkish
26,26, 세계/NNG;경제/NNG;개선/NNG,52,1.4520272075392509,Hawkish
14,13, 환금/NNG,27,1.5637216081191931,Hawkish
20,21, 주목적/NNG,41,1.3828830547992865,Hawkish
25,9, 지정학/NNG;위험/NNG;증대/NNG,34,4.033408909831253,Hawkish
13,5, 더디/VA;경제/NNG;회복/NNG,18,3.775270739602052,Hawkish
37,8, 키프/NNG,45,6.715625834869035,Hawkish
121,132, 해외발/NNG,253,1.331024940244313,Hawkish
47,30, 국유재산/NNG,77,2.274842625144826,Hawkish
15,15, 모아진/VV,30,1.4520272075392506,Hawkish
18,0, 강경론/NNG,18,inf,Hawkish
19,16, 타나/VV,35,1.7242823089528605,Hawkish
36,39, 관치/NNG,75,1.3403328069593086,Hawkish
19,20, 낮/VA;경기/NNG;회복/NNG,39,1.3794258471622882,Hawkish
30,33, 성장/NNG;아니/VCN,63,1.3200247341265916,Hawkish
54,52, 약정이율/NNG,106,1.5078744078292219,Hawkish
25,22, 영공/NNG,47,1.6500309176582397,Hawkish
25,0, 크레딧/NNG;거래/NNG;증가/NNG,25,inf,Hawkish
25,22, 채권/NNG;하락/NNG,47,1.6500309176582397,Hawkish
13,14, 상각채권/NNG,27,1.3483109784293044,Hawkish
10,11, 여액/NNG,21,1.3200247341265916,Hawkish
13,13, 내려갈수록/VV,26,1.4520272075392509,Hawkish
16,7, 절대/MAG;금리/NNG;매력/NNG;높/VA,23,3.3189193315182877,Hawkish
14,10, 회사채/NNG;시장/NNG;강세/NNG,24,2.032838090554951,Hawkish
12,6, 내수/NNG;판매/NNG;부진/NNG,18,2.9040544150785017,Hawkish
11,8, 자산/NNG;성장/NNG;둔화/NNG,19,1.9965374103664697,Hawkish
12,5, 소득/NNG;증가/NNG;낮/VA,17,3.484865298094202,Hawkish
14,11, 현금흐름/NNG;악화/NNG,25,1.8480346277772284,Hawkish
19,14, 역마진/NNG;해소/NNG,33,1.9706083530889835,Hawkish
36,32, 시화/NNG,68,1.6335306084816572,Hawkish
11,5, 하향/NNG;상향/NNG,16,3.1944598565863513,Hawkish
15,5, 안정/NNG;지지/NNG,20,4.356081622617752,Hawkish
13,11, 투자/NNG;쉽/VA,24,1.7160321543645694,Hawkish
8,8, 가분/NNG,16,1.4520272075392506,Hawkish
41,44, 레이팅/NNG,85,1.3530253524797564,Hawkish
12,6, 채권시장/NNG;시장/NNG;강세/NNG,18,2.9040544150785017,Hawkish
20,20, 불확실성/NNG;불안/NNG,40,1.4520272075392509,Hawkish
17,14, 전망/NNG;하향/NNG;금리/NNG;인하/NNG,31,1.7631758948690905,Hawkish
182,183, 기원/NNG,365,1.4440926326346646,Hawkish
19,6, 바램/NNG,25,4.598086157207628,Hawkish
12,6, 다다르/VV,18,2.9040544150785017,Hawkish
26,12, 소금/NNG,38,3.1460589496683764,Hawkish
23,22, 대이/VV,45,1.5180284442455803,Hawkish
19,21, 결기/NNG,40,1.3137389020593222,Hawkish
57,53, 인류/NNG,110,1.561614166598817,Hawkish
35,33, 금리/NNG;상승/NNG;경기/NNG;회복/NNG,68,1.5400288564810236,Hawkish
20,22, 금리/NNG;인상/NNG;양적완화/NNG,42,1.3200247341265916,Hawkish
120,59, 환헤지ㅇ/NNG,179,2.953275676351019,Hawkish
14,12, 첨가/NNG,26,1.6940317421291258,Hawkish
19,20, 금리옵션/NNG,39,1.3794258471622882,Hawkish
31,11, 길라잡이/NNG,42,4.092076675792434,Hawkish
10,6, 채권/NNG;발행/NNG;활성화/NNG,16,2.420045345898751,Hawkish
83,76, 유산/NNG,159,1.5857665556020766,Hawkish
21,10, 지기/NNG,31,3.0492571358324265,Hawkish
15,14, 채산성/NNG;악화/NNG;우려/NNG,29,1.5557434366491973,Hawkish
13,14, 자금/NNG;지원/NNG;강화/NNG,27,1.3483109784293044,Hawkish
10,9, 높/VA;부채/NNG;부담/NNG,19,1.6133635639325008,Hawkish
55,40, 가계/NNG;신용위험/NNG,95,1.9965374103664697,Hawkish
13,10, 절대다수/NNG,23,1.887635369801026,Hawkish
13,13, 농축수산물/NNG;가격/NNG;하락/NNG,26,1.4520272075392509,Hawkish
21,9, 투자/NNG;수요/NNG;높/VA,30,3.3880634842582515,Hawkish
17,15, 성장/NNG;효과/NNG,32,1.645630835211151,Hawkish
11,10, 금리/NNG;변동/NNG;크/VV,21,1.5972299282931757,Hawkish
33,25, 속등/NNG,58,1.916675913951811,Hawkish
12,6, 펀더멘털/NNG;부정적/VAX,18,2.9040544150785017,Hawkish
11,7, 대외/NNG;부진/NNG,18,2.2817570404188228,Hawkish
20,18, 전망/NNG;의구심/NNG,38,1.6133635639325008,Hawkish
23,25, 인플레이션/NNG;기대/NNG;약화/NNG,48,1.3358650309361106,Hawkish
184,122, 조류/NNG,306,2.189942673665755,Hawkish
9,10, 잡혀가/VV,19,1.3068244867853258,Hawkish
8,8, 경제/NNG;성장/NNG;전망/NNG;상향/NNG,16,1.4520272075392506,Hawkish
12,4, 건설/NNG;경기/NNG;좋/VA,16,4.356081622617753,Hawkish
33,23, 수주/NNG;부진/NNG,56,2.083343384730229,Hawkish
26,27, 경제/NNG;건전/NNG,53,1.3982484220748341,Hawkish
14,14, 민간/NNG;소비/NNG;성장/NNG,28,1.4520272075392509,Hawkish
8,8, 성장/NNG;전망/NNG;밝/VA,16,1.4520272075392506,Hawkish
26,1, 이슈기업/NNG,27,37.752707396020526,Hawkish
46,48, 성질/NNG,94,1.3915260738917818,Hawkish
108,92, 세전이익/NNG,200,1.7045536784156423,Hawkish
20,18, 채권단자율협약/NNG,38,1.6133635639325008,Hawkish
22,20, 감액손실/NNG,42,1.5972299282931757,Hawkish
19,16, 투자선호도/NNG,35,1.7242823089528605,Hawkish
36,31, 금리/NNG;인하/NNG;지지/NNG,67,1.6862251442391303,Hawkish
9,7, 악화/NNG;부정적/VAX,16,1.866892123979037,Hawkish
25,4, 설비투자지수/NNG,29,9.075170047120318,Hawkish
14,3, 설비/NNG;투자/NNG;조정/NNG;압력/NNG,17,6.776126968516503,Hawkish
12,5, 경기/NNG;불확실성/NNG;해소/NNG,17,3.484865298094202,Hawkish
17,16, 건설/NNG;수주/NNG;감소/NNG,33,1.5427789080104541,Hawkish
10,11, 건설/NNG;투자/NNG;회복/NNG,21,1.3200247341265916,Hawkish
16,14, 회복/NNG;발목/NNG;잡/VV,30,1.6594596657591438,Hawkish
12,13, 전망/NNG;경기/NNG;둔화/NNG,25,1.3403328069593086,Hawkish
12,6, 월동/NNG,18,2.9040544150785017,Hawkish
45,43, 캐스팅보트/NNG,88,1.5195633567271227,Hawkish
9,7, 언더슈팅/NNG,16,1.866892123979037,Hawkish
37,39, 배양/NNG,76,1.3775642738192893,Hawkish
10,6, 경제주체/NNG;심리/NNG;호전/NNG,16,2.420045345898751,Hawkish
20,2, 부정적/VAX;효과/NNG;완화/NNG,22,14.520272075392509,Hawkish
10,7, 가계/NNG;부채/NNG;완화/NNG,17,2.07432458219893,Hawkish
24,10, 완화정책/NNG;축소/NNG,34,3.484865298094202,Hawkish
27,0, 오디세이아/NNG,27,inf,Hawkish
9,7, 여인/NNG,16,1.866892123979037,Hawkish
121,129, 딸/NNG,250,1.3619790086220878,Hawkish
22,22, 곁/NNG,44,1.4520272075392509,Hawkish
17,17, 바위/NNG,34,1.4520272075392509,Hawkish
32,29, 사절단/NNG,61,1.6022369186640009,Hawkish
11,9, 무역자유화/NNG,20,1.774699920325751,Hawkish
11,10, 경제/NNG;확대/NNG,21,1.5972299282931757,Hawkish
36,30, 누출/NNG,66,1.742432649047101,Hawkish
12,9, 특정인/NNG,21,1.9360362767190011,Hawkish
36,37, 클라이언트/NNG,73,1.412783228957109,Hawkish
23,18, 그램/NNG,41,1.855368098522376,Hawkish
55,61, 벤/NNG,116,1.3092048592567016,Hawkish
26,20, 개운/NNG,46,1.887635369801026,Hawkish
56,55, 태핑/NNG,111,1.4784277022217827,Hawkish
75,38, 선장/NNG,113,2.8658431727748375,Hawkish
10,11, 이벤트드리븐/NNG,21,1.3200247341265916,Hawkish
75,9, 도드프랭크법/NNG,84,12.100226729493757,Hawkish
17,2, 우신/NNG,19,12.342231264083633,Hawkish
39,32, 부익부/NNG,71,1.769658159188462,Hawkish
38,35, 빈익빈/NNG,73,1.5764866824711867,Hawkish
9,7, 알리오/NNG,16,1.866892123979037,Hawkish
20,9, 중장기재무관리계획/NNG,29,3.2267271278650016,Hawkish
25,12, 기타공공기관/NNG,37,3.025056682373439,Hawkish
17,2, 재무관리계획/NNG,19,12.342231264083633,Hawkish
14,3, 공공기관중장기재무관리계획/NNG,17,6.776126968516503,Hawkish
96,73, 민평/NNG;낮/VA,169,1.9095152318324395,Hawkish
10,9, 정한/NNG,19,1.6133635639325008,Hawkish
24,23, 부동산/NNG;가격/NNG;억제/NNG,47,1.5151588252583488,Hawkish
13,8, 경제/NNG;회복/NNG;약화/NNG,21,2.359544212251283,Hawkish
15,11, 위험/NNG;부정적/VAX,26,1.9800371011898874,Hawkish
24,21, 문명/NNG,45,1.6594596657591438,Hawkish
13,14, 야망/NNG,27,1.3483109784293044,Hawkish
168,127, 취임식/NNG,295,1.9207918965873554,Hawkish
38,39, 회원수/NNG,77,1.41479574067927,Hawkish
9,7, 오마/NNG,16,1.866892123979037,Hawkish
9,9, 경제/NNG;회복/NNG;부진/NNG,18,1.4520272075392509,Hawkish
28,30, 채권/NNG;매입/NNG;중단/NNG,58,1.3552253937033008,Hawkish
13,7, 강하/VA;추세/NNG,20,2.6966219568586087,Hawkish
54,5, 토피아/NNG,59,15.681893841423907,Hawkish
11,6, 채권시장/NNG;양적완화/NNG;축소/NNG,17,2.662049880488626,Hawkish
11,12, 끌어낸/VV,23,1.331024940244313,Hawkish
42,31, 사연/NNG,73,1.967262668278985,Hawkish
32,29, 모기지/NNG;금리/NNG;급등/NNG,61,1.6022369186640009,Hawkish
33,15, 민간/NNG;고용/NNG;부진/NNG,48,3.1944598565863513,Hawkish
21,23, 벌크/NNG,44,1.325763972101055,Hawkish
54,40, 접할/VV,94,1.9602367301779884,Hawkish
34,36, 진공/NNG,70,1.3713590293426259,Hawkish
15,2, 쎈/VA,17,10.89020405654438,Hawkish
11,8, 정박/NNG,19,1.9965374103664697,Hawkish
9,10, 양적완화/NNG;조치/NNG;축소/NNG,19,1.3068244867853258,Hawkish
19,19, 상방/NNG;하방/NNG;위험/NNG,38,1.4520272075392509,Hawkish
9,9, 성장/NNG;둔화/NNG;막/VV,18,1.4520272075392509,Hawkish
18,1, 경제/NNG;전망/NNG;성장률/NNG;상향/NNG,19,26.136489735706515,Hawkish
25,26, 구조적/VAX;저성장/NNG,51,1.3961800072492796,Hawkish
9,10, 둔화/NNG;증가/NNG,19,1.3068244867853258,Hawkish
16,17, 정보의비대칭성/NNG,33,1.3666138423898828,Hawkish
16,13, 정보부족/NNG,29,1.7871104092790777,Hawkish
25,25, fed/NNG;자산/NNG;매입/NNG;축소/NNG;우려/NNG,50,1.4520272075392509,Hawkish
12,6, 단기물/NNG;강세/NNG;장기물/NNG;약세/NNG,18,2.9040544150785017,Hawkish
12,10, 수익/NNG;부정적/VAX,22,1.742432649047101,Hawkish
283,163, 크로네/NNG,446,2.5210042928442205,Hawkish
33,27, 사기업/NNG,60,1.7746999203257507,Hawkish
33,24, 공익사업/NNG,57,1.9965374103664695,Hawkish
36,21, 상하향/NNG,57,2.4891894986387157,Hawkish
48,50, 사라/NNG,98,1.393946119237681,Hawkish
16,1, 경기/NNG;하방/NNG;위험/NNG;금리/NNG;인하/NNG,17,23.23243532062801,Hawkish
17,18, 글로벌/NNG;경기/NNG;회복/NNG;지연/NNG,35,1.3713590293426259,Hawkish
12,8, 경상/NNG;수지/NNG;재정/NNG;적자/NNG,20,2.1780408113088763,Hawkish
19,15, 기업/NNG;설비/NNG;투자/NNG;확대/NNG,34,1.839234462883051,Hawkish
11,12, 전망/NNG;양적완화/NNG,23,1.331024940244313,Hawkish
15,14, 펀더멘털/NNG;안정/NNG,29,1.5557434366491973,Hawkish
37,35, 부실채권/NNG;증가/NNG,72,1.5350001908272082,Hawkish
11,9, 판매가격/NNG;저조/NNG,20,1.774699920325751,Hawkish
13,14, 한계기업/NNG;증가/NNG,27,1.3483109784293044,Hawkish
55,59, 건전성/NNG;확보/NNG,114,1.353584684994217,Hawkish
14,15, 수익성/NNG;약화/NNG,29,1.3552253937033008,Hawkish
48,50, 성장/NNG;전환/NNG,98,1.393946119237681,Hawkish
23,21, 금리/NNG;회복/NNG,44,1.5903155130191793,Hawkish
13,12, 컨디션/NNG,25,1.5730294748341882,Hawkish
37,38, 자산/NNG;매입/NNG;중단/NNG,75,1.4138159652355864,Hawkish
24,24, 비용/NNG;통제/NNG,48,1.4520272075392509,Hawkish
9,7, 예상/NNG;낙관/NNG,16,1.866892123979037,Hawkish
12,8, 상통/NNG,20,2.1780408113088763,Hawkish
10,10, 계회/NNG,20,1.4520272075392509,Hawkish
12,13, 수출/NNG;증가율/NNG;감소/NNG,25,1.3403328069593086,Hawkish
15,11, 신용경색/NNG;불안/NNG,26,1.9800371011898874,Hawkish
111,41, 총자본비율/NNG,152,3.931098049679435,Hawkish
20,17, 산시/NNG,37,1.7082673029873539,Hawkish
31,12, 전망/NNG;양적완화/NNG;축소/NNG,43,3.7510702861430643,Hawkish
9,10, 채권시장/NNG;변동성/NNG;줄/VV,19,1.3068244867853258,Hawkish
9,7, 개선/NNG;노력/NNG;강화/NNG,16,1.866892123979037,Hawkish
31,30, 장폭/NNG,61,1.5004281144572258,Hawkish
19,18, 당분간/MAG;성장/NNG,37,1.5326953857358758,Hawkish
19,21, 심각/NNG;위축/NNG,40,1.3137389020593222,Hawkish
70,28, 회사채신속인수제/NNG,98,3.6300680188481276,Hawkish
11,11, 투자/NNG;한계/NNG,22,1.4520272075392509,Hawkish
66,62, 피해/NNG;막/VV,128,1.5457063822192025,Hawkish
19,17, 세자/NNG,36,1.622853937837986,Hawkish
23,24, 리수/NNG,47,1.3915260738917818,Hawkish
15,10, 경기/NNG;의구심/NNG,25,2.178040811308876,Hawkish
19,18, 우려/NNG;쉽/VA,37,1.5326953857358758,Hawkish
17,16, 거리/VV,33,1.5427789080104541,Hawkish
22,8, 보증채/NNG,30,3.9930748207329394,Hawkish
10,6, 지비/NNG,16,2.420045345898751,Hawkish
11,10, 호조/NNG;양호/NNG,21,1.5972299282931757,Hawkish
20,22, 일화/NNG,42,1.3200247341265916,Hawkish
40,39, 이민자/NNG,79,1.4892586743992315,Hawkish
11,9, 져/VV,20,1.774699920325751,Hawkish
89,80, 매도가능증권/NNG,169,1.6153802683874163,Hawkish
12,4, fed/NNG;자산/NNG;매입/NNG;축소/NNG;지연/NNG,16,4.356081622617753,Hawkish
31,33, 금리/NNG;좋/VA,64,1.364025558597478,Hawkish
12,5, 총자/NNG,17,3.484865298094202,Hawkish
39,14, 수목/NNG,53,4.044932935287913,Hawkish
42,35, 잠재수요/NNG,77,1.742432649047101,Hawkish
11,11, 임금/NNG;소득/NNG;증가/NNG,22,1.4520272075392509,Hawkish
18,15, 위험/NNG;높/VA;않/VX,33,1.742432649047101,Hawkish
15,8, 투자/NNG;양호/NNG,23,2.722551014136095,Hawkish
29,27, 여력/NNG;떨어/VV,56,1.559584778468084,Hawkish
13,12, 투자/NNG;경기/NNG;회복/NNG,25,1.5730294748341882,Hawkish
11,9, 경제/NNG;우려/NNG;높/VA,20,1.774699920325751,Hawkish
14,15, 장대/NNG,29,1.3552253937033008,Hawkish
101,104, 생산가능인구/NNG,205,1.4101418073217724,Hawkish
15,14, 인구수/NNG,29,1.5557434366491973,Hawkish
14,10, 우려/NNG;제한/NNG,24,2.032838090554951,Hawkish
11,11, 수요예측/NNG;흥행/NNG;성공/NNG,22,1.4520272075392509,Hawkish
14,10, 기업연구소/NNG,24,2.032838090554951,Hawkish
44,40, 롱텀/NNG,84,1.5972299282931757,Hawkish
19,20, 잠깐/NNG,39,1.3794258471622882,Hawkish
16,16, 취한다/VV,32,1.4520272075392506,Hawkish
35,36, 서술/NNG,71,1.4116931184409385,Hawkish
27,28, 가격/NNG;살/VV,55,1.4001690929842776,Hawkish
16,6, 신흥국/NNG;경기/NNG;모멘텀/NNG,22,3.8720725534380014,Hawkish
8,8, 회복/NNG;가능성/NNG;높/VA,16,1.4520272075392506,Hawkish
28,23, 개선/NNG;기대/NNG;높/VA,51,1.76768529613474,Hawkish
72,6, 로컬통화/NNG,78,17.42432649047101,Hawkish
32,25, 자금/NNG;유출/NNG;확대/NNG,57,1.858594825650241,Hawkish
12,5, 자금/NNG;이탈/NNG;확대/NNG,17,3.484865298094202,Hawkish
13,7, 황금시대/NNG,20,2.6966219568586087,Hawkish
13,13, 달리/MAG;경기/NNG;회복/NNG,26,1.4520272075392509,Hawkish
11,6, 침체/NNG;빠지/VV;막/VV,17,2.662049880488626,Hawkish
230,1, 공아/NNG,231,333.9662577340277,Hawkish
21,19, 프리젠테이션/NNG,40,1.604872176753909,Hawkish
24,24, 심리/NNG;압박/NNG,48,1.4520272075392509,Hawkish
15,12, 식용/NNG,27,1.8150340094240633,Hawkish
33,29, 팔라듐/NNG,62,1.6523068223722508,Hawkish
12,9, 원자재/NNG;시장/NNG;약세/NNG,21,1.9360362767190011,Hawkish
39,40, 빈약/NNG,79,1.4157265273507695,Hawkish
13,8, 진행시/NNG,21,2.359544212251283,Hawkish
40,37,견고/NNG,77,1.5697591432856766,Hawkish
58,20, 동두천/NNG,78,4.210878901863827,Hawkish
21,15, 급락/NNG;전환/NNG,36,2.032838090554951,Hawkish
63,59,서베이/NNG,122,1.550469730084285,Hawkish
21,18, 수익성자산/NNG,39,1.6940317421291258,Hawkish
18,6, 재자/NNG,24,4.356081622617753,Hawkish
9,7, fed/NNG;양적완화/NNG;축소/NNG;불확실성/NNG,16,1.866892123979037,Hawkish
9,7, 글로벌/NNG;금리/NNG;안정/NNG,16,1.866892123979037,Hawkish
108,115, 주택/NNG;거래/NNG;활성화/NNG,223,1.3636429427325139,Hawkish
13,4, 부양/NNG;아니/VCN,17,4.719088424502566,Hawkish
16,17, 외부/NNG;불확실성/NNG,33,1.3666138423898828,Hawkish
22,19, 기복/NNG,41,1.6812946613612378,Hawkish
47,25, 으뜸/NNG,72,2.7298111501737914,Hawkish
28,27, 손익계산서/NNG,55,1.5058059930036674,Hawkish
25,1, 로유/NNG,26,36.30068018848127,Hawkish
16,10, 칠/XSV,26,2.323243532062801,Hawkish
31,27, 수입금액/NNG,58,1.6671423493969175,Hawkish
23,11, 인도인/NNG,34,3.0360568884911605,Hawkish
53,48, 반입/NNG,101,1.6032800416579227,Hawkish
21,22, 인도기업/NNG,43,1.3860259708329212,Hawkish
30,30, 매세/NNG,60,1.4520272075392506,Hawkish
72,73, 점유/NNG,145,1.4321364238743297,Hawkish
34,26, 수출금액/NNG,60,1.8988048098590204,Hawkish
12,8, 소비자/NNG;심리/NNG;지수/NNG;개선/NNG,20,2.1780408113088763,Hawkish
10,6, 경기/NNG;회복/NNG;가능성/NNG;높/VA,16,2.420045345898751,Hawkish
11,10, 타격/NNG;받/VV;밖/NNG;없/VA,21,1.5972299282931757,Hawkish
11,6, 외국인/NNG;투자/NNG;촉진/NNG,17,2.662049880488626,Hawkish
10,8, 높/VA;시장/NNG;불안/NNG,18,1.8150340094240636,Hawkish
22,19, 혜안/NNG,41,1.6812946613612378,Hawkish
84,77, 특사/NNG,161,1.5840296809519099,Hawkish
26,22, 시달려/VV,48,1.7160321543645694,Hawkish
226,54, 통계국/NNG,280,6.077002757479086,Hawkish
99,66, 기간프리미엄/NNG,165,2.1780408113088763,Hawkish
33,31, 입어/NNG,64,1.5457063822192025,Hawkish
219,174, 인준/NNG,393,1.827551485351126,Hawkish
14,4, 부동산협회/NNG,18,5.082095226387378,Hawkish
62,43, 에너지산업/NNG,105,2.093620624824036,Hawkish
25,17, 당분간/MAG;경기/NNG;회복/NNG,42,2.1353341287341925,Hawkish
20,18, 인플레이션/NNG;우려/NNG;없/VA,38,1.6133635639325008,Hawkish
18,20, 채권/NNG;매입/NNG;줄/VV,38,1.3068244867853258,Hawkish
16,16, 채권비중/NNG;축소/NNG,32,1.4520272075392506,Hawkish
15,11, 여력/NNG;증가/NNG,26,1.9800371011898874,Hawkish
33,32, 국채전문딜러/NNG,65,1.4974030577748523,Hawkish
30,27, 은행계정/NNG,57,1.6133635639325008,Hawkish
13,12, 양적완화/NNG;축소/NNG;가능성/NNG;크/VV,25,1.5730294748341882,Hawkish
19,13, 경기/NNG;전망/NNG;상향/NNG,32,2.122193611018905,Hawkish
13,12, 달리/MAG;성장/NNG,25,1.5730294748341882,Hawkish
12,9, 안정성/NNG;양호/NNG,21,1.9360362767190011,Hawkish
9,9, 제조업/NNG;경기/NNG;상승/NNG,18,1.4520272075392509,Hawkish
19,14, 존/VA,33,1.9706083530889835,Hawkish
20,17, 등락세/NNG,37,1.7082673029873539,Hawkish
14,12, 명과/NNG,26,1.6940317421291258,Hawkish
42,45, 중상위/NNG,87,1.3552253937033008,Hawkish
11,8, 연식/NNG,19,1.9965374103664697,Hawkish
10,9, 좋/VA;신호/NNG;아니/VCN,19,1.6133635639325008,Hawkish
27,19, 제조업/NNG;상승/NNG,46,2.0634070843978827,Hawkish
93,70, 기상악화/NNG,163,1.9291218614450045,Hawkish
10,7, 물가/NNG;상승률/NNG;국제/NNG;유가/NNG;상승/NNG,17,2.07432458219893,Hawkish
8,8, 중폭/NNG,16,1.4520272075392506,Hawkish
23,22, 미디어그룹/NNG,45,1.5180284442455803,Hawkish
9,9, 섰다/NNG,18,1.4520272075392509,Hawkish
42,45, 제국/NNG,87,1.3552253937033008,Hawkish
30,26, 사회봉사/NNG,56,1.6754160086991354,Hawkish
17,18, 접경지역/NNG,35,1.3713590293426259,Hawkish
33,28, 지뢰/NNG,61,1.7113177803141169,Hawkish
35,32, 증강/NNG,67,1.5881547582460558,Hawkish
47,50, 와해/NNG,97,1.3649055750868957,Hawkish
23,24, 침체/NNG;빠지/VV;않/VX,47,1.3915260738917818,Hawkish
9,8, 변동성/NNG;크/VV;가능성/NNG;높/VA,17,1.6335306084816572,Hawkish
43,47, 끊긴/VV,90,1.328450423918889,Hawkish
8,8, 흩어진/VV,16,1.4520272075392506,Hawkish
31,29, 재배치/NNG,60,1.552167014955751,Hawkish
19,19, 통화정책/NNG;부양/NNG,38,1.4520272075392509,Hawkish
31,31, 매우/MAG;완화/NNG,62,1.452027207539251,Hawkish
9,8,증시자금/NNG,17,1.6335306084816572,Hawkish
48,48, 소재산업/NNG,96,1.4520272075392509,Hawkish
14,10, 운송지수/NNG,24,2.032838090554951,Hawkish
95,103, 합법/NNG,198,1.3392483953031926,Hawkish
17,17, 위험자산/NNG;선호/NNG;높/VV,34,1.4520272075392509,Hawkish
20,17, 높/VA;인플레이션/NNG;우려/NNG,37,1.7082673029873539,Hawkish
16,4, 인플레이션/NNG;우려/NNG;낮/VA,20,5.8081088301570025,Hawkish
30,21, 인플레이션/NNG;매우/MAG;낮/VA,51,2.07432458219893,Hawkish
81,37, 주채무계열/NNG,118,3.178762265153495,Hawkish
11,12, 중간선/NNG,23,1.331024940244313,Hawkish
13,10, 만이/NNG,23,1.887635369801026,Hawkish
77,76, 로드/NNG,153,1.4711328286910832,Hawkish
34,8, 행단/NNG,42,6.171115632041817,Hawkish
55,42, 자율규제/NNG,97,1.901464200349019,Hawkish
15,16, 관리기능/NNG,31,1.3612755070680476,Hawkish
33,32, 제재안/NNG,65,1.4974030577748523,Hawkish
104,108, 입김/NNG,212,1.3982484220748341,Hawkish
64,62, 고정이하여신/NNG,126,1.4988667948792267,Hawkish
47,29, 대손충당금비율/NNG,76,2.3532854742877514,Hawkish
26,25, 충당금/NNG;적립/NNG;부담/NNG,51,1.510108295840821,Hawkish
11,6, 경기/NNG;회복/NNG;위험/NNG,17,2.662049880488626,Hawkish
12,11, 건전성/NNG;부정적/VAX,23,1.58402968095191,Hawkish
50,51, 뒤흔든/VV,101,1.423556085822795,Hawkish
14,7, 한계소비성향/NNG,21,2.9040544150785017,Hawkish
20,14, 조지/NNG,34,2.07432458219893,Hawkish
11,8, 경기/NNG;둔화/NNG;금융시장/NNG;불안/NNG,19,1.9965374103664697,Hawkish
10,9, 물가/NNG;상승/NNG;압력/NNG;증대/NNG,19,1.6133635639325008,Hawkish
14,9, 불확실성/NNG;성장/NNG,23,2.258708989505501,Hawkish
20,17, 안정/NNG;위협/NNG,37,1.7082673029873539,Hawkish
15,15, 위협/NNG;아니/VCN,30,1.4520272075392506,Hawkish
14,13, 부러지/VV,27,1.5637216081191931,Hawkish
85,67, 주식자산/NNG,152,1.8421240692662137,Hawkish
10,10, 실물/NNG;경기/NNG;호전/NNG,20,1.4520272075392509,Hawkish
12,10, 편도/NNG,22,1.742432649047101,Hawkish
52,37, 계량화/NNG,89,2.0406868862713794,Hawkish
22,20, 미치/NNG,42,1.5972299282931757,Hawkish
88,89, 크리스마스/NNG,177,1.4357122950949894,Hawkish
13,12,역발상/NNG,25,1.5730294748341882,Hawkish
28,29, 밤새/NNG,57,1.4019573038310007,Hawkish
9,10, 상승률/NNG;추세/NNG,19,1.3068244867853258,Hawkish
15,6, 폐쇄/NNG;피하/VV,21,3.6300680188481267,Hawkish
38,3, 전환로/NNG,41,18.39234462883051,Hawkish
28,29, 채무증권/NNG,57,1.4019573038310007,Hawkish
32,22, 주택건설협회/NNG,54,2.1120395746025467,Hawkish
24,5, 단기자금시장/NNG;불안/NNG,29,6.969730596188404,Hawkish
18,7, 빌린다/VV,25,3.733784247958074,Hawkish
15,15, 불균등/NNG,30,1.4520272075392506,Hawkish
14,13, 경제/NNG;내외/NNG;성장/NNG,27,1.5637216081191931,Hawkish
11,6, 실업자/NNG;감소/NNG,17,2.662049880488626,Hawkish
10,8, 중견그룹/NNG,18,1.8150340094240636,Hawkish
10,8, 경제/NNG;대외/NNG;불확실성/NNG,18,1.8150340094240636,Hawkish
41,39, 국제/NNG;유가/NNG;불안/NNG,80,1.5264901412592125,Hawkish
57,60, 위험/NNG;불확실성/NNG,117,1.3794258471622882,Hawkish
11,10, 업황/NNG;호전/NNG,21,1.5972299282931757,Hawkish
167,1, 예측액/NNG,168,242.4885436590549,Hawkish
18,16, 마무리짓기/NNG,34,1.6335306084816572,Hawkish
19,15, 중전회/NNG,34,1.839234462883051,Hawkish
16,15, 회사채/NNG;수요예측/NNG;성공/NNG,31,1.5488290213752007,Hawkish
8,8, 기대/NNG;시장/NNG;강세/NNG,16,1.4520272075392506,Hawkish
26,26, 경기/NNG;활황/NNG,52,1.4520272075392509,Hawkish
15,15, 한계기업/NNG;늘/VV,30,1.4520272075392506,Hawkish
10,11, 금리/NNG;하락/NNG;멈추/VV,21,1.3200247341265916,Hawkish
23,0, 박재/NNG,23,inf,Hawkish
10,11, 내비/NNG,21,1.3200247341265916,Hawkish
71,73, 비서/NNG,144,1.4122456402094086,Hawkish
57,16, 오이/NNG,73,5.172846926858581,Hawkish
20,21, 유통산업/NNG,41,1.3828830547992865,Hawkish
66,72, 핑/NNG,138,1.331024940244313,Hawkish
118,54, 초과이익/NNG,172,3.1729483424005847,Hawkish
21,11, 주주지분/NNG,32,2.7720519416658425,Hawkish
94,102, bps/NNG,196,1.338142720673427,Hawkish
10,8, 기업가치평가/NNG,18,1.8150340094240636,Hawkish
15,4, 유한/VV,19,5.44510202827219,Hawkish
13,14, 잔존가치/NNG,27,1.3483109784293044,Hawkish
16,16, 경쟁기업/NNG,32,1.4520272075392506,Hawkish
15,3, 재비/NNG,18,7.260136037696253,Hawkish
16,6, 경재/NNG,22,3.8720725534380014,Hawkish
20,14, 유스/NNG,34,2.07432458219893,Hawkish
12,10, 시우/NNG,22,1.742432649047101,Hawkish
13,4, 험/VV,17,4.719088424502566,Hawkish
14,10, 코루나/NNG,24,2.032838090554951,Hawkish
8,8, 경기/NNG;회복/NNG;기대/NNG;강하/VA,16,1.4520272075392506,Hawkish
16,3, 경기/NNG;개선/NNG;모멘텀/NNG,19,7.744145106876003,Hawkish
22,18, 선진국/NNG;경기/NNG;개선/NNG,40,1.774699920325751,Hawkish
34,35, 금융시장/NNG;부담/NNG,69,1.4105407158952723,Hawkish
18,13, 과열/NNG;경계/NNG,31,2.010499210438963,Hawkish
28,30, 과열/NNG;부담/NNG,58,1.3552253937033008,Hawkish
23,15, 동조성/NNG,38,2.2264417182268508,Hawkish
39,40, 생산기업/NNG,79,1.4157265273507695,Hawkish
28,31, fed/NNG;예상/NNG;금리/NNG;인상/NNG,59,1.3115084455193233,Hawkish
15,16, 원리금/NNG;상환/NNG;부담/NNG;증가/NNG,31,1.3612755070680476,Hawkish
30,29, 자금/NNG;조달/NNG;비용/NNG;증가/NNG,59,1.5020971112475008,Hawkish
9,9, 완화정책/NNG;철회/NNG,18,1.4520272075392509,Hawkish
25,23, 회색/NNG,48,1.5782904429774465,Hawkish
165,141, 자동차금융/NNG,306,1.6991807747799745,Hawkish
14,11, 레드오션/NNG,25,1.8480346277772284,Hawkish
16,8, 계륵/NNG,24,2.9040544150785013,Hawkish
25,18, 상위업종/NNG,43,2.0167044549156263,Hawkish
28,26, 만장/NNG,54,1.5637216081191931,Hawkish
32,29, 결제비중/NNG,61,1.6022369186640009,Hawkish
21,11, 공공기관/NNG;부채/NNG;감축/NNG,32,2.7720519416658425,Hawkish
12,7, 공기업/NNG;부채/NNG;감축/NNG,19,2.489189498638716,Hawkish
16,6, 위험/NNG;사전/NNG;차단/NNG,22,3.8720725534380014,Hawkish
9,9, 부진/NNG;수출/NNG;호조/NNG,18,1.4520272075392509,Hawkish
12,6, 유동성/NNG;위험/NNG;확대/NNG,18,2.9040544150785017,Hawkish
10,10, 회복/NNG;부담/NNG,20,1.4520272075392509,Hawkish
9,9, 통화/NNG;하락/NNG;방어/NNG,18,1.4520272075392509,Hawkish
23,18, 투자심리/NNG;약하/VA,41,1.855368098522376,Hawkish
20,2, 정요/NNG,22,14.520272075392509,Hawkish
10,7, 적어져/VV,17,2.07432458219893,Hawkish
20,19, 경제/NNG;불확실성/NNG;확대/NNG,39,1.5284496921465798,Hawkish
14,6, 자본비율/NNG;충족/NNG,20,3.3880634842582515,Hawkish
36,22, 이탈/NNG;가속/NNG,58,2.376044521427865,Hawkish
13,13, 금리/NNG;인상/NNG;가능성/NNG;지지/NNG,26,1.4520272075392509,Hawkish
21,19, 상환전환우선주/NNG,40,1.604872176753909,Hawkish
29,8, 노동통계국/NNG,37,5.263598627329784,Hawkish
45,45, 휴무/NNG,90,1.4520272075392509,Hawkish
17,1, 북반구/NNG,18,24.684462528167266,Hawkish
17,0, 숭어/NNG,17,inf,Hawkish
17,0, 망둥이/NNG,17,inf,Hawkish
35,36, 뛴다/VV,71,1.4116931184409385,Hawkish
19,4, 원자재/NNG;가격/NNG;상승/NNG;압력/NNG,23,6.897129235811442,Hawkish
18,4, 금리/NNG;하락/NNG;채권/NNG;강세/NNG,22,6.534122433926629,Hawkish
18,3, 금리/NNG;상승/NNG;채권/NNG;약세/NNG,21,8.712163245235505,Hawkish
18,1, 예상/NNG;채권/NNG;금리/NNG;상승/NNG,19,26.136489735706515,Hawkish
21,20, 과잉/NNG;유동성/NNG;해소/NNG,41,1.5246285679162133,Hawkish
29,27, 신규/NNG;대출/NNG;급증/NNG,56,1.559584778468084,Hawkish
15,11, 곡물/NNG;가격/NNG;안정/NNG,26,1.9800371011898874,Hawkish
8,8, 경기/NNG;판단/NNG;긍정적/VAX,16,1.4520272075392506,Hawkish
18,19, 단기/NNG;하락/NNG;압력/NNG,37,1.375604722931922,Hawkish
24,13,디레버리징/NNG,37,2.680665613918617,Hawkish
21,21, 미뤄져/VV,42,1.4520272075392509,Hawkish
20,20, 효/NNG,40,1.4520272075392509,Hawkish
11,6, 성장/NNG;전망/NNG;불확실성/NNG,17,2.662049880488626,Hawkish
22,6, 개선/NNG;경제/NNG;성장/NNG,28,5.324099760977252,Hawkish
11,8, 실업률/NNG;전망/NNG;하향/NNG,19,1.9965374103664697,Hawkish
24,20, 채권/NNG;일드커브/NNG;플래트닝/NNG,44,1.742432649047101,Hawkish
11,8, 신규/NNG;주택가격/NNG;상승/NNG,19,1.9965374103664697,Hawkish
13,9, 소비/NNG;지출/NNG;개선/NNG,22,2.097372633112251,Hawkish
11,12, 소비/NNG;지출/NNG;성장/NNG,23,1.331024940244313,Hawkish
10,9, 근로/NNG;소득/NNG;증가/NNG,19,1.6133635639325008,Hawkish
35,0, 하향/NNG;등급/NNG;하향/NNG,35,inf,Hawkish
19,17, 경기/NNG;우려/NNG;완화/NNG,36,1.622853937837986,Hawkish
10,7, 안정성/NNG;위험/NNG,17,2.07432458219893,Hawkish
15,15, 투자/NNG;미루/VV,30,1.4520272075392506,Hawkish
11,8, 자동차협회/NNG,19,1.9965374103664697,Hawkish
18,3, 장목/NNG,21,8.712163245235505,Hawkish
11,10, 경제/NNG;물가/NNG;상승/NNG;압력/NNG,21,1.5972299282931757,Hawkish
19,16, 원화/NNG;강세/NNG;제한/NNG,35,1.7242823089528605,Hawkish
14,7, 하락/NNG;수출/NNG;둔화/NNG,21,2.9040544150785017,Hawkish
18,20, 주문/NNG;급증/NNG,38,1.3068244867853258,Hawkish
27,16, 생산/NNG;호조/NNG,43,2.4502959127224857,Hawkish
144,134, 윈도드레싱/NNG,278,1.5603874469078518,Hawkish
13,7, 리비/NNG,20,2.6966219568586087,Hawkish
43,39, 헤/XSV,82,1.6009530749791738,Hawkish
25,21, 밀과/NNG,46,1.7286038184991082,Hawkish
13,3, 금/NNG;가격/NNG;안전자산/NNG;선호/NNG,16,6.292117899336753,Hawkish
10,9, 경제/NNG;고도성장/NNG,19,1.6133635639325008,Hawkish
11,10, 매파/NNG;금리/NNG;인하/NNG,21,1.5972299282931757,Hawkish
17,17, 망가졌/VV,34,1.4520272075392509,Hawkish
96,102, 혁/NNG,198,1.366613842389883,Hawkish
23,18,정체/NNG,41,1.855368098522376,Hawkish
78,72, 거래단위/NNG,150,1.5730294748341884,Hawkish
12,12, 세계/NNG;경제/NNG;호전/NNG,24,1.4520272075392509,Hawkish
24,25, 기대/NNG;소폭/MAG;상승/NNG,49,1.393946119237681,Hawkish
11,9, 고용률/NNG;상승/NNG,20,1.774699920325751,Hawkish
17,12, 산업/NNG;호조/NNG,29,2.0570385440139387,Hawkish
100,86, 버냉키쇼크/NNG,186,1.6884037296968033,Hawkish
195,137, 춘절/NNG,332,2.0667540545266707,Hawkish
10,10, 위험/NNG;금리/NNG;상승/NNG,20,1.4520272075392509,Hawkish
37,8, 투자주/NNG,45,6.715625834869035,Hawkish
13,8, 신흥국/NNG;외환시장/NNG;불안/NNG,21,2.359544212251283,Hawkish
40,42, 피한/VV,82,1.3828830547992865,Hawkish
18,5, 파산제도/NNG,23,5.227297947141303,Hawkish
34,13, 참여금액/NNG,47,3.797609619718041,Hawkish
22,11, 사공/NNG,33,2.9040544150785017,Hawkish
28,16, 파산법/NNG,44,2.541047613193689,Hawkish
20,21, 신흥국/NNG;통화/NNG;절하/NNG,41,1.3828830547992865,Hawkish
11,8, 회사채/NNG;투자/NNG;늘/VV,19,1.9965374103664697,Hawkish
13,6, 채권시장/NNG;회복/NNG,19,3.1460589496683764,Hawkish
11,5, 투자심리/NNG;제한/NNG,16,3.1944598565863513,Hawkish
9,7, 예상밖/NNG;강세/NNG,16,1.866892123979037,Hawkish
9,9, 높/VA;개선/NNG,18,1.4520272075392509,Hawkish
65,70, 소중/NNG,135,1.3483109784293041,Hawkish
10,11, 컨센서스/NNG;넘/VV,21,1.3200247341265916,Hawkish
52,55, 구매관리자협회/NNG,107,1.3728257234916554,Hawkish
37,27, 폐사/NNG,64,1.9898150621834176,Hawkish
16,6, 가격/NNG;경기/NNG;둔화/NNG;우려/NNG,22,3.8720725534380014,Hawkish
16,16, 광의/NNG;통화/NNG;증가/NNG,32,1.4520272075392506,Hawkish
15,8, 경제/NNG;경기/NNG;부양/NNG,23,2.722551014136095,Hawkish
10,10, 위험/NNG;개선/NNG,20,1.4520272075392509,Hawkish
13,12, 고용구조/NNG,25,1.5730294748341882,Hawkish
20,13, 역기/NNG,33,2.2338880115988475,Hawkish
9,10, 수요/NNG;증가/NNG;전망/NNG;상승/NNG,19,1.3068244867853258,Hawkish
17,13, 서비스업/NNG;상승/NNG,30,1.8988048098590204,Hawkish
21,18, 황은/NNG,39,1.6940317421291258,Hawkish
25,20, 주택/NNG;판매가격/NNG;감소/NNG,45,1.8150340094240636,Hawkish
9,7, 통화/NNG;증가/NNG;둔화/NNG,16,1.866892123979037,Hawkish
14,15, 완만/NNG;경기/NNG;개선/NNG,29,1.3552253937033008,Hawkish
19,11, 제조업/NNG;하락/NNG,30,2.5080469948405244,Hawkish
22,20, 주어질/VV,42,1.5972299282931757,Hawkish
10,9, 정률/NNG,19,1.6133635639325008,Hawkish
19,18, 배당가능이익/NNG,37,1.5326953857358758,Hawkish
40,26, 가산금/NNG,66,2.2338880115988475,Hawkish
14,9, 긍정적/VAX;상승/NNG,23,2.258708989505501,Hawkish
12,10, 순이익/NNG;흑자/NNG,22,1.742432649047101,Hawkish
16,11, 매파/NNG;상승/NNG,27,2.1120395746025467,Hawkish
103,86, 템플/NNG,189,1.7390558415877073,Hawkish
11,5, 주택/NNG;호조/NNG,16,3.1944598565863513,Hawkish
13,8, 이탈/NNG;아니/VCN,21,2.359544212251283,Hawkish
33,31, 헐/XSV,64,1.5457063822192025,Hawkish
13,11, 개선/NNG;제한적/VAX,24,1.7160321543645694,Hawkish
15,12, 긍정적/VAX;추세/NNG,27,1.8150340094240633,Hawkish
51,52, 눌렀/VV,103,1.4241036073942652,Hawkish
37,38, 특임/NNG,75,1.4138159652355864,Hawkish
17,14, 경기/NNG;강하/VA,31,1.7631758948690905,Hawkish
21,5, 남북통일/NNG,26,6.098514271664853,Hawkish
43,45, 고정자산/NNG;투자/NNG;증가/NNG,88,1.3874926649819508,Hawkish
18,6, 경제/NNG;불확실성/NNG;증가/NNG,24,4.356081622617753,Hawkish
35,30, 원자재/NNG;수요/NNG;감소/NNG,65,1.694031742129126,Hawkish
14,11, 소비자/NNG;지출/NNG;증가/NNG,25,1.8480346277772284,Hawkish
12,7, 수출/NNG;경기/NNG;부양/NNG,19,2.489189498638716,Hawkish
14,14, 불안/NNG;유가/NNG;하락/NNG,28,1.4520272075392509,Hawkish
12,5, 낮/VA;물가/NNG;우려/NNG,17,3.484865298094202,Hawkish
53,56, 공급/NNG;중단/NNG,109,1.374240035706791,Hawkish
23,22, 순금/NNG,45,1.5180284442455803,Hawkish
20,8, 원유/NNG;공급/NNG;차질/NNG;우려/NNG,28,3.630068018848127,Hawkish
18,11, 경제/NNG;불안/NNG;우려/NNG,29,2.376044521427865,Hawkish
25,22, 원유/NNG;생산/NNG;차질/NNG,47,1.6500309176582397,Hawkish
10,11, 어긋났/VV,21,1.3200247341265916,Hawkish
52,0, 거래금/NNG,52,inf,Hawkish
53,1, 리민/NNG,54,76.9574419995803,Hawkish
10,7, 수출/NNG;환경/NNG;개선/NNG,17,2.07432458219893,Hawkish
20,22, 투자/NNG;약화/NNG,42,1.3200247341265916,Hawkish
18,4, 재강/NNG,22,6.534122433926629,Hawkish
10,8, 소비자/NNG;물가/NNG;상승률/NNG;확대/NNG,18,1.8150340094240636,Hawkish
8,8, 회복/NNG;경제/NNG;성장/NNG,16,1.4520272075392506,Hawkish
36,32, 공급/NNG;차질/NNG;우려/NNG,68,1.6335306084816572,Hawkish
12,7, 수주/NNG;하락/NNG,19,2.489189498638716,Hawkish
10,7, 점차/MAG;매파/NNG,17,2.07432458219893,Hawkish
13,10, 금리/NNG;쉽/VA;오르/VV,23,1.887635369801026,Hawkish
15,12, 내수/NNG;증대/NNG,27,1.8150340094240633,Hawkish
13,13, 외국인/NNG;국채선물/NNG;매도/NNG;약세/NNG,26,1.4520272075392509,Hawkish
11,11, 물가/NNG;전망/NNG;상승/NNG,22,1.4520272075392509,Hawkish
79,48, 감리/NNG,127,2.3897947790750167,Hawkish
29,24, 재벌그룹/NNG,53,1.7545328757765946,Hawkish
31,24, 전망/NNG;작/VA,55,1.8755351430715321,Hawkish
19,14, 인플레이션/NNG;증가/NNG,33,1.9706083530889835,Hawkish
52,43, 유의미/NNG,95,1.7559398788846754,Hawkish
11,8, 하단/NNG;부담/NNG,19,1.9965374103664697,Hawkish
86,4, 금금/NNG,90,31.218584962093892,Hawkish
35,24, 변액연금/NNG,59,2.1175396776614073,Hawkish
35,27, 펀드설정/NNG,62,1.8822574912545844,Hawkish
16,16, 생산/NNG;차질/NNG;우려/NNG,32,1.4520272075392506,Hawkish
14,11, 일시적/VAX;성장/NNG,25,1.8480346277772284,Hawkish
10,11, 지수/NNG;상향/NNG,21,1.3200247341265916,Hawkish
56,50, 지정학/NNG;위험/NNG;확대/NNG,106,1.626270472443961,Hawkish
13,10, 수출/NNG;생산/NNG;부진/NNG,23,1.887635369801026,Hawkish
9,9, 개선/NNG;양호/NNG,18,1.4520272075392509,Hawkish
23,14, 불신임/NNG,37,2.3854732695287693,Hawkish
22,2, 변동계수/NNG,24,15.972299282931758,Hawkish
42,45, 펀더멘털/NNG;좋/VA,87,1.3552253937033008,Hawkish
21,20, 가격/NNG;쉽/VA,41,1.5246285679162133,Hawkish
136,137, 경기평가보고서/NNG,273,1.4414284687980885,Hawkish
14,12, 감춰/VV,26,1.6940317421291258,Hawkish
14,8, 하향/NNG;내리/VV,22,2.541047613193689,Hawkish
11,8, 콘솔/NNG,19,1.9965374103664697,Hawkish
22,23, 중미/NNG,45,1.388895589820153,Hawkish
16,13, 펀더멘털/NNG;강화/NNG,29,1.7871104092790777,Hawkish
24,7, 재무레버리지/NNG,31,4.978378997277432,Hawkish
10,11, 급락/NNG;안전자산/NNG;선호/NNG,21,1.3200247341265916,Hawkish
9,7, 경제/NNG;펀더멘털/NNG;견고/NNG,16,1.866892123979037,Hawkish
149,165, 공휴일/NNG,314,1.3112245692324143,Hawkish
38,42, 경제/NNG;강하/VA;성장/NNG,80,1.3137389020593222,Hawkish
9,9, 국제/NNG;유가/NNG;불확실성/NNG,18,1.4520272075392509,Hawkish
26,19, 수출/NNG;채산성/NNG;악화/NNG,45,1.9869845997905538,Hawkish
15,11, 계절적/VAX;수요/NNG;증가/NNG,26,1.9800371011898874,Hawkish
10,6, 완화/NNG;가능성/NNG;높/VA,16,2.420045345898751,Hawkish
11,12, 영업이익률/NNG;하락/NNG,23,1.331024940244313,Hawkish
16,15, 제조업/NNG;둔화/NNG,31,1.5488290213752007,Hawkish
9,8, 흑자/NNG;확대/NNG,17,1.6335306084816572,Hawkish
31,30, 수출/NNG;차질/NNG,61,1.5004281144572258,Hawkish
26,25, 연소/NNG,51,1.510108295840821,Hawkish
15,12, 물가/NNG;전망/NNG;낮/VA,27,1.8150340094240633,Hawkish
9,9, 내수/NNG;우려/NNG,18,1.4520272075392509,Hawkish
16,9, 웍스/NNG,25,2.5813817022920014,Hawkish
15,12, 전망/NNG;환율/NNG;하락/NNG,27,1.8150340094240633,Hawkish
32,30, 경기/NNG;회복/NNG;둔화/NNG;우려/NNG,62,1.5488290213752007,Hawkish
13,12, 경제/NNG;회복/NNG;기대/NNG;높/VA,25,1.5730294748341882,Hawkish
10,11, 예상/NNG;증가/NNG;상회/NNG,21,1.3200247341265916,Hawkish
17,8, 펀더멘털/NNG;의구심/NNG,25,3.0855578160209083,Hawkish
12,11, 일시적/VAX;금리/NNG;상승/NNG,23,1.58402968095191,Hawkish
9,7, 물가/NNG;상승률/NNG;당분간/MAG;낮/VA,16,1.866892123979037,Hawkish
12,9, 주택건설사업/NNG,21,1.9360362767190011,Hawkish
12,9, 들어와도/VV,21,1.9360362767190011,Hawkish
47,47, 발행/NNG;금리/NNG;낮/VA,94,1.4520272075392509,Hawkish
18,9, 잔업/NNG,27,2.9040544150785017,Hawkish
15,13, 임금/NNG;상승/NNG;물가/NNG;상승/NNG,28,1.6754160086991354,Hawkish
12,11, 인플레이션/NNG;위험/NNG;낮/VA,23,1.58402968095191,Hawkish
23,17, 글로벌/NNG;경기/NNG;호조/NNG,40,1.9645073984354566,Hawkish
18,15, 부진/NNG;물가/NNG;상승/NNG,33,1.742432649047101,Hawkish
27,13, 순상/NNG,40,3.0157488156584438,Hawkish
60,63, 상환자금/NNG,123,1.3828830547992863,Hawkish
18,18, 천사/NNG,36,1.4520272075392509,Hawkish
14,14, 물가/NNG;상승/NNG;일시적/VAX,28,1.4520272075392509,Hawkish
10,7, 회복/NNG;실적/NNG;개선/NNG,17,2.07432458219893,Hawkish
13,12, 하락/NNG;가능성/NNG;크/VV,25,1.5730294748341882,Hawkish
58,63, 실적/NNG;둔화/NNG,121,1.3367869529726435,Hawkish
9,9, 경제효율성/NNG,18,1.4520272075392509,Hawkish
38,20, 캐/NNG,58,2.7588516943245764,Hawkish
57,29, 인질/NNG,86,2.8539845113702516,Hawkish
18,9, 환경평가/NNG,27,2.9040544150785017,Hawkish
12,11, 인상/NNG;경기/NNG;회복/NNG,23,1.58402968095191,Hawkish
31,28, 공급/NNG;부족/NNG;우려/NNG,59,1.6076015512041708,Hawkish
24,19, 글로벌/NNG;지정학/NNG;위험/NNG,43,1.834139630575896,Hawkish
12,13, 부진/NNG;수출/NNG;감소/NNG,25,1.3403328069593086,Hawkish
14,6, 개선/NNG;완화/NNG,20,3.3880634842582515,Hawkish
20,14, 연쇄효과/NNG,34,2.07432458219893,Hawkish
9,9, 민평/NNG;하회/NNG,18,1.4520272075392509,Hawkish
10,11, 슬픈/VA,21,1.3200247341265916,Hawkish
10,11, 번다/VV,21,1.3200247341265916,Hawkish
9,7, 핀잔/NNG,16,1.866892123979037,Hawkish
12,12, 둥/NNG,24,1.4520272075392509,Hawkish
16,6, 서비스업/NNG;회복/NNG,22,3.8720725534380014,Hawkish
9,9, 견조/NNG;확장/NNG,18,1.4520272075392509,Hawkish
13,12, 산업/NNG;확산/NNG,25,1.5730294748341882,Hawkish
18,14, 가격/NNG;우려/NNG,32,1.866892123979037,Hawkish
40,32, 현격히/MAG,72,1.8150340094240636,Hawkish
98,24, 전전/NNG,122,5.9291110974519405,Hawkish
20,15, 임금/NNG;상승률/NNG;정체/NNG,35,1.936036276719001,Hawkish
9,9, 상승률/NNG;저조/NNG,18,1.4520272075392509,Hawkish
9,8, 경제/NNG;전망/NNG;성장률/NNG;전망/NNG;하향/NNG,17,1.6335306084816572,Hawkish
10,10, 인하/NNG;기대/NNG;확산/NNG,20,1.4520272075392509,Hawkish
10,11, 접어든다면/VV,21,1.3200247341265916,Hawkish
13,9, 유렵/NNG,22,2.097372633112251,Hawkish
16,13, 금리/NNG;쉽/VA;오르/VV;못하/VX,29,1.7871104092790777,Hawkish
33,28, 안정/NNG;증가/NNG,61,1.7113177803141169,Hawkish
8,8,로/NNG,16,1.4520272075392506,Hawkish
17,12, 느리/VA;경기/NNG;회복/NNG,29,2.0570385440139387,Hawkish
19,21, 거시정책/NNG;확장/NNG,40,1.3137389020593222,Hawkish
16,14, 종내/MAG,30,1.6594596657591438,Hawkish
8,8, 중소기업/NNG;금융지원/NNG;강화/NNG,16,1.4520272075392506,Hawkish
11,10, 높/VA;선호/NNG,21,1.5972299282931757,Hawkish
16,4, 유로존/NNG;상승/NNG,20,5.8081088301570025,Hawkish
13,10, 비춰졌/VV,23,1.887635369801026,Hawkish
8,8, 금융시장/NNG;부양/NNG,16,1.4520272075392506,Hawkish
15,8, 운전자본/NNG;부담/NNG,23,2.722551014136095,Hawkish
45,15, 남중/NNG,60,4.356081622617752,Hawkish
14,11, 타이머/NNG,25,1.8480346277772284,Hawkish
29,31, 현지생산/NNG,60,1.3583480328592992,Hawkish
8,8, 높/VA;경제/NNG;성장/NNG;둔화/NNG,16,1.4520272075392506,Hawkish
11,10, 대외/NNG;지정학/NNG;위험/NNG,21,1.5972299282931757,Hawkish
10,6, 건설/NNG;기성/NNG;감소/NNG,16,2.420045345898751,Hawkish
49,25, 경기/NNG;판단/NNG;상향/NNG,74,2.845973326776932,Hawkish
13,7, 신규/NNG;수주/NNG;감소/NNG,20,2.6966219568586087,Hawkish
8,8, 경제/NNG;부실/NNG,16,1.4520272075392506,Hawkish
18,9, 티커/NNG,27,2.9040544150785017,Hawkish
12,9, 근원/NNG;인플레이션/NNG;높/VA,21,1.9360362767190011,Hawkish
17,12, 수요/NNG;물가/NNG;압력/NNG,29,2.0570385440139387,Hawkish
12,8, 경기/NNG;회복/NNG;취약/NNG,20,2.1780408113088763,Hawkish
23,13, 락하/NNG,36,2.568971213338674,Hawkish
697,458, 코코본드/NNG,1155,2.2097444621285103,Hawkish
33,25, 지출/NNG;많/VA,58,1.916675913951811,Hawkish
86,96, 유휴노동력/NNG,182,1.3007743734205788,Hawkish
43,39, 가파/NNG,82,1.6009530749791738,Hawkish
22,1, 중위값/NNG,23,31.944598565863515,Hawkish
12,13, 감정가액/NNG,25,1.3403328069593086,Hawkish
20,21, 감가상각비/NNG,41,1.3828830547992865,Hawkish
8,8, 사용가치/NNG,16,1.4520272075392506,Hawkish
14,13, 안전자산/NNG;선호/NNG;증가/NNG,27,1.5637216081191931,Hawkish
8,8, 물가/NNG;상승률/NNG;가격/NNG;하락/NNG;확대/NNG,16,1.4520272075392506,Hawkish
15,15, 경제주체/NNG;심리/NNG;개선/NNG;미흡/NNG,30,1.4520272075392506,Hawkish
14,5, 가격/NNG;오르/VV;못하/VX,19,4.065676181109902,Hawkish
9,7, 채권시장/NNG;타격/NNG,16,1.866892123979037,Hawkish
13,13, 회복/NNG;그치/VV,26,1.4520272075392509,Hawkish
8,8, 전망/NNG;늦/VA,16,1.4520272075392506,Hawkish
24,24, 스펙트럼/NNG,48,1.4520272075392509,Hawkish
11,11, 공급/NNG;개선/NNG,22,1.4520272075392509,Hawkish
16,1, 급정지/NNG,17,23.23243532062801,Hawkish
17,4, 위험/NNG;우려/NNG;크/VV,21,6.171115632041817,Hawkish
43,45, 언제든지/MAG,88,1.3874926649819508,Hawkish
100,105, 경제/NNG;둔화/NNG;우려/NNG,205,1.3828830547992865,Hawkish
76,35, 수주산업/NNG,111,3.1529733649423735,Hawkish
118,69, 모디/NNG,187,2.483176963617849,Hawkish
27,23, 소폭/MAG;완화/NNG,50,1.7045536784156423,Hawkish
60,62, 어느덧/MAG,122,1.405187620199275,Hawkish
31,11, 주주권/NNG,42,4.092076675792434,Hawkish
26,26, 실국/NNG,52,1.4520272075392509,Hawkish
11,12, 종화/NNG,23,1.331024940244313,Hawkish
15,1, 완적/NNG,16,21.78040811308876,Hawkish
15,2, 인리/NNG,17,10.89020405654438,Hawkish
22,6, 신국/NNG,28,5.324099760977252,Hawkish
20,0, 금준/NNG,20,inf,Hawkish
14,5, 산파/NNG,19,4.065676181109902,Hawkish
16,1, 레트/NNG,17,23.23243532062801,Hawkish
13,10, 금제/NNG,23,1.887635369801026,Hawkish
50,0, 향하/NNG,50,inf,Hawkish
9,7, 부본/NNG,16,1.866892123979037,Hawkish
13,10, 라프/NNG,23,1.887635369801026,Hawkish
14,6, 중매/NNG,20,3.3880634842582515,Hawkish
14,3, 철철/MAG,17,6.776126968516503,Hawkish
11,6, 지방/NNG;공공요금/NNG;인상/NNG,17,2.662049880488626,Hawkish
18,15, 소득/NNG;확충/NNG,33,1.742432649047101,Hawkish
21,23, 물가/NNG;높/VV,44,1.325763972101055,Hawkish
13,8, 재무활동/NNG,21,2.359544212251283,Hawkish
17,3, 부정적/VAX;하락/NNG,20,8.228154176055755,Hawkish
10,9, 공업/NNG;제품/NNG;가격/NNG;오름/NNG;둔화/NNG,19,1.6133635639325008,Hawkish
28,17, 총영사관/NNG,45,2.3915742241822953,Hawkish
15,7, 부진/NNG;유가/NNG;하락/NNG,22,3.1114868732983947,Hawkish
28,24, 시시각각/MAG,52,1.6940317421291258,Hawkish
12,5, 대출/NNG;예금/NNG;금리/NNG;인상/NNG,17,3.484865298094202,Hawkish
9,8, 절하/NNG;효과/NNG,17,1.6335306084816572,Hawkish
22,0, 채공/NNG,22,inf,Hawkish
19,21, 환하/VA,40,1.3137389020593222,Hawkish
97,96, 매각이익/NNG,193,1.467152490951118,Hawkish
47,34, 겸업/NNG,81,2.0072140810101406,Hawkish
53,49, 한도규제/NNG,102,1.5705600408077611,Hawkish
10,8, 완만/NNG;속도/NNG;확대/NNG,18,1.8150340094240636,Hawkish
11,11, 경기/NNG;불확실성/NNG;확대/NNG,22,1.4520272075392509,Hawkish
12,11, 소비/NNG;여력/NNG;감소/NNG,23,1.58402968095191,Hawkish
9,8, 금융위기/NNG;마이너스/NNG,17,1.6335306084816572,Hawkish
10,10, 부진/NNG;위험/NNG,20,1.4520272075392509,Hawkish
12,6, 개선/NNG;낮/VA,18,2.9040544150785017,Hawkish
79,39, 캡티브/NNG,118,2.9412858819384824,Hawkish
22,7, 저하/NNG;추세/NNG,29,4.5635140808376455,Hawkish
28,30, 선현/NNG,58,1.3552253937033008,Hawkish
12,5, 척수/NNG,17,3.484865298094202,Hawkish
9,8, 원가/NNG;낮/VV,17,1.6335306084816572,Hawkish
14,11, 가치주투자/NNG,25,1.8480346277772284,Hawkish
10,7, 중전/NNG,17,2.07432458219893,Hawkish
14,10, 판자촌/NNG,24,2.032838090554951,Hawkish
19,8, 부동산/NNG;둔화/NNG;우려/NNG,27,3.448564617905721,Hawkish
19,21, 둔화/NNG;금리/NNG;인상/NNG,40,1.3137389020593222,Hawkish
9,9, 고물가/NNG;고금리/NNG,18,1.4520272075392509,Hawkish
13,8, 도도/NNG,21,2.359544212251283,Hawkish
28,26, 파급시차/NNG,54,1.5637216081191931,Hawkish
12,6, 인플레이션/NNG;압력/NNG;높/VA;금리/NNG;인상/NNG,18,2.9040544150785017,Hawkish
42,39, 소비자/NNG;물가/NNG;상승률/NNG;높/VA,81,1.5637216081191931,Hawkish
13,5, 물가/NNG;상승률/NNG;개선/NNG,18,3.775270739602052,Hawkish
17,13, 생산/NNG;비용/NNG;증가/NNG,30,1.8988048098590204,Hawkish
17,8, 다르/VA;금리/NNG;인상/NNG,25,3.0855578160209083,Hawkish
44,37, 고임금/NNG,81,1.726735057614244,Hawkish
28,30, 무늬/NNG,58,1.3552253937033008,Hawkish
72,79, 플레이션/NNG,151,1.3233665688965326,Hawkish
36,37, 설비/NNG;투자/NNG;회복/NNG,73,1.412783228957109,Hawkish
28,22, 선제/NNG;금리/NNG;오르/VV,50,1.8480346277772284,Hawkish
13,11, 소다/NNG,24,1.7160321543645694,Hawkish
91,68, 안녕/NNG,159,1.9431540571481147,Hawkish
87,92, 시추/NNG,179,1.3731126853903783,Hawkish
12,7, 사발/NNG,19,2.489189498638716,Hawkish
22,23, 수없이/MAG,45,1.388895589820153,Hawkish
22,0, 업명/NNG,22,inf,Hawkish
51,39, 명명/NNG,90,1.8988048098590202,Hawkish
18,11, 제품포트폴리오/NNG,29,2.376044521427865,Hawkish
60,51, 장성/NNG,111,1.7082673029873536,Hawkish
34,17, 특집/NNG,51,2.9040544150785017,Hawkish
14,12, 운송비/NNG,26,1.6940317421291258,Hawkish
26,16, 회사채/NNG;수익률/NNG;떨어/VV,42,2.359544212251283,Hawkish
13,12, 구매력/NNG;증대/NNG,25,1.5730294748341882,Hawkish
32,32, 수익성/NNG;향상/NNG,64,1.4520272075392506,Hawkish
12,6, 우려/NNG;최대/NNG,18,2.9040544150785017,Hawkish
54,43, 마진/NNG;축소/NNG,97,1.8234760280725475,Hawkish
14,8, 바닥/NNG;잡/VV,22,2.541047613193689,Hawkish
12,8, 무화/NNG,20,2.1780408113088763,Hawkish
121,107, 매제/NNG,228,1.6420120758154144,Hawkish
13,14, 글로벌/NNG;저성장/NNG;우려/NNG,27,1.3483109784293044,Hawkish
200,174, 공모채/NNG,374,1.668996790275001,Hawkish
12,13, 치뤄진/VV,25,1.3403328069593086,Hawkish
10,8, 자금/NNG;유출/NNG;우려/NNG;완화/NNG,18,1.8150340094240636,Hawkish
42,5, 합/MAG,47,12.197028543329706,Hawkish
68,41, 상호금융사/NNG,109,2.408240246650465,Hawkish
12,9, 위험/NNG;선호/NNG;개선/NNG,21,1.9360362767190011,Hawkish
19,20, 각의/NNG,39,1.3794258471622882,Hawkish
31,27, 가공무역/NNG,58,1.6671423493969175,Hawkish
14,4, 구족/NNG,18,5.082095226387378,Hawkish
39,30, 농수산/NNG,69,1.887635369801026,Hawkish
13,9, 맛볼/VV,22,2.097372633112251,Hawkish
25,9, 도이치/NNG,34,4.033408909831253,Hawkish
51,41, 후구퉁/NNG,92,1.8061801849878487,Hawkish
13,13, 수뢰/NNG,26,1.4520272075392509,Hawkish
13,13, 초고령사회/NNG,26,1.4520272075392509,Hawkish
35,25, 소득재분배/NNG,60,2.0328380905549515,Hawkish
26,17, 양로/NNG,43,2.22074749388356,Hawkish
10,7, 노동/NNG;생산성/NNG;하락/NNG,17,2.07432458219893,Hawkish
52,53, 경제/NNG;성장/NNG;견인/NNG,105,1.4246304677743593,Hawkish
16,12, 서비스업/NNG;확대/NNG,28,1.9360362767190007,Hawkish
29,27, 서비스업/NNG;성장/NNG,56,1.559584778468084,Hawkish
74,16, 시무식/NNG,90,6.715625834869035,Hawkish
19,20, 보약/NNG,39,1.3794258471622882,Hawkish
18,17, 구조개혁/NNG;경제/NNG;활성화/NNG,35,1.5374405726886184,Hawkish
16,8, 경제/NNG;회복/NNG;우려/NNG,24,2.9040544150785013,Hawkish
16,7, 치뤄/VV,23,3.3189193315182877,Hawkish
14,10, 두루두루/MAG,24,2.032838090554951,Hawkish
21,5, 가가/NNG,26,6.098514271664853,Hawkish
48,52, 총액인수/NNG,100,1.3403328069593086,Hawkish
36,40, 상거래/NNG,76,1.3068244867853258,Hawkish
25,5, 평민/NNG,30,7.260136037696254,Hawkish
27,13, 비협/NNG,40,3.0157488156584438,Hawkish
28,12, 약채/NNG,40,3.3880634842582515,Hawkish
31,25, 낮/VA;물가/NNG;상승/NNG,56,1.8005137373486713,Hawkish
31,27, 변동성/NNG;증대/NNG,58,1.6671423493969175,Hawkish
11,6, 바쁠/VA,17,2.662049880488626,Hawkish
16,15, 유가/NNG;하락/NNG;긍정적/VAX,31,1.5488290213752007,Hawkish
11,11, 대외/NNG;변동성/NNG;확대/NNG,22,1.4520272075392509,Hawkish
11,8, 미/NNG;금리/NNG;인상/NNG;경계/NNG,19,1.9965374103664697,Hawkish
20,11, 매파/NNG;없/VA,31,2.640049468253183,Hawkish
33,31, 중산/NNG,64,1.5457063822192025,Hawkish
21,21, 컬러/NNG,42,1.4520272075392509,Hawkish
14,2, 고/XSV,16,10.164190452774756,Hawkish
15,10, 전비/NNG,25,2.178040811308876,Hawkish
20,21, 신사/NNG,41,1.3828830547992865,Hawkish
20,20, 라가/NNG,40,1.4520272075392509,Hawkish
63,67, 기업수/NNG,130,1.3653390160443701,Hawkish
24,17, 직인/NNG,41,2.0499207635848244,Hawkish
11,8, 반부/NNG,19,1.9965374103664697,Hawkish
75,81, 둔/NNG,156,1.3444696366104174,Hawkish
28,29, 비일비재/NNG,57,1.4019573038310007,Hawkish
43,43, 동산/NNG,86,1.4520272075392506,Hawkish
13,9, 증이/NNG,22,2.097372633112251,Hawkish
20,20, 걸음마/NNG,40,1.4520272075392509,Hawkish
87,72, 자본력/NNG,159,1.7545328757765946,Hawkish
59,61, 중위/NNG,120,1.4044197581117344,Hawkish
19,19, 초상/NNG,38,1.4520272075392509,Hawkish
23,20, 연체금액/NNG,43,1.6698312886701383,Hawkish
14,14, 요강/NNG,28,1.4520272075392509,Hawkish
18,10, 가격/NNG;억제/NNG,28,2.6136489735706516,Hawkish
13,12, 거의/MAG;성장/NNG,25,1.5730294748341882,Hawkish
22,0, 과과/NNG,22,inf,Hawkish
16,17, 쟁/NNG,33,1.3666138423898828,Hawkish
15,8, 카프/NNG,23,2.722551014136095,Hawkish
9,8, 괴/NNG,17,1.6335306084816572,Hawkish
10,7, 붕/NNG,17,2.07432458219893,Hawkish
12,11, 위험자산/NNG;하락/NNG,23,1.58402968095191,Hawkish
18,6, 상승률/NNG;아니/VCN,24,4.356081622617753,Hawkish
13,9, 견실/NNG;회복/NNG,22,2.097372633112251,Hawkish
19,16, 황급히/MAG,35,1.7242823089528605,Hawkish
21,15, 부채가구/NNG,36,2.032838090554951,Hawkish
102,105, 쏘/VV,207,1.410540715895272,Hawkish
26,0, 시시시/NNG,26,inf,Hawkish
12,5, 둔화/NNG;우려/NNG;높/VV,17,3.484865298094202,Hawkish
15,11, 인플레이션/NNG;개선/NNG,26,1.9800371011898874,Hawkish
16,0, 발행희망금액/NNG,16,inf,Hawkish
30,6, 경전/NNG,36,7.260136037696253,Hawkish
12,6, 일변/NNG,18,2.9040544150785017,Hawkish
15,3, 사신/NNG,18,7.260136037696253,Hawkish
110,29, 캘린더/NNG,139,5.507689407907503,Hawkish
23,25, 영아/NNG,48,1.3358650309361106,Hawkish
13,6, 영일/NNG,19,3.1460589496683764,Hawkish
11,5, 남아/NNG,16,3.1944598565863513,Hawkish
38,6, 코코/NNG,44,9.196172314415255,Hawkish
75,80, 대수/NNG,155,1.3612755070680476,Hawkish
29,28, 상품명/NNG,57,1.503885322094224,Hawkish
31,0, 화화/NNG,31,inf,Hawkish
19,21, 매크로/NNG;위험/NNG,40,1.3137389020593222,Hawkish
17,11, 안정/NNG;하락/NNG,28,2.244042048015206,Hawkish
15,15, 동향점검회의/NNG,30,1.4520272075392506,Hawkish
67,5, 정월/NNG,72,19.457164581025957,Hawkish
44,46, 브리티시/NNG,90,1.388895589820153,Hawkish
40,33, 재형/NNG,73,1.7600329788354554,Hawkish
94,18, 상위등급/NNG,112,7.582808750482753,Hawkish
10,11, 금리/NNG;인상/NNG;전망/NNG;완화/NNG,21,1.3200247341265916,Hawkish
17,12, 기업/NNG;신용등급/NNG;하락/NNG,29,2.0570385440139387,Hawkish
17,7, 원가/NNG;하락/NNG,24,3.526351789738181,Hawkish
13,7, 소분/NNG,20,2.6966219568586087,Hawkish
20,6, 탁신/NNG,26,4.840090691797502,Hawkish
18,14, 베인/VV,32,1.866892123979037,Hawkish
40,43, 긴축정책/NNG;완화/NNG,83,1.3507229837574426,Hawkish
21,7, 개선/NNG;제약/NNG,28,4.356081622617753,Hawkish
38,39, 부진/NNG;상쇄/NNG,77,1.41479574067927,Hawkish
60,9, 아/NNG,69,9.680181383595004,Hawkish
28,19, 인하/NNG;최저/NNG,47,2.1398295690052116,Hawkish
10,11, 가교프로그램/NNG,21,1.3200247341265916,Hawkish
25,19, 금리/NNG;인상/NNG;가능성/NNG;상승/NNG,44,1.9105621151832248,Hawkish
20,17, 낙관론/NNG;약화/NNG,37,1.7082673029873539,Hawkish
23,13, 전화위복/NNG,36,2.568971213338674,Hawkish
9,7, 양호/NNG;추세/NNG,16,1.866892123979037,Hawkish
39,38, 상장종목/NNG,77,1.4902384498429153,Hawkish
15,16, 했어도/VV,31,1.3612755070680476,Hawkish
13,12, 당해/NNG,25,1.5730294748341882,Hawkish
17,18, 강구퉁/NNG,35,1.3713590293426259,Hawkish
18,14, 상해지수/NNG,32,1.866892123979037,Hawkish
11,6, 임금/NNG;상승률/NNG;호조/NNG,17,2.662049880488626,Hawkish
9,9, 살상/NNG,18,1.4520272075392509,Hawkish
12,8, 채권/NNG;수요/NNG;감소/NNG,20,2.1780408113088763,Hawkish
12,11, 견고/NNG;경제/NNG;성장/NNG,23,1.58402968095191,Hawkish
17,8, 안정성/NNG;낮/VA,25,3.0855578160209083,Hawkish
166,158, 종업원/NNG,324,1.525547572477947,Hawkish
14,9, 준설/NNG,23,2.258708989505501,Hawkish
19,19, 판매업/NNG,38,1.4520272075392509,Hawkish
55,49, 일렉트로닉스/NNG,104,1.6298264574420163,Hawkish
9,9, 라오/NNG,18,1.4520272075392509,Hawkish
66,59, 운송업/NNG,125,1.6243016219930602,Hawkish
77,58, 공개매수/NNG,135,1.9276912927676262,Hawkish
21,9, 지분출자/NNG,30,3.3880634842582515,Hawkish
20,6, 다트/NNG,26,4.840090691797502,Hawkish
18,7, 비유동자산/NNG,25,3.733784247958074,Hawkish
19,8, 매입채무/NNG,27,3.448564617905721,Hawkish
16,6, 차손/NNG,22,3.8720725534380014,Hawkish
16,13, 일렉트로닉/NNG,29,1.7871104092790777,Hawkish
14,12, 유로존/NNG;미약/NNG;개선/NNG,26,1.6940317421291258,Hawkish
12,6, 채무재조정/NNG;불확실성/NNG,18,2.9040544150785017,Hawkish
12,10, 우려/NNG;일시적/VAX,22,1.742432649047101,Hawkish
12,9, 부동산/NNG;경기/NNG;둔화/NNG;우려/NNG,21,1.9360362767190011,Hawkish
68,64, 글로벌/NNG;유동성/NNG;축소/NNG,132,1.5427789080104541,Hawkish
16,11, 유가/NNG;상승/NNG;하락/NNG,27,2.1120395746025467,Hawkish
14,3, 산업분석/NNG,17,6.776126968516503,Hawkish
9,10, 공공요금/NNG;안정/NNG,19,1.3068244867853258,Hawkish
14,13, 물가/NNG;상승률/NNG;잡/VV,27,1.5637216081191931,Hawkish
12,10, 유로존/NNG;완만/NNG;개선/NNG,22,1.742432649047101,Hawkish
66,1, 단판/MAG,67,95.83379569759055,Hawkish
13,12, 완화/NNG;않/VX,25,1.5730294748341882,Hawkish
13,14, 부진/NNG;부담/NNG,27,1.3483109784293044,Hawkish
19,8, 이채/NNG,27,3.448564617905721,Hawkish
31,0, 현현/NNG,31,inf,Hawkish
15,1, 도유/NNG,16,21.78040811308876,Hawkish
21,19, 물가/NNG;상승률/NNG;저유가/NNG;영향/NNG;낮/VA,40,1.604872176753909,Hawkish
30,28, 유로존/NNG;개선/NNG,58,1.5557434366491973,Hawkish
18,19, 소비/NNG;여력/NNG;줄/VV,37,1.375604722931922,Hawkish
37,35, 무리수/NNG,72,1.5350001908272082,Hawkish
10,10, 문업/NNG,20,1.4520272075392509,Hawkish
18,18, 국제/NNG;금융시장/NNG;변동성/NNG;증대/NNG,36,1.4520272075392509,Hawkish
30,21, 민자발전/NNG,51,2.07432458219893,Hawkish
10,7, 드러난다면/VV,17,2.07432458219893,Hawkish
52,45, 긴축정책/NNG;우려/NNG,97,1.677898106489801,Hawkish
18,0, 상향/NNG;등급/NNG;하향/NNG,18,inf,Hawkish
12,13, 개선/NNG;높/VA,25,1.3403328069593086,Hawkish
18,10, 단기/NNG;충격/NNG;그치/VV,28,2.6136489735706516,Hawkish
23,17, 화주/NNG,40,1.9645073984354566,Hawkish
9,7, 금리/NNG;결정/NNG;금리/NNG;인하/NNG,16,1.866892123979037,Hawkish
10,7, 영업이익/NNG;하락/NNG,17,2.07432458219893,Hawkish
11,11, 매입/NNG;부담/NNG,22,1.4520272075392509,Hawkish
54,33, 미/NNG;금리/NNG;인상/NNG;우려/NNG,87,2.3760445214278647,Hawkish
16,14, 글로벌/NNG;채권시장/NNG;약세/NNG,30,1.6594596657591438,Hawkish
18,16, 유럽연합집행위원회/NNG,34,1.6335306084816572,Hawkish
37,40,목/NNG,77,1.343125166973807,Hawkish
148,83, 입법화/NNG,231,2.5891569483832426,Hawkish
22,23, 유동성/NNG;제한/NNG,45,1.388895589820153,Hawkish
9,10, 이국/NNG,19,1.3068244867853258,Hawkish
15,15, 신흥국/NNG;부도/NNG;위험/NNG,30,1.4520272075392506,Hawkish
40,44, 발전사/NNG,84,1.3200247341265916,Hawkish
21,7, 재무/NNG;부담/NNG;확대/NNG,28,4.356081622617753,Hawkish
17,15, 안전자산/NNG;매수/NNG;상승/NNG,32,1.645630835211151,Hawkish
17,11, 대출장/NNG,28,2.244042048015206,Hawkish
14,11, 주조/NNG,25,1.8480346277772284,Hawkish
10,11, 유동성/NNG;공급/NNG;중단/NNG,21,1.3200247341265916,Hawkish
10,10, 긴축안/NNG;반대/NNG,20,1.4520272075392509,Hawkish
53,38, 빼앗기/VV,91,2.0251958420942184,Hawkish
8,8, 하단/NNG;하락/NNG,16,1.4520272075392506,Hawkish
18,13, 유선방송/NNG,31,2.010499210438963,Hawkish
39,33, 성숙기/NNG,72,1.7160321543645691,Hawkish
19,14, 유료방송/NNG,33,1.9706083530889835,Hawkish
9,10, 디지털방송/NNG,19,1.3068244867853258,Hawkish
42,44, 손상차손/NNG,86,1.3860259708329212,Hawkish
18,7, 판매비/NNG,25,3.733784247958074,Hawkish
32,14, 일반관리비/NNG,46,3.3189193315182877,Hawkish
51,35, 영업외수익/NNG,86,2.1158110738429086,Hawkish
18,0, 총자산회전율/NNG,18,inf,Hawkish
8,8, 매출구조/NNG,16,1.4520272075392506,Hawkish
21,23, 고급화/NNG,44,1.325763972101055,Hawkish
79,82, 키스/NNG,161,1.3989042609219613,Hawkish
22,15, 실용주의/NNG,37,2.129639904390901,Hawkish
9,8, 정리지/NNG,17,1.6335306084816572,Hawkish
33,29, 국내선/NNG,62,1.6523068223722508,Hawkish
15,2, 미/NNG;금리/NNG;인상/NNG;우려/NNG;완화/NNG,17,10.89020405654438,Hawkish
15,12, 기업/NNG;이익/NNG;전망/NNG;하향/NNG,27,1.8150340094240633,Hawkish
31,27, 미/NNG;금리/NNG;인상/NNG;지연/NNG,58,1.6671423493969175,Hawkish
9,10, 안전자산/NNG;선호/NNG;낮/VA,19,1.3068244867853258,Hawkish
12,9, 통화정책/NNG;종료/NNG,21,1.9360362767190011,Hawkish
15,13, 경제/NNG;부작용/NNG,28,1.6754160086991354,Hawkish
10,10, 투자/NNG;하락/NNG,20,1.4520272075392509,Hawkish
20,17, 유산스/NNG,37,1.7082673029873539,Hawkish
9,7, 장류/NNG,16,1.866892123979037,Hawkish
20,9, 유통사업/NNG,29,3.2267271278650016,Hawkish
38,14, 경쟁강도/NNG,52,3.941216706177967,Hawkish
15,14, 도매상/NNG,29,1.5557434366491973,Hawkish
25,25, 사모발행/NNG,50,1.4520272075392509,Hawkish
27,30, 간접금융/NNG,57,1.3068244867853256,Hawkish
16,14, 국판/NNG,30,1.6594596657591438,Hawkish
17,13, 자산/NNG;건전성/NNG;저하/NNG,30,1.8988048098590204,Hawkish
20,13, 업황/NNG;우려/NNG,33,2.2338880115988475,Hawkish
65,67, 셰/NNG,132,1.4086831117918104,Hawkish
98,101, 뱅크론/NNG,199,1.4088976865232334,Hawkish
10,6, 개선/NNG;임금/NNG;상승/NNG,16,2.420045345898751,Hawkish
13,6, 만의/NNG,19,3.1460589496683764,Hawkish
50,55, 혼인/NNG,105,1.3200247341265916,Hawkish
13,5, 선국/NNG,18,3.775270739602052,Hawkish
24,20, 베/VV,44,1.742432649047101,Hawkish
26,22, 경제/NNG;전망/NNG;하방/NNG;위험/NNG,48,1.7160321543645694,Hawkish
11,9, 경제활동참가율/NNG;높/VA,20,1.774699920325751,Hawkish
15,16, 노동력/NNG;감소/NNG,31,1.3612755070680476,Hawkish
12,7, 기업구조조정전문회사/NNG,19,2.489189498638716,Hawkish
11,9, 하락/NNG;경기/NNG;부진/NNG,20,1.774699920325751,Hawkish
22,9, 양적질적완화/NNG,31,3.549399840651502,Hawkish
78,74, 자연실업률/NNG,152,1.5305151647035347,Hawkish
23,12, 경기민감도/NNG,35,2.7830521477835637,Hawkish
20,17, 국제/NNG;유가/NNG;원자재/NNG;가격/NNG;하락/NNG,37,1.7082673029873539,Hawkish
31,34, 기업/NNG;실적/NNG;실망/NNG,65,1.3239071598151992,Hawkish
65,69, 물가/NNG;오르/VV;않/VX,134,1.36785171724712,Hawkish
22,14, 몬순/NNG,36,2.2817570404188228,Hawkish
100,104, 난/NNG,204,1.3961800072492796,Hawkish
21,23, 수개/NNG,44,1.325763972101055,Hawkish
22,23, 차남/NNG,45,1.388895589820153,Hawkish
19,9, 날갯짓/NNG,28,3.0653907714717517,Hawkish
31,31, 유가/NNG;공급/NNG;과잉/NNG;우려/NNG,62,1.452027207539251,Hawkish
68,69, 경제/NNG;강하/VA,137,1.4309833349662182,Hawkish
19,17, 모디노믹스/NNG,36,1.622853937837986,Hawkish
20,10, 강우량/NNG,30,2.9040544150785017,Hawkish
56,58, 엎친/VV,114,1.4019573038310007,Hawkish
14,12, 관리변동환율제도/NNG,26,1.6940317421291258,Hawkish
9,8, 국고금/NNG,17,1.6335306084816572,Hawkish
14,8, 금융시장/NNG;변동성/NNG;증대/NNG;신흥국/NNG;성장/NNG,22,2.541047613193689,Hawkish
14,8, 변동성/NNG;증대/NNG;신흥국/NNG;성장/NNG;약화/NNG,22,2.541047613193689,Hawkish
14,8, 경기/NNG;둔화/NNG;우려/NNG;확대/NNG,22,2.541047613193689,Hawkish
9,9, 단기/NNG;부동자금/NNG;증가/NNG,18,1.4520272075392509,Hawkish
9,7, 원자재/NNG;가격/NNG;하락/NNG;경기/NNG;둔화/NNG,16,1.866892123979037,Hawkish
16,15, 기업/NNG;실적/NNG;전망/NNG;상향/NNG,31,1.5488290213752007,Hawkish
16,12, 이탈/NNG;추세/NNG,28,1.9360362767190007,Hawkish
133,0, 전병/NNG,133,inf,Hawkish
40,44, 내딛/VV,84,1.3200247341265916,Hawkish
71,75, 강수량/NNG,146,1.3745857564704909,Hawkish
18,11, 노동가능인구/NNG,29,2.376044521427865,Hawkish
11,8, 강우/NNG,19,1.9965374103664697,Hawkish
81,81, 추징/NNG,162,1.4520272075392509,Hawkish
60,64, 기상청/NNG,124,1.3612755070680476,Hawkish
16,13, 라질/NNG,29,1.7871104092790777,Hawkish
16,15, 짧아졌/VV,31,1.5488290213752007,Hawkish
12,10, 금리/NNG;인상/NNG;위안/NNG;절하/NNG,22,1.742432649047101,Hawkish
10,8, 신흥시장/NNG;하락/NNG,18,1.8150340094240636,Hawkish
15,6, 수익성/NNG;안정/NNG,21,3.6300680188481267,Hawkish
26,14, 정책/NNG;지연/NNG,40,2.6966219568586087,Hawkish
23,25, 투자/NNG;부정적/VAX,48,1.3358650309361106,Hawkish
57,47, 불안/NNG;금리/NNG;인상/NNG,104,1.7609691665901552,Hawkish
273,64, 시니어론/NNG,337,6.193803557159617,Hawkish
39,43, 금리/NNG;인상/NNG;경기/NNG;둔화/NNG;우려/NNG,82,1.3169549091635064,Hawkish
38,33, 발개위/NNG,71,1.6720313298936829,Hawkish
182,38, 하위등급/NNG,220,6.954446099266938,Hawkish
15,11, 엠피/NNG,26,1.9800371011898874,Hawkish
10,10, 도입계획/NNG,20,1.4520272075392509,Hawkish
9,9, 충분/NNG;외화/NNG;유동성/NNG;확보/NNG,18,1.4520272075392509,Hawkish
48,53, 절하/NNG;우려/NNG,101,1.3150435087147934,Hawkish
14,12,시니어론/NNG,26,1.6940317421291258,Hawkish
60,16, 플로어/NNG,76,5.44510202827219,Hawkish
13,4, 기업/NNG;투자/NNG;호조/NNG,17,4.719088424502566,Hawkish
17,17, 액면금액/NNG,34,1.4520272075392509,Hawkish
72,57, 선순위채권/NNG,129,1.8341396305758957,Hawkish
64,2, 미달액/NNG,66,46.46487064125602,Hawkish
35,38, 수익구조/NNG;개선/NNG,73,1.3373934806282575,Hawkish
34,5, 절하/NNG;충격/NNG,39,9.873785011266905,Hawkish
13,10, 인플레이션/NNG;하방/NNG;압력/NNG,23,1.887635369801026,Hawkish
28,29, 조국/NNG,57,1.4019573038310007,Hawkish
61,63, 원자재/NNG;가격/NNG;약세/NNG,124,1.405931105712608,Hawkish
13,3, 긴축/NNG;불확실성/NNG,16,6.292117899336753,Hawkish
23,17, 유동성/NNG;거품/NNG,40,1.9645073984354566,Hawkish
15,9, 힘내/VV,24,2.420045345898751,Hawkish
44,18, 절하/NNG;금리/NNG;인상/NNG,62,3.549399840651502,Hawkish
15,7, 선선/NNG,22,3.1114868732983947,Hawkish
49,6, 국신/NNG,55,11.858222194903881,Hawkish
10,7, 채권/NNG;우려/NNG,17,2.07432458219893,Hawkish
56,54, 지수/NNG;금리/NNG;인상/NNG,110,1.5058059930036674,Hawkish
392,350, 금리/NNG;인상/NNG;중단/NNG,742,1.626270472443961,Hawkish
19,13, 부채/NNG;상환능력/NNG;취약/NNG,32,2.122193611018905,Hawkish
11,9, 웃돈다는/VV,20,1.774699920325751,Hawkish
40,35, 태어나/VV,75,1.6594596657591438,Hawkish
15,13, 설레/VV,28,1.6754160086991354,Hawkish
19,11, 자본가/NNG,30,2.5080469948405244,Hawkish
8,8, 추경/NNG;늘/VV,16,1.4520272075392506,Hawkish
35,25, 예상/NNG;나쁘/VA,60,2.0328380905549515,Hawkish
35,1, 월화/NNG,36,50.820952263873785,Hawkish
105,4, 목금/NNG,109,38.11571419790533,Hawkish
20,16, 대외/NNG;경제/NNG;여건/NNG;비추/VV;성장/NNG,36,1.8150340094240636,Hawkish
11,10, 경기/NNG;완만/NNG;상승/NNG,21,1.5972299282931757,Hawkish
108,103, 칼럼니스트/NNG,211,1.5225139651867874,Hawkish
23,21, 끌어왔/VV,44,1.5903155130191793,Hawkish
12,5, 기업/NNG;부채/NNG;상환/NNG;부담/NNG,17,3.484865298094202,Hawkish
11,9, 외채/NNG;상환/NNG;부담/NNG,20,1.774699920325751,Hawkish
11,10, 부채/NNG;부담/NNG;높/VA,21,1.5972299282931757,Hawkish
18,17, 디폴트/NNG;증가/NNG,35,1.5374405726886184,Hawkish
10,6, 외채/NNG;급증/NNG,16,2.420045345898751,Hawkish
11,8, 최대/NNG;넘/VV;않/VX,19,1.9965374103664697,Hawkish
17,4, 터주/NNG,21,6.171115632041817,Hawkish
23,25, 전망/NNG;안정/NNG;부정적/VAX;하향/NNG,48,1.3358650309361106,Hawkish
58,38, 흥통/NNG,96,2.2162520536125405,Hawkish
36,6, 화환/NNG,42,8.712163245235505,Hawkish
15,2, 물가/NNG;안정/NNG;금리/NNG;인상/NNG,17,10.89020405654438,Hawkish
10,7, 지수/NNG;단기/NNG;상승/NNG,17,2.07432458219893,Hawkish
48,46, 채권시장/NNG;혼조/NNG,94,1.5151588252583488,Hawkish
12,7, 금융시장/NNG;약세/NNG,19,2.489189498638716,Hawkish
19,13, 금융시장/NNG;강세/NNG,32,2.122193611018905,Hawkish
104,114, 사채권자/NNG,218,1.324656399860369,Hawkish
39,37, 기한이익상실/NNG,76,1.5305151647035347,Hawkish
47,46, 나타냈었/VV,93,1.4835930163987996,Hawkish
16,16, 질권설정/NNG,32,1.4520272075392506,Hawkish
12,13, 수위권/NNG,25,1.3403328069593086,Hawkish
61,45, 한글/NNG,106,1.9683035479976512,Hawkish
12,11, 경기/NNG;둔화/NNG;심각/NNG,23,1.58402968095191,Hawkish
13,11, 금리/NNG;점차/MAG;오르/VV,24,1.7160321543645694,Hawkish
34,33, 심각/NNG;위험/NNG,67,1.4960280320101373,Hawkish
12,5, 채권/NNG;금리/NNG;인상/NNG;우려/NNG,17,3.484865298094202,Hawkish
22,19, 금리/NNG;인상/NNG;우려/NNG;높/VA,41,1.6812946613612378,Hawkish
12,5, 채권펀드/NNG;금리/NNG;인상/NNG,17,3.484865298094202,Hawkish
100,97, 다이버/NNG,197,1.4969352655043824,Hawkish
55,51, 뱅커/NNG,106,1.5659116944050742,Hawkish
52,55, 외환시장/NNG;금리/NNG;인상/NNG,107,1.3728257234916554,Hawkish
37,11, 충당금적립전/NNG,48,4.8840915162683896,Hawkish
23,7, 투자심리/NNG;저하/NNG,30,4.7709465390575385,Hawkish
24,26, 환경/NNG;안정/NNG,50,1.3403328069593086,Hawkish
24,22, 참여의사/NNG,46,1.58402968095191,Hawkish
195,210, 개인연금/NNG,405,1.3483109784293041,Hawkish
28,30, 부채기업/NNG,58,1.3552253937033008,Hawkish
70,78, 유암/NNG,148,1.3031013400993277,Hawkish
24,26, 치킨/VV,50,1.3403328069593086,Hawkish
93,80, 좀비기업/NNG,173,1.687981628764379,Hawkish
23,9,수쿠크/NNG,32,3.710736197044752,Hawkish
70,77, 수쿠크/NNG,147,1.3200247341265916,Hawkish
10,10, 상향/NNG;위험/NNG,20,1.4520272075392509,Hawkish
41,30, 국고채/NNG;수익률/NNG;상승/NNG,71,1.984437183636976,Hawkish
9,8, 노르/VA,17,1.6335306084816572,Hawkish
19,19, 띤다/VV,38,1.4520272075392509,Hawkish
12,12, 자본/NNG;유출/NNG;우려/NNG;완화/NNG,24,1.4520272075392509,Hawkish
11,10, 부진/NNG;fed/NNG;금리/NNG;오르/VV,21,1.5972299282931757,Hawkish
29,28, 우려/NNG;유가/NNG;하락/NNG,57,1.503885322094224,Hawkish
15,5, 부진/NNG;인상/NNG,20,4.356081622617752,Hawkish
31,33, 빛나/VV,64,1.364025558597478,Hawkish
10,7, 해외/NNG;투자/NNG;비중/NNG;확대/NNG,17,2.07432458219893,Hawkish
11,5, 환위험/NNG;제거/NNG,16,3.1944598565863513,Hawkish
14,9, 임금/NNG;상승/NNG;억제/NNG,23,2.258708989505501,Hawkish
619,639, 탄핵/NNG,1258,1.4065803465834057,Hawkish
10,7, 유고/NNG,17,2.07432458219893,Hawkish
11,10, 자산/NNG;비중/NNG;확대/NNG,21,1.5972299282931757,Hawkish
24,0, 지지지지/MAG,24,inf,Hawkish
9,8, 전망/NNG;국제/NNG;유가/NNG;하락/NNG,17,1.6335306084816572,Hawkish
10,9, 대외/NNG;경제/NNG;불안/NNG,19,1.6133635639325008,Hawkish
10,11, 가계/NNG;부채/NNG;상승/NNG,21,1.3200247341265916,Hawkish
67,45, 채권/NNG;매입/NNG;확대/NNG,112,2.161907175669551,Hawkish
70,77, 시납/NNG,147,1.3200247341265916,Hawkish
35,37, 외화증권투자/NNG,72,1.373539250374967,Hawkish
30,16, 시가평가제도/NNG,46,2.722551014136095,Hawkish
12,12, 지급여력금액/NNG,24,1.4520272075392509,Hawkish
13,7, 미상/NNG,20,2.6966219568586087,Hawkish
10,7, 원가기준/NNG,17,2.07432458219893,Hawkish
14,6, 금리/NNG;인상/NNG;지연/NNG;기대/NNG;상승/NNG,20,3.3880634842582515,Hawkish
14,2, 금리/NNG;위험/NNG;신용위험/NNG,16,10.164190452774756,Hawkish
10,10, 신흥국/NNG;신용위험/NNG,20,1.4520272075392509,Hawkish
32,21, 과열/NNG;해소/NNG,53,2.212612887678858,Hawkish
180,178, 물가/NNG;부진/NNG,358,1.4683421199835118,Hawkish
12,5, 중위수/NNG,17,3.484865298094202,Hawkish
12,10, 자화상/NNG,22,1.742432649047101,Hawkish
27,26, 완납/NNG,53,1.5078744078292219,Hawkish
33,31, 위로금/NNG,64,1.5457063822192025,Hawkish
20,1, 행목/NNG,21,29.040544150785017,Hawkish
9,9, 원화/NNG;금리/NNG;인상/NNG,18,1.4520272075392509,Hawkish
21,9, 부도율/NNG;상승/NNG,30,3.3880634842582515,Hawkish
46,48, 인프라펀드/NNG,94,1.3915260738917818,Hawkish
23,15, 샤오캉/NNG,38,2.2264417182268508,Hawkish
18,12, 굴/NNG,30,2.1780408113088763,Hawkish
42,37, 말기/NNG,79,1.6482471004499601,Hawkish
11,9, 퀘/NNG,20,1.774699920325751,Hawkish
11,7, 되도록/MAG,18,2.2817570404188228,Hawkish
12,12, 코커스/NNG,24,1.4520272075392509,Hawkish
80,54, 부통령/NNG,134,2.1511514185766676,Hawkish
9,8, 중심주의/NNG,17,1.6335306084816572,Hawkish
144,147, 난민/NNG,291,1.4223939992221233,Hawkish
20,21, 억눌러/VV,41,1.3828830547992865,Hawkish
50,49, 이자부/NNG,99,1.4816604158563784,Hawkish
47,47, 창당/NNG,94,1.4520272075392509,Hawkish
37,23, 규획/NNG,60,2.335869855606621,Hawkish
20,19, 법원장/NNG,39,1.5284496921465798,Hawkish
33,34, 엔지니어/NNG,67,1.4093205249645666,Hawkish
27,22, 성장통/NNG,49,1.7820333910708988,Hawkish
13,10, 결정력/NNG,23,1.887635369801026,Hawkish
12,12, 지안/NNG,24,1.4520272075392509,Hawkish
53,43, 스몰캡/NNG,96,1.7897079534786113,Hawkish
11,12, 부동산/NNG;거품/NNG;붕괴/NNG;우려/NNG,23,1.331024940244313,Hawkish
10,11, 원화/NNG;강세/NNG;지지/NNG,21,1.3200247341265916,Hawkish
11,9, 기대/NNG;금리/NNG;오르/VV,20,1.774699920325751,Hawkish
13,7, 외환시장/NNG;강세/NNG,20,2.6966219568586087,Hawkish
19,17, 매우/MAG;매파/NNG,36,1.622853937837986,Hawkish
52,55, 재정/NNG;부양/NNG,107,1.3728257234916554,Hawkish
9,10, 견고/NNG;증가/NNG,19,1.3068244867853258,Hawkish
15,12, 퇴설/NNG,27,1.8150340094240633,Hawkish
34,19, 쿠르드/NNG,53,2.598364476649186,Hawkish
12,8, 득/MAG,20,2.1780408113088763,Hawkish
10,10, 수출/NNG;감소/NNG;축소/NNG,20,1.4520272075392509,Hawkish
49,49, 정치/NNG;안정/NNG,98,1.4520272075392509,Hawkish
10,7, 환경/NNG;높/VA,17,2.07432458219893,Hawkish
34,1, 대각선/NNG,35,49.36892505633453,Hawkish
40,34, 기준율/NNG,74,1.7082673029873539,Hawkish
8,8, 거시/NNG;건전성/NNG;정책/NNG;강화/NNG,16,1.4520272075392506,Hawkish
30,18, 세미/NNG,48,2.420045345898751,Hawkish
26,24, 해지율/NNG,50,1.5730294748341882,Hawkish
25,17, 산부/NNG,42,2.1353341287341925,Hawkish
14,12, 도소/NNG,26,1.6940317421291258,Hawkish
21,0, 화토/NNG,21,inf,Hawkish
56,35, 투자풀/NNG,91,2.323243532062801,Hawkish
18,12, 수출/NNG;가격/NNG;경쟁력/NNG;약화/NNG,30,2.1780408113088763,Hawkish
14,10, 건설/NNG;경기/NNG;호조/NNG,24,2.032838090554951,Hawkish
11,5, 서비스업/NNG;위축/NNG,16,3.1944598565863513,Hawkish
25,26, 수익성/NNG;둔화/NNG,51,1.3961800072492796,Hawkish
14,12, 손실/NNG;상쇄/NNG,26,1.6940317421291258,Hawkish
9,9, 동원력/NNG,18,1.4520272075392509,Hawkish
34,30, 국가외환관리국/NNG,64,1.645630835211151,Hawkish
19,18, 소비/NNG;좋/VA,37,1.5326953857358758,Hawkish
89,93, 주가조작/NNG,182,1.389574424419283,Hawkish
11,12, 키스톤/NNG,23,1.331024940244313,Hawkish
44,14, 명목채/NNG,58,4.5635140808376455,Hawkish
165,71, 미지급/NNG,236,3.374429425971498,Hawkish
11,10, 정치/NNG;위험/NNG;완화/NNG,21,1.5972299282931757,Hawkish
733,812, 리츠/NNG,1545,1.310758550648117,Hawkish
12,6, 약/VA,18,2.9040544150785017,Hawkish
11,5, 유보이익/NNG,16,3.1944598565863513,Hawkish
17,8, 지급가능/NNG,25,3.0855578160209083,Hawkish
11,8, 하이일드/NNG;가격/NNG;하락/NNG,19,1.9965374103664697,Hawkish
26,15, 중후장대/NNG,41,2.5168471597347013,Hawkish
14,4, 가치사슬/NNG,18,5.082095226387378,Hawkish
13,5, 상위그룹/NNG,18,3.775270739602052,Hawkish
14,3, 벌거벗/VV,17,6.776126968516503,Hawkish
55,54, 빼들/VV,109,1.478916600271459,Hawkish
15,11, 경기/NNG;개선/NNG;긍정적/VAX,26,1.9800371011898874,Hawkish
23,22, 시노/NNG,45,1.5180284442455803,Hawkish
11,12, fed/NNG;금리/NNG;인상/NNG;가능성/NNG;확대/NNG,23,1.331024940244313,Hawkish
81,72, 아메리칸/NNG,153,1.6335306084816572,Hawkish
17,11, 애도/NNG,28,2.244042048015206,Hawkish
46,0, 수수수/MAG,46,inf,Hawkish
13,8, 지정학/NNG;위험/NNG;금리/NNG;인상/NNG,21,2.359544212251283,Hawkish
16,14, 당해/XSV,30,1.6594596657591438,Hawkish
11,6, 위계/NNG,17,2.662049880488626,Hawkish
48,50, 거액자산가/NNG,98,1.393946119237681,Hawkish
170,177, 거둬들이/VV,347,1.3946024027213144,Hawkish
13,11, 던져졌/VV,24,1.7160321543645694,Hawkish
12,13, 용두사미/NNG,25,1.3403328069593086,Hawkish
14,14, 때늦/VA,28,1.4520272075392509,Hawkish
9,7, 조선/NNG,16,1.866892123979037,Hawkish
11,12, 근래/MAG,23,1.331024940244313,Hawkish
36,24, 수출구조/NNG,60,2.1780408113088763,Hawkish
13,9, 재수출/NNG,22,2.097372633112251,Hawkish
38,35, 궁금해하/VV,73,1.5764866824711867,Hawkish
12,7, 저가형/NNG,19,2.489189498638716,Hawkish
22,17, 협동/NNG,39,1.879094033286089,Hawkish
10,10, 진다는/VV,20,1.4520272075392509,Hawkish
25,23, 기업연금/NNG,48,1.5782904429774465,Hawkish
15,10, 한적/NNG,25,2.178040811308876,Hawkish
79,52, 전략팀/NNG,131,2.205964411453862,Hawkish
20,1, 인상/NNG;금리/NNG;인상/NNG;금리/NNG;인상/NNG,21,29.040544150785017,Hawkish
21,23, 느리/VA;속도/NNG;금리/NNG;인상/NNG,44,1.325763972101055,Hawkish
10,8, 채권/NNG;금리/NNG;변동성/NNG;크/VV,18,1.8150340094240636,Hawkish
35,37, 부동산/NNG;금리/NNG;인상/NNG,72,1.373539250374967,Hawkish
12,9, 인플레이션/NNG;위험/NNG;없/VA,21,1.9360362767190011,Hawkish
19,12, 기업/NNG;실적/NNG;상승/NNG,31,2.299043078603814,Hawkish
22,24, 금리/NNG;인상/NNG;최대/NNG,46,1.331024940244313,Hawkish
19,13, 투자/NNG;금리/NNG;인상/NNG,32,2.122193611018905,Hawkish
10,7, 제한적/VAX;상승/NNG;그치/VV,17,2.07432458219893,Hawkish
24,23, 기업/NNG;부채/NNG;부담/NNG,47,1.5151588252583488,Hawkish
11,6, 금리/NNG;인상/NNG;강세/NNG,17,2.662049880488626,Hawkish
36,37, 금리/NNG;인상/NNG;멈추/VV,73,1.412783228957109,Hawkish
10,9, 긴축/NNG;속도/NNG;늦/VV,19,1.6133635639325008,Hawkish
11,9, 금융시스템/NNG;충격/NNG,20,1.774699920325751,Hawkish
16,13, 구조조정/NNG;압력/NNG,29,1.7871104092790777,Hawkish
18,19, 통화정책/NNG;제약/NNG,37,1.375604722931922,Hawkish
20,22, 신흥시장/NNG;상승/NNG,42,1.3200247341265916,Hawkish
18,10, 영업이익/NNG;급감/NNG,28,2.6136489735706516,Hawkish
34,18, 자산시장/NNG;과열/NNG,52,2.7427180586852518,Hawkish
33,27, 제조업/NNG;성장/NNG,60,1.7746999203257507,Hawkish
13,6, 가동률/NNG;떨어/VV,19,3.1460589496683764,Hawkish
11,12, 불안정성/NNG;높/VA,23,1.331024940244313,Hawkish
19,16, 성장/NNG;억제/NNG,35,1.7242823089528605,Hawkish
12,10, 수출/NNG;안정/NNG,22,1.742432649047101,Hawkish
15,15, 의구심/NNG;많/VA,30,1.4520272075392506,Hawkish
14,10, 합계출산율/NNG,24,2.032838090554951,Hawkish
14,6, 안위/NNG,20,3.3880634842582515,Hawkish
17,10, 한차례/NNG,27,2.4684462528167264,Hawkish
25,23, 물가/NNG;상승/NNG;압력/NNG;높/VA;않/VX,48,1.5782904429774465,Hawkish
16,0, 크레딧/NNG;투자심리/NNG;저하/NNG,16,inf,Hawkish
18,12, 채권투자/NNG;비중/NNG;줄/VV,30,2.1780408113088763,Hawkish
18,17, 금리/NNG;충분히/MAG;낮/VA,35,1.5374405726886184,Hawkish
19,4, 상확/NNG,23,6.897129235811442,Hawkish
12,13, 물가/NNG;상승/NNG;기대/NNG;높/VA,25,1.3403328069593086,Hawkish
18,17, 소비자/NNG;물가/NNG;호조/NNG,35,1.5374405726886184,Hawkish
13,6, 금리/NNG;인상/NNG;인플레이션/NNG;압력/NNG,19,3.1460589496683764,Hawkish
15,10, 금중/NNG,25,2.178040811308876,Hawkish
11,7, 통화/NNG;완화/NNG;확대/NNG,18,2.2817570404188228,Hawkish
11,10, 부진/NNG;넘/VV,21,1.5972299282931757,Hawkish
11,6, 급인/NNG,17,2.662049880488626,Hawkish
24,14, 회사채/NNG;수익률/NNG;상승/NNG,38,2.489189498638716,Hawkish
30,30, 회사채/NNG;수익률/NNG;하락/NNG,60,1.4520272075392506,Hawkish
10,10, 금리/NNG;인하/NNG;낮/VA,20,1.4520272075392509,Hawkish
14,2, 통화정책/NNG;자제/NNG,16,10.164190452774756,Hawkish
21,22, 물가/NNG;개선/NNG,43,1.3860259708329212,Hawkish
30,33, 순대외채권/NNG,63,1.3200247341265916,Hawkish
12,9, 단기/NNG;외채/NNG;줄/VV,21,1.9360362767190011,Hawkish
141,123, 로드쇼/NNG,264,1.6645189940084093,Hawkish
9,9, 경기/NNG;둔화/NNG;수출/NNG;부진/NNG,18,1.4520272075392509,Hawkish
30,29, 청원/NNG,59,1.5020971112475008,Hawkish
29,7, 경기/NNG;둔화/NNG;금리/NNG;인상/NNG;우려/NNG,36,6.015541288376896,Hawkish
16,13, 금융시장/NNG;주가/NNG;상승/NNG,29,1.7871104092790777,Hawkish
141,151, 책임준비금/NNG,292,1.3558664653181083,Hawkish
14,13, 애착/NNG,27,1.5637216081191931,Hawkish
39,30, 풍족/NNG,69,1.887635369801026,Hawkish
31,24, 사업경쟁력/NNG,55,1.8755351430715321,Hawkish
16,12, 안정성/NNG;떨어/VV,28,1.9360362767190007,Hawkish
14,9, 요일/NNG,23,2.258708989505501,Hawkish
9,7, 물길/NNG,16,1.866892123979037,Hawkish
33,31, 빅스/NNG,64,1.5457063822192025,Hawkish
17,18, 전망/NNG;후퇴/NNG,35,1.3713590293426259,Hawkish
17,13,틀/NNG,30,1.8988048098590204,Hawkish
30,30, 봄날/NNG,60,1.4520272075392506,Hawkish
16,12, 일목/NNG,28,1.9360362767190007,Hawkish
11,10, 물가/NNG;예상/NNG;오르/VV,21,1.5972299282931757,Hawkish
57,51, 세계/NNG;금리/NNG;인상/NNG,108,1.622853937837986,Hawkish
11,9, 됐었으나/XSV,20,1.774699920325751,Hawkish
28,31, 갈증/NNG,59,1.3115084455193233,Hawkish
11,5, 전망/NNG;소폭/MAG;개선/NNG,16,3.1944598565863513,Hawkish
14,8, 신용등급/NNG;등급/NNG;전망/NNG;안정/NNG,22,2.541047613193689,Hawkish
23,18, 급상/NNG,41,1.855368098522376,Hawkish
26,10, 하향수/NNG,36,3.775270739602052,Hawkish
41,40, 분식/NNG,81,1.488327887727732,Hawkish
13,7, 급락/NNG;추세/NNG,20,2.6966219568586087,Hawkish
34,30, 붙일/VV,64,1.645630835211151,Hawkish
12,12, 가져간다는/VV,24,1.4520272075392509,Hawkish
11,7, 도가/NNG,18,2.2817570404188228,Hawkish
17,11, fed/NNG;금리/NNG;인상/NNG;가속/NNG,28,2.244042048015206,Hawkish
37,23, 금리/NNG;인상/NNG;근거/NNG;강화/NNG,60,2.335869855606621,Hawkish
21,20, 소비자/NNG;물가/NNG;넘/VV,41,1.5246285679162133,Hawkish
30,24, 우려/NNG;오르/VV,54,1.8150340094240633,Hawkish
20,17, 중심가/NNG,37,1.7082673029873539,Hawkish
29,24, 옛말/NNG,53,1.7545328757765946,Hawkish
12,6, 채권시장/NNG;불확실성/NNG;해소/NNG,18,2.9040544150785017,Hawkish
16,15, 예상/NNG;금리/NNG;오르/VV,31,1.5488290213752007,Hawkish
11,8, 채권/NNG;거래/NNG;줄/VV,19,1.9965374103664697,Hawkish
17,13, 광산기업/NNG,30,1.8988048098590204,Hawkish
66,5, 수소탄/NNG,71,19.166759139518106,Hawkish
14,14, 유가/NNG;상품/NNG;가격/NNG;하락/NNG,28,1.4520272075392509,Hawkish
131,80, 서킷브레이커/NNG,211,2.377694552345523,Hawkish
15,6, 제한해제/NNG,21,3.6300680188481267,Hawkish
12,5, 휴전선/NNG,17,3.484865298094202,Hawkish
37,25, 폭격기/NNG,62,2.1490002671580912,Hawkish
48,53, 일주일/NNG,101,1.3150435087147934,Hawkish
21,19, 유가/NNG;저점/NNG,40,1.604872176753909,Hawkish
37,37, 튼튼히/MAG,74,1.4520272075392509,Hawkish
10,11, 전망/NNG;혼조/NNG,21,1.3200247341265916,Hawkish
13,13, 금융시장/NNG;불확실성/NNG;높/VA,26,1.4520272075392509,Hawkish
15,15, 탄성/NNG,30,1.4520272075392506,Hawkish
17,17, 연주/NNG,34,1.4520272075392509,Hawkish
22,0, 전망/NNG;하향/NNG;전망/NNG;하향/NNG,22,inf,Hawkish
13,13, 주식인수/NNG,26,1.4520272075392509,Hawkish
10,11, 재무/NNG;안정/NNG,21,1.3200247341265916,Hawkish
16,6, 불안/NNG;국제/NNG;유가/NNG;급락/NNG,22,3.8720725534380014,Hawkish
33,27, 통화정책/NNG;물가/NNG;안정/NNG,60,1.7746999203257507,Hawkish
9,7, 팍/MAG,16,1.866892123979037,Hawkish
19,17, 조인트벤처/NNG,36,1.622853937837986,Hawkish
10,10, 재정/NNG;쏟/VV,20,1.4520272075392509,Hawkish
60,44, 상한액/NNG,104,1.9800371011898874,Hawkish
12,12, 윗목/NNG,24,1.4520272075392509,Hawkish
10,7, 가격/NNG;급락/NNG;우려/NNG,17,2.07432458219893,Hawkish
31,30, 급락/NNG;최저/NNG,61,1.5004281144572258,Hawkish
36,40, 마음가짐/NNG,76,1.3068244867853258,Hawkish
11,11, 기대수익/NNG;높/VA,22,1.4520272075392509,Hawkish
14,4, 부도기업/NNG,18,5.082095226387378,Hawkish
61,64, 이자/NNG;부담/NNG;늘/VV,125,1.3839634321858485,Hawkish
17,17, 약하/VA;우려/NNG,34,1.4520272075392509,Hawkish
16,7, 물가/NNG;상승/NNG;압력/NNG;금리/NNG;인상/NNG,23,3.3189193315182877,Hawkish
8,8, 인플레이션/NNG;예상/NNG;낮/VA,16,1.4520272075392506,Hawkish
64,38, 견실/NNG;성장/NNG,102,2.4455195074345277,Hawkish
39,31, 이익조정비율/NNG,70,1.8267439062590576,Hawkish
9,8, 둔화/NNG;타격/NNG,17,1.6335306084816572,Hawkish
10,8, 확실/NNG;금리/NNG;인상/NNG,18,1.8150340094240636,Hawkish
17,10, 유가/NNG;불확실성/NNG,27,2.4684462528167264,Hawkish
13,10, 광동/NNG,23,1.887635369801026,Hawkish
10,10, 인상/NNG;배제/NNG,20,1.4520272075392509,Hawkish
36,40, 연체율/NNG;하락/NNG,76,1.3068244867853258,Hawkish
31,8, 초장/NNG,39,5.626605429214597,Hawkish
10,7, 물가/NNG;하락/NNG;일시적/VAX,17,2.07432458219893,Hawkish
8,8, 오링/NNG,16,1.4520272075392506,Hawkish
27,28, 크레인/NNG,55,1.4001690929842776,Hawkish
10,10, 기대/NNG;매우/MAG;낮/VA,20,1.4520272075392509,Hawkish
24,8, 구조조정/NNG;우려/NNG,32,4.356081622617753,Hawkish
34,0, 민평/NNG;하단/NNG,34,inf,Hawkish
9,8, 달러인덱스/NNG;소폭/MAG;상승/NNG,17,1.6335306084816572,Hawkish
36,24, 현정/NNG,60,2.1780408113088763,Hawkish
16,4, 상하위/NNG,20,5.8081088301570025,Hawkish
17,17, 신규설정/NNG,34,1.4520272075392509,Hawkish
9,10, 대외/NNG;여건/NNG;좋/VA;않/VX,19,1.3068244867853258,Hawkish
9,8, 불안/NNG;부정적/VAX,17,1.6335306084816572,Hawkish
12,8, 수요/NNG;낮/VV,20,2.1780408113088763,Hawkish
17,16, 자본/NNG;통제/NNG;강화/NNG,33,1.5427789080104541,Hawkish
32,33, 베일인/NNG,65,1.4080263830683644,Hawkish
11,9, 은행/NNG;수익성/NNG;저하/NNG,20,1.774699920325751,Hawkish
14,11, 대외교역/NNG,25,1.8480346277772284,Hawkish
12,13, 독립국가연합/NNG,25,1.3403328069593086,Hawkish
10,10, 대용량/NNG,20,1.4520272075392509,Hawkish
18,17, 글로벌/NNG;경제/NNG;성장/NNG;둔화/NNG;우려/NNG,35,1.5374405726886184,Hawkish
13,9, 금리/NNG;역전폭/NNG;확대/NNG,22,2.097372633112251,Hawkish
26,17, 낮/VA;인상/NNG,43,2.22074749388356,Hawkish
14,15, 요구액/NNG,29,1.3552253937033008,Hawkish
16,6, 투자심리/NNG;양호/NNG,22,3.8720725534380014,Hawkish
10,9, 핵미사일/NNG,19,1.6133635639325008,Hawkish
25,26, 불매/NNG,51,1.3961800072492796,Hawkish
22,24, 금리/NNG;인상/NNG;전망/NNG;확산/NNG,46,1.331024940244313,Hawkish
22,20, 재정/NNG;악화/NNG;우려/NNG,42,1.5972299282931757,Hawkish
16,13, 금리/NNG;인상/NNG;낮/VA,29,1.7871104092790777,Hawkish
11,10, 정책/NNG;의구심/NNG,21,1.5972299282931757,Hawkish
16,17, 타우/NNG,33,1.3666138423898828,Hawkish
16,16, 정안/NNG,32,1.4520272075392506,Hawkish
10,11, 보호제/NNG,21,1.3200247341265916,Hawkish
17,16, 회생계획/NNG,33,1.5427789080104541,Hawkish
15,2, 가교은행/NNG,17,10.89020405654438,Hawkish
14,14, 정리기/NNG,28,1.4520272075392509,Hawkish
30,27, 우려/NNG;부담/NNG,57,1.6133635639325008,Hawkish
11,10, 자산/NNG;최대/NNG,21,1.5972299282931757,Hawkish
20,17, 세인/NNG,37,1.7082673029873539,Hawkish
18,13,템플/NNG,31,2.010499210438963,Hawkish
23,22, 매도의견/NNG,45,1.5180284442455803,Hawkish
21,14, 세이프가드/NNG,35,2.1780408113088763,Hawkish
10,8, 시스템/NNG;불안/NNG,18,1.8150340094240636,Hawkish
10,9, 누이/NNG,19,1.6133635639325008,Hawkish
29,24, 전환가격/NNG,53,1.7545328757765946,Hawkish
16,7, 전환비율/NNG,23,3.3189193315182877,Hawkish
10,9, 약정수익률/NNG,19,1.6133635639325008,Hawkish
16,17, 산업규제/NNG,33,1.3666138423898828,Hawkish
10,9, 금리/NNG;인하/NNG;가능성/NNG;축소/NNG,19,1.6133635639325008,Hawkish
68,73, 관심종목/NNG,141,1.3525732892146447,Hawkish
16,13, 증권예탁결제원/NNG,29,1.7871104092790777,Hawkish
18,20, 비상장기업/NNG,38,1.3068244867853258,Hawkish
19,14, 행사일/NNG,33,1.9706083530889835,Hawkish
20,9, 기대/NNG;억제/NNG,29,3.2267271278650016,Hawkish
10,7, 경제통화위원회/NNG,17,2.07432458219893,Hawkish
12,12, 엠바고/NNG,24,1.4520272075392509,Hawkish
24,23, 유가/NNG;산유국/NNG;감산/NNG,47,1.5151588252583488,Hawkish
78,85, 비즈니스모델/NNG,163,1.3324484963301362,Hawkish
45,25, 은행지주회사/NNG,70,2.6136489735706516,Hawkish
17,18, 영업자/NNG,35,1.3713590293426259,Hawkish
8,8, 여도/NNG,16,1.4520272075392506,Hawkish
23,25, 금리/NNG;인하/NNG;걸림돌/NNG,48,1.3358650309361106,Hawkish
48,48, 카플란/NNG,96,1.4520272075392509,Hawkish
18,17, 랴오닝/NNG,35,1.5374405726886184,Hawkish
14,2, 화수/NNG,16,10.164190452774756,Hawkish
55,51, 백워데이션/NNG,106,1.5659116944050742,Hawkish
17,18, 특정일/NNG,35,1.3713590293426259,Hawkish
12,13, 에지/NNG,25,1.3403328069593086,Hawkish
31,20, 코리아펀드/NNG,51,2.250642171685839,Hawkish
9,7, 투자/NNG;그치/VV,16,1.866892123979037,Hawkish
23,23, 신탁업/NNG,46,1.4520272075392506,Hawkish
38,21, 경제/NNG;성장률/NNG;호조/NNG,59,2.6274778041186444,Hawkish
9,8, 피로/NNG;해소/NNG,17,1.6335306084816572,Hawkish
49,27, 주주사/NNG,76,2.6351604877564183,Hawkish
14,5, 세인트/NNG,19,4.065676181109902,Hawkish
23,11, 유안/NNG,34,3.0360568884911605,Hawkish
41,39, 투자/NNG;수요/NNG;확보/NNG,80,1.5264901412592125,Hawkish
9,7, 제조업/NNG;약화/NNG,16,1.866892123979037,Hawkish
13,5, 최상급/NNG,18,3.775270739602052,Hawkish
13,13, 마이너스/NNG;줄/VV,26,1.4520272075392509,Hawkish
33,32, 인접국/NNG,65,1.4974030577748523,Hawkish
8,8, 메르코수르/NNG,16,1.4520272075392506,Hawkish
12,7, 영업보고서/NNG,19,2.489189498638716,Hawkish
10,9, 미분양/NNG;위험/NNG,19,1.6133635639325008,Hawkish
19,19, 풍선/NNG,38,1.4520272075392509,Hawkish
22,22, 최대/NNG;인상/NNG,44,1.4520272075392509,Hawkish
29,25, 인상/NNG;줄/VV,54,1.684351560745531,Hawkish
71,41, 단일시장/NNG,112,2.514486139885044,Hawkish
9,8, 대금업/NNG,17,1.6335306084816572,Hawkish
21,15, 신드롬/NNG,36,2.032838090554951,Hawkish
12,11, 입국자수/NNG,23,1.58402968095191,Hawkish
26,12, 스타트업기업/NNG,38,3.1460589496683764,Hawkish
35,35, 산학/NNG,70,1.4520272075392509,Hawkish
14,6, 총투자율/NNG,20,3.3880634842582515,Hawkish
23,23, 소고기/NNG,46,1.4520272075392506,Hawkish
52,52, 타이트한/VA,104,1.4520272075392509,Hawkish
29,19, 영업외비용/NNG,48,2.2162520536125405,Hawkish
47,51, 충당금전입액/NNG,98,1.338142720673427,Hawkish
58,61, 전략적제휴/NNG,119,1.3806160333979762,Hawkish
45,46, 신용보험/NNG,91,1.4204613986797017,Hawkish
60,64, 재보험/NNG,124,1.3612755070680476,Hawkish
69,65, 주택담보대출/NNG;금리/NNG;인상/NNG,134,1.5413827280032049,Hawkish
63,60, 경기/NNG;경착륙/NNG,123,1.5246285679162133,Hawkish
11,5, 건전성/NNG;향상/NNG,16,3.1944598565863513,Hawkish
10,11, 감춰진/VV,21,1.3200247341265916,Hawkish
16,8, 금리/NNG;인상/NNG;낮/VV,24,2.9040544150785013,Hawkish
17,17, 뜸했/VA,34,1.4520272075392509,Hawkish
10,6, 연체율/NNG;소폭/MAG;상승/NNG,16,2.420045345898751,Hawkish
12,7, 졸/NNG,19,2.489189498638716,Hawkish
16,13, 전심/NNG,29,1.7871104092790777,Hawkish
10,9, 경제/NNG;금리/NNG;인상/NNG;지지/NNG,19,1.6133635639325008,Hawkish
23,16, 곧이곧대로/MAG,39,2.087289110837673,Hawkish
17,17, 불어온/VV,34,1.4520272075392509,Hawkish
25,21, 수출/NNG;진작/NNG,46,1.7286038184991082,Hawkish
71,59, 트렌치/NNG,130,1.747354775174353,Hawkish
53,52, 입주업체/NNG,105,1.4799508076842365,Hawkish
28,21, 안타/NNG,49,1.9360362767190011,Hawkish
34,28, 전속/NNG,62,1.7631758948690905,Hawkish
15,1, 투자/NNG;수요/NNG;개선/NNG,16,21.78040811308876,Hawkish
21,0, 상향/NNG;전망/NNG;상향/NNG,21,inf,Hawkish
17,6, 상향/NNG;가능성/NNG;높/VA,23,4.114077088027877,Hawkish
26,23, 공산주의/NNG,49,1.6414220606965444,Hawkish
9,9, 주택/NNG;수요/NNG;위축/NNG,18,1.4520272075392509,Hawkish
9,10, 달러인덱스/NNG;급락/NNG,19,1.3068244867853258,Hawkish
16,14, 매출/NNG;둔화/NNG,30,1.6594596657591438,Hawkish
21,0, 물경/MAG,21,inf,Hawkish
20,18, 결손금/NNG,38,1.6133635639325008,Hawkish
20,18, 네일/NNG,38,1.6133635639325008,Hawkish
18,9, 문전/NNG,27,2.9040544150785017,Hawkish
16,15, 대임/NNG,31,1.5488290213752007,Hawkish
12,6, 초과생산/NNG,18,2.9040544150785017,Hawkish
16,14, 실험실/NNG,30,1.6594596657591438,Hawkish
17,13, 채워진/VV,30,1.8988048098590204,Hawkish
13,9, 주원/NNG,22,2.097372633112251,Hawkish
12,10, 가격/NNG;상승/NNG;우호적/VAX,22,1.742432649047101,Hawkish
10,8, 수요/NNG;점차/MAG;늘/VV,18,1.8150340094240636,Hawkish
11,5, 발행/NNG;힘들/VA,16,3.1944598565863513,Hawkish
9,7, 침체/NNG;피하/VV,16,1.866892123979037,Hawkish
32,34, 여력/NNG;높/VV,66,1.3666138423898828,Hawkish
32,20, 양키본드/NNG,52,2.323243532062801,Hawkish
30,31, 투자/NNG;환경/NNG;개선/NNG,61,1.405187620199275,Hawkish
11,12, 호조/NNG;견인/NNG,23,1.331024940244313,Hawkish
47,49, 대손준비금/NNG,96,1.3927607909049955,Hawkish
10,11, 활성화/NNG;걸림돌/NNG,21,1.3200247341265916,Hawkish
28,27, 열린다는/VV,55,1.5058059930036674,Hawkish
32,23, fed/NNG;금리/NNG;인상/NNG;가능성/NNG;약화/NNG,55,2.0202117670111313,Hawkish
10,11, 둔화/NNG;완화/NNG,21,1.3200247341265916,Hawkish
9,7, 기대/NNG;흔들/VV,16,1.866892123979037,Hawkish
13,11, 까다로워진/VA,24,1.7160321543645694,Hawkish
9,8, 금리/NNG;부담/NNG;경감/NNG,17,1.6335306084816572,Hawkish
24,13, 진보당/NNG,37,2.680665613918617,Hawkish
14,7, 재정/NNG;적자/NNG;악화/NNG,21,2.9040544150785017,Hawkish
56,60, 야대/NNG,116,1.3552253937033008,Hawkish
25,27, 심사숙고/NNG,52,1.3444696366104174,Hawkish
11,10, 다자개발은행/NNG,21,1.5972299282931757,Hawkish
21,15, 원구/NNG,36,2.032838090554951,Hawkish
10,9,위아래/NNG,19,1.6133635639325008,Hawkish
10,8, 결시/NNG,18,1.8150340094240636,Hawkish
48,45, 무혐/NNG,93,1.548829021375201,Hawkish
22,17, 보국/NNG,39,1.879094033286089,Hawkish
91,96, 부동산/NNG;둔화/NNG,187,1.3764007904799147,Hawkish
13,3, 기실/MAG,16,6.292117899336753,Hawkish
22,15, 메꾸/VV,37,2.129639904390901,Hawkish
10,7, 덩/NNG,17,2.07432458219893,Hawkish
14,8, 개선/NNG;실적/NNG;개선/NNG,22,2.541047613193689,Hawkish
16,15, 쇠락/NNG,31,1.5488290213752007,Hawkish
10,7, 무한책임/NNG,17,2.07432458219893,Hawkish
25,12, 누적액/NNG,37,3.025056682373439,Hawkish
13,10, 산업/NNG;안정/NNG,23,1.887635369801026,Hawkish
12,10, 따진다면/VV,22,1.742432649047101,Hawkish
14,8, 운용리스/NNG,22,2.541047613193689,Hawkish
10,6, 호조/NNG;실적/NNG;개선/NNG,16,2.420045345898751,Hawkish
25,25, 재무구조/NNG;취약/NNG,50,1.4520272075392509,Hawkish
20,7, 상국/NNG,27,4.14864916439786,Hawkish
44,40, 대출/NNG;조건/NNG;강화/NNG,84,1.5972299282931757,Hawkish
27,23, 변해야/VV,50,1.7045536784156423,Hawkish
10,10, 공식적/VAX;경기/NNG;침체/NNG,20,1.4520272075392509,Hawkish
54,49, 자동화/NNG,103,1.6001932491248887,Hawkish
33,34, 하트/NNG,67,1.4093205249645666,Hawkish
22,17, 소비재기업/NNG,39,1.879094033286089,Hawkish
32,14, 종사자수/NNG,46,3.3189193315182877,Hawkish
11,7, 공법/NNG,18,2.2817570404188228,Hawkish
55,47, 전문화/NNG,102,1.6991807747799743,Hawkish
17,8, 옮김/VV,25,3.0855578160209083,Hawkish
14,14, 우기/NNG,28,1.4520272075392509,Hawkish
15,4, 유망섹터/NNG,19,5.44510202827219,Hawkish
20,20, 영업마진/NNG,40,1.4520272075392509,Hawkish
9,8, 채권회수율/NNG,17,1.6335306084816572,Hawkish
12,5, 구슬/NNG,17,3.484865298094202,Hawkish
26,27, 꿰/VV,53,1.3982484220748341,Hawkish
12,5, 보배/NNG,17,3.484865298094202,Hawkish
13,3, 스모그/NNG,16,6.292117899336753,Hawkish
19,14, 기술진보/NNG,33,1.9706083530889835,Hawkish
49,43, 기업/NNG;실적/NNG;모멘텀/NNG,92,1.6546356551028671,Hawkish
10,11, 실적/NNG;모멘텀/NNG;약화/NNG,21,1.3200247341265916,Hawkish
71,70, 소비/NNG;지출/NNG;둔화/NNG,141,1.4727704533612402,Hawkish
21,10, 투자등급/NNG;하향/NNG,31,3.0492571358324265,Hawkish
10,6, 통화정책/NNG;확대/NNG,16,2.420045345898751,Hawkish
31,25, 경제/NNG;감속/NNG,56,1.8005137373486713,Hawkish
42,36, 지수/NNG;회복/NNG,78,1.6940317421291258,Hawkish
9,8, 소비/NNG;자제/NNG,17,1.6335306084816572,Hawkish
13,4, 성장성/NNG;낮/VA,17,4.719088424502566,Hawkish
38,27, 유가/NNG;높/VA,65,2.0435938476478346,Hawkish
16,15, 승세/NNG,31,1.5488290213752007,Hawkish
10,10, 가격/NNG;상승/NNG;긍정적/VAX,20,1.4520272075392509,Hawkish
11,9, 소비/NNG;심리/NNG;호조/NNG,20,1.774699920325751,Hawkish
19,21, 소비/NNG;악영향/NNG,40,1.3137389020593222,Hawkish
21,17, 견고/NNG;상승/NNG,38,1.7936806681367214,Hawkish
15,5, 본위/NNG,20,4.356081622617752,Hawkish
36,35, 후기/NNG,71,1.4935136991832296,Hawkish
9,8, 던져진/VV,17,1.6335306084816572,Hawkish
37,27, 원부/NNG,64,1.9898150621834176,Hawkish
26,28, 실물/NNG;경제/NNG;성장/NNG,54,1.3483109784293044,Hawkish
42,34, 투자/NNG;억제/NNG,76,1.7936806681367214,Hawkish
31,28, 당분/NNG,59,1.6076015512041708,Hawkish
8,8, 열대/NNG,16,1.4520272075392506,Hawkish
42,42, 인플레이션/NNG;물가/NNG;상승/NNG,84,1.4520272075392509,Hawkish
14,8, 이익/NNG;증가율/NNG;둔화/NNG,22,2.541047613193689,Hawkish
17,13, 기업/NNG;부채/NNG;증가/NNG,30,1.8988048098590204,Hawkish
9,9, 이익/NNG;증가율/NNG;높/VA,18,1.4520272075392509,Hawkish
34,30, 금리/NNG;상승/NNG;압박/NNG,64,1.645630835211151,Hawkish
11,10, 신비/NNG,21,1.5972299282931757,Hawkish
11,10, 군포/NNG,21,1.5972299282931757,Hawkish
21,23, 물류기업/NNG,44,1.325763972101055,Hawkish
19,6, 비용/NNG;구조/NNG;개선/NNG,25,4.598086157207628,Hawkish
9,9, 상현/NNG,18,1.4520272075392509,Hawkish
11,6, 화공품/NNG,17,2.662049880488626,Hawkish
11,8, 가격/NNG;상승/NNG;금리/NNG;하락/NNG,19,1.9965374103664697,Hawkish
9,7, 물가/NNG;상승/NNG;아니/VCN,16,1.866892123979037,Hawkish
61,60, 유가/NNG;내리/VV,121,1.4762276609982383,Hawkish
12,12, 중기계획/NNG,24,1.4520272075392509,Hawkish
29,32, 주택담보대출/NNG;증가/NNG;둔화/NNG,61,1.315899656832446,Hawkish
12,8, 수익/NNG;악영향/NNG,20,2.1780408113088763,Hawkish
13,14, 놀래/VV,27,1.3483109784293044,Hawkish
21,7, 차례차례/MAG,28,4.356081622617753,Hawkish
24,25, 보령/NNG,49,1.393946119237681,Hawkish
96,100, 블랙아웃/NNG,196,1.393946119237681,Hawkish
26,0, 은한/NNG,26,inf,Hawkish
14,15, 절대/MAG;금리/NNG;낮/VA,29,1.3552253937033008,Hawkish
67,71, 숙련/NNG,138,1.3702228578187294,Hawkish
12,11, 리쇼어링/NNG,23,1.58402968095191,Hawkish
10,7, 높여라/VV,17,2.07432458219893,Hawkish
26,25, 경상/NNG;수지/NNG;적자/NNG;줄/VV,51,1.510108295840821,Hawkish
22,11, 투자/NNG;한도/NNG;제한/NNG,33,2.9040544150785017,Hawkish
9,8, 단기/NNG;fed/NNG;금리/NNG;인상/NNG,17,1.6335306084816572,Hawkish
77,57, 정태/NNG,134,1.9615104382547774,Hawkish
14,11, 충당금적립액/NNG,25,1.8480346277772284,Hawkish
15,15, 금리/NNG;인상/NNG;지연/NNG;기대/NNG;크/VV,30,1.4520272075392506,Hawkish
23,25, 높/VA;fed/NNG;금리/NNG;인상/NNG,48,1.3358650309361106,Hawkish
15,16, 국고채/NNG;금리/NNG;하단/NNG,31,1.3612755070680476,Hawkish
15,9, 상환능력/NNG;취약/NNG,24,2.420045345898751,Hawkish
12,13, 영미/NNG,25,1.3403328069593086,Hawkish
12,11, 심리/NNG;패닉/NNG,23,1.58402968095191,Hawkish
16,13, 금리/NNG;막/VV,29,1.7871104092790777,Hawkish
9,7, 채권시장/NNG;불플래트닝/NNG,16,1.866892123979037,Hawkish
10,10, 확장/NNG;거시정책/NNG;힘입/VV;완만/NNG;성장/NNG,20,1.4520272075392509,Hawkish
13,10, 대내외/NNG;경제/NNG;여건/NNG;비추/VV;성장/NNG,23,1.887635369801026,Hawkish
17,8, 공급측면/NNG;물가/NNG;상승/NNG;압력/NNG,25,3.0855578160209083,Hawkish
13,11, 취업자/NNG;증가/NNG;둔화/NNG,24,1.7160321543645694,Hawkish
14,10, 완화/NNG;정책/NNG;벗어나/VV,24,2.032838090554951,Hawkish
14,13, 소기업낙관지수/NNG;상승/NNG,27,1.5637216081191931,Hawkish
14,12, 대손/NNG;부담/NNG,26,1.6940317421291258,Hawkish
83,50, 텐트/NNG,133,2.4103651645151563,Hawkish
13,7, 수신/NNG;금리/NNG;높/VA,20,2.6966219568586087,Hawkish
45,39, 급락/NNG;멈추/VV,84,1.6754160086991354,Hawkish
9,8, 영구히/MAG,17,1.6335306084816572,Hawkish
63,53,스트레스테스트/NNG,116,1.7259946051881663,Hawkish
12,5, 유로시장/NNG,17,3.484865298094202,Hawkish
13,8, 경제/NNG;성공/NNG,21,2.359544212251283,Hawkish
10,6, 미학/NNG,16,2.420045345898751,Hawkish
13,11, 꺽/VV,24,1.7160321543645694,Hawkish
21,20, 금리/NNG;인상/NNG;압력/NNG;높/VA,41,1.5246285679162133,Hawkish
10,8, 완화정책/NNG;실망/NNG,18,1.8150340094240636,Hawkish
22,22, 역경매/NNG,44,1.4520272075392509,Hawkish
18,12, 중가/NNG,30,2.1780408113088763,Hawkish
25,25, 퇴보/NNG,50,1.4520272075392509,Hawkish
16,9, fed/NNG;성장률/NNG;둔화/NNG,25,2.5813817022920014,Hawkish
9,7, 유상증자/NNG;자본/NNG;확충/NNG,16,1.866892123979037,Hawkish
9,10, 기대/NNG;위험/NNG;선호/NNG,19,1.3068244867853258,Hawkish
39,37, 유동성/NNG;팽창/NNG,76,1.5305151647035347,Hawkish
31,30, 엔달러/NNG;상승/NNG,61,1.5004281144572258,Hawkish
29,19, 경기/NNG;감속/NNG,48,2.2162520536125405,Hawkish
78,51, 물가/NNG;통제/NNG,129,2.22074749388356,Hawkish
9,10, 아직/MAG;완화/NNG,19,1.3068244867853258,Hawkish
21,20, 요금/NNG;상승/NNG,41,1.5246285679162133,Hawkish
34,29, 반덤핑/NNG,63,1.7023767260805012,Hawkish
32,35, 수입규제/NNG,67,1.327567732607315,Hawkish
22,16, 기업/NNG;대출/NNG;확대/NNG,38,1.9965374103664697,Hawkish
35,39, 최대/NNG;위험/NNG,74,1.3031013400993277,Hawkish
9,7, 영혼/NNG,16,1.866892123979037,Hawkish
15,15, 아웅/NNG,30,1.4520272075392506,Hawkish
19,11, 성장/NNG;견고/NNG,30,2.5080469948405244,Hawkish
36,30, 컨셉/NNG,66,1.742432649047101,Hawkish
11,10, 추종지수/NNG,21,1.5972299282931757,Hawkish
11,5, 역사적변동성/NNG,16,3.1944598565863513,Hawkish
12,8, 경기/NNG;부양/NNG;효과/NNG;제한적/VAX,20,2.1780408113088763,Hawkish
14,9, 위험자산/NNG;선호/NNG;확산/NNG,23,2.258708989505501,Hawkish
11,5, 판매가격/NNG;인하/NNG,16,3.1944598565863513,Hawkish
15,15, 수요/NNG;부정적/VAX,30,1.4520272075392506,Hawkish
18,16, 금리/NNG;확보/NNG,34,1.6335306084816572,Hawkish
23,19, 면죄부/NNG,42,1.7577171459685668,Hawkish
9,8, 금리/NNG;더이상/MAG;내리/VV,17,1.6335306084816572,Hawkish
37,1, 나신/VV,38,53.72500667895228,Hawkish
12,13, 집단/NNG;대출심사/NNG;강화/NNG,25,1.3403328069593086,Hawkish
43,14, 신항/NNG,57,4.459797851727699,Hawkish
13,11, 실적/NNG;개선/NNG;긍정적/VAX,24,1.7160321543645694,Hawkish
23,22, 로스컷/NNG,45,1.5180284442455803,Hawkish
70,68, 연안/NNG,138,1.4947338901139346,Hawkish
13,9, 아직/MAG;물가/NNG;상승/NNG,22,2.097372633112251,Hawkish
49,47, 노동/NNG;비용/NNG;상승/NNG,96,1.5138155993494318,Hawkish
16,15, 금리/NNG;장기간/NNG;낮/VA,31,1.5488290213752007,Hawkish
40,34, 무형/NNG,74,1.7082673029873539,Hawkish
13,11, 계열분리/NNG,24,1.7160321543645694,Hawkish
38,27, 별세/NNG,65,2.0435938476478346,Hawkish
19,20, 이티/NNG,39,1.3794258471622882,Hawkish
36,22, 수부/NNG,58,2.376044521427865,Hawkish
9,8, 단시/NNG,17,1.6335306084816572,Hawkish
23,18, 급락/NNG;위험/NNG,41,1.855368098522376,Hawkish
8,8, ecb/NNG;금리/NNG;마이너스/NNG,16,1.4520272075392506,Hawkish
8,8, 많/VA;않/VX;금리/NNG;인상/NNG,16,1.4520272075392506,Hawkish
8,8, 합자회사/NNG,16,1.4520272075392506,Hawkish
21,18, 관리수수료/NNG,39,1.6940317421291258,Hawkish
21,14, 대손충당금/NNG;적립/NNG;부담/NNG,35,2.1780408113088763,Hawkish
11,11, 내수/NNG;악화/NNG,22,1.4520272075392509,Hawkish
18,12, 국채/NNG;매입/NNG;줄/VV,30,2.1780408113088763,Hawkish
17,16, 꼽힐/VV,33,1.5427789080104541,Hawkish
19,20, 머쓱/NNG,39,1.3794258471622882,Hawkish
42,39, 정책/NNG;종료/NNG,81,1.5637216081191931,Hawkish
10,9, 내렸었/VV,19,1.6133635639325008,Hawkish
20,19, 리프라이싱/NNG,39,1.5284496921465798,Hawkish
12,13, 광/MAG,25,1.3403328069593086,Hawkish
23,14, 화장/NNG,37,2.3854732695287693,Hawkish
56,62, 사그러들/VV,118,1.3115084455193233,Hawkish
15,9, 애비/NNG,24,2.420045345898751,Hawkish
11,10, 지분법/NNG,21,1.5972299282931757,Hawkish
56,55, 생겨난/VV,111,1.4784277022217827,Hawkish
35,27, 다수결/NNG,62,1.8822574912545844,Hawkish
11,12, 가계/NNG;소득/NNG;정체/NNG,23,1.331024940244313,Hawkish
23,25, 증협/NNG,48,1.3358650309361106,Hawkish
14,6, 력사/NNG,20,3.3880634842582515,Hawkish
11,5, 가른/VV,16,3.1944598565863513,Hawkish
10,10, 광군제/NNG,20,1.4520272075392509,Hawkish
11,7, 높/VA;재정/NNG;적자/NNG,18,2.2817570404188228,Hawkish
23,25,단기자금시장/NNG,48,1.3358650309361106,Hawkish
15,9, 큐/MAG,24,2.420045345898751,Hawkish
52,53, 첨부/NNG,105,1.4246304677743593,Hawkish
14,15, 틱차트/NNG,29,1.3552253937033008,Hawkish
12,4, 금리/NNG;상승/NNG;금리/NNG;오르/VV,16,4.356081622617753,Hawkish
26,14, 고르/VA;성장/NNG,40,2.6966219568586087,Hawkish
11,10, 예산편성지침/NNG,21,1.5972299282931757,Hawkish
21,22, 소견/NNG,43,1.3860259708329212,Hawkish
45,38, 방위비/NNG,83,1.7195059036649023,Hawkish
36,28, 급수/NNG,64,1.866892123979037,Hawkish
9,8, 단기/NNG;안전자산/NNG;선호/NNG,17,1.6335306084816572,Hawkish
10,7, 상대지수/NNG,17,2.07432458219893,Hawkish
60,52, 인플레이션/NNG;우려/NNG;높/VA,112,1.6754160086991354,Hawkish
13,11, 위험/NNG;fed/NNG;금리/NNG;인상/NNG,24,1.7160321543645694,Hawkish
13,13, 거품/NNG;붕괴/NNG;위험/NNG,26,1.4520272075392509,Hawkish
13,3, 위험자산/NNG;위험/NNG,16,6.292117899336753,Hawkish
13,12, 부채비율/NNG;안정/NNG,25,1.5730294748341882,Hawkish
26,22, 소비/NNG;억제/NNG,48,1.7160321543645694,Hawkish
11,7, 자본/NNG;부담/NNG,18,2.2817570404188228,Hawkish
13,8, 금리/NNG;인상/NNG;속도/NNG;우려/NNG,21,2.359544212251283,Hawkish
16,11, 고평가/NNG;우려/NNG,27,2.1120395746025467,Hawkish
28,23, 모티브/NNG,51,1.76768529613474,Hawkish
40,40, 위험자산/NNG;선호/NNG;강하/VA,80,1.4520272075392509,Hawkish
9,7, 고정/NNG;금리/NNG;무제한/NNG,16,1.866892123979037,Hawkish
34,33, 라흐/NNG,67,1.4960280320101373,Hawkish
13,6, 의견거절/NNG,19,3.1460589496683764,Hawkish
25,16, 범람/NNG,41,2.2687925117800796,Hawkish
20,21, 비호/NNG,41,1.3828830547992865,Hawkish
43,45, 배타/NNG,88,1.3874926649819508,Hawkish
49,48, 북미자유무역협정/NNG,97,1.4822777743629851,Hawkish
10,6, 권기/NNG,16,2.420045345898751,Hawkish
21,15, 무역구제/NNG,36,2.032838090554951,Hawkish
64,64, 검역/NNG,128,1.4520272075392506,Hawkish
15,11, 직물/NNG,26,1.9800371011898874,Hawkish
103,86, 육류/NNG,189,1.7390558415877073,Hawkish
50,20, 기독/NNG,70,3.630068018848127,Hawkish
18,20, 댈/XSV,38,1.3068244867853258,Hawkish
22,17, 외국인/NNG;매도/NNG;압력/NNG,39,1.879094033286089,Hawkish
13,8, 재고/NNG;축소/NNG,21,2.359544212251283,Hawkish
25,24, 수소/NNG,49,1.5125283411867194,Hawkish
17,18, 트럼프쇼크/NNG,35,1.3713590293426259,Hawkish
25,17, 판매가격/NNG;인상/NNG,42,2.1353341287341925,Hawkish
24,15, 하락/NNG;오르/VV,39,2.3232435320628015,Hawkish
11,7, 동당/NNG,18,2.2817570404188228,Hawkish
15,9, 수익/NNG;향상/NNG,24,2.420045345898751,Hawkish
30,33, 부친/VV,63,1.3200247341265916,Hawkish
9,8, 이전투구/NNG,17,1.6335306084816572,Hawkish
54,58, 출하량/NNG,112,1.3518874001227508,Hawkish
11,10, 정치/NNG;경제/NNG;불안/NNG,21,1.5972299282931757,Hawkish
45,47, 사직/NNG,92,1.39023881572907,Hawkish
9,7, 채워지/VV,16,1.866892123979037,Hawkish
30,14, 정상화계획/NNG,44,3.1114868732983947,Hawkish
10,11, 국채/NNG;금리/NNG;고점/NNG,21,1.3200247341265916,Hawkish
12,11, 중단/NNG;우려/NNG,23,1.58402968095191,Hawkish
24,25, 생산성/NNG;오르/VV,49,1.393946119237681,Hawkish
727,0, 젂/VV,727,inf,Hawkish
11,11, 경제/NNG;수출/NNG;증가/NNG,22,1.4520272075392509,Hawkish
12,8, 국채/NNG;매입/NNG;축소/NNG,20,2.1780408113088763,Hawkish
100,88, 계란/NNG,188,1.6500309176582397,Hawkish
61,64, 닭고기/NNG,125,1.3839634321858485,Hawkish
18,17, 냉각기/NNG,35,1.5374405726886184,Hawkish
20,7, 행할/VV,27,4.14864916439786,Hawkish
34,33, 주택담보대출/NNG;금리/NNG;급등/NNG,67,1.4960280320101373,Hawkish
11,7, 몰렸으나/VV,18,2.2817570404188228,Hawkish
43,34, 감가상각/NNG,77,1.8363873507114052,Hawkish
17,12, 야성적충동/NNG,29,2.0570385440139387,Hawkish
13,3, fed/NNG;경기/NNG;판단/NNG;상향/NNG,16,6.292117899336753,Hawkish
12,9, 주택관리/NNG,21,1.9360362767190011,Hawkish
12,10, 세대수/NNG,22,1.742432649047101,Hawkish
12,10, 재정/NNG;부담/NNG;완화/NNG,22,1.742432649047101,Hawkish
15,7, 투자/NNG;지출/NNG;늘/VV,22,3.1114868732983947,Hawkish
16,8, 완화정책/NNG;한계/NNG,24,2.9040544150785013,Hawkish
10,8, 인상/NNG;악재/NNG,18,1.8150340094240636,Hawkish
10,7, 정책/NNG;줄/VV,17,2.07432458219893,Hawkish
10,9, 신규출점/NNG,19,1.6133635639325008,Hawkish
21,13, 금리/NNG;짧/VA,34,2.3455824121787896,Hawkish
40,25, 다중채무/NNG,65,2.3232435320628015,Hawkish
10,10, 임명권자/NNG,20,1.4520272075392509,Hawkish
34,11, 산업혁명/NNG,45,4.488084096030412,Hawkish
16,1, 삼일절/NNG,17,23.23243532062801,Hawkish
12,13, 가계/NNG;이자/NNG;부담/NNG;늘/VV,25,1.3403328069593086,Hawkish
27,30, 물가/NNG;오름/NNG;확대/NNG,57,1.3068244867853256,Hawkish
9,7, 부작용/NNG;작/VA,16,1.866892123979037,Hawkish
92,80, 행정명령/NNG,172,1.6698312886701383,Hawkish
30,24, 원재료/NNG;가격/NNG;상승/NNG,54,1.8150340094240633,Hawkish
24,23, 금리/NNG;오르/VV;긴축/NNG,47,1.5151588252583488,Hawkish
12,7, 전망/NNG;원화/NNG;강세/NNG,19,2.489189498638716,Hawkish
10,6, 수출/NNG;최저/NNG,16,2.420045345898751,Hawkish
26,26, 정책/NNG;벗어나/VV,52,1.4520272075392509,Hawkish
18,5, 성장/NNG;완만/NNG;수요측면/NNG;물가/NNG;상승/NNG,23,5.227297947141303,Hawkish
19,5, 완만/NNG;수요측면/NNG;물가/NNG;상승/NNG;압력/NNG,24,5.517703388649153,Hawkish
26,13, 수출/NNG;세계/NNG;경제/NNG;회복/NNG,39,2.9040544150785017,Hawkish
16,11, 내수/NNG;회복/NNG;약화/NNG,27,2.1120395746025467,Hawkish
24,2, 회복/NNG;힘입/VV;개선/NNG,26,17.42432649047101,Hawkish
125,0, 앆/NNG,125,inf,Hawkish
14,9, 조정법/NNG,23,2.258708989505501,Hawkish
11,10, 국영화/NNG,21,1.5972299282931757,Hawkish
77,72, 송환/NNG,149,1.552862430285032,Hawkish
15,15, 접근권/NNG,30,1.4520272075392506,Hawkish
9,8, 관세동맹/NNG,17,1.6335306084816572,Hawkish
34,25, 인하/NNG;인상/NNG,59,1.9747570022533814,Hawkish
22,24, 이자/NNG;오르/VV,46,1.331024940244313,Hawkish
17,15, 해롭/VA,32,1.645630835211151,Hawkish
15,11, 경제/NNG;해치/VV,26,1.9800371011898874,Hawkish
20,13, 보호국/NNG,33,2.2338880115988475,Hawkish
34,3, 선택법/NNG,37,16.45630835211151,Hawkish
17,15, 완화/NNG;반대/NNG,32,1.645630835211151,Hawkish
18,15, 국채/NNG;금리/NNG;불안/NNG,33,1.742432649047101,Hawkish
20,20, 투자/NNG;관심/NNG;높/VA,40,1.4520272075392509,Hawkish
9,10, 재투자/NNG;축소/NNG,19,1.3068244867853258,Hawkish
32,34, 성장/NNG;지지/NNG,66,1.3666138423898828,Hawkish
19,11, 종래/NNG,30,2.5080469948405244,Hawkish
42,26,발행물/NNG,68,2.3455824121787896,Hawkish
55,23, 국경조정세/NNG,78,3.472238974550382,Hawkish
13,13, 고평가/NNG;부담/NNG,26,1.4520272075392509,Hawkish
9,9, 물가/NNG;자신/NNG,18,1.4520272075392509,Hawkish
37,38, 지분법이익/NNG,75,1.4138159652355864,Hawkish
31,33,조용/NNG,64,1.364025558597478,Hawkish
14,11, 공수/NNG,25,1.8480346277772284,Hawkish
13,9, 휘발유/NNG;가격/NNG;인상/NNG,22,2.097372633112251,Hawkish
16,11, 통화정책/NNG;지지/NNG,27,2.1120395746025467,Hawkish
13,14, 높/VA;기저효과/NNG,27,1.3483109784293044,Hawkish
14,14,구성원/NNG,28,1.4520272075392509,Hawkish
17,13, 인신매매/NNG,30,1.8988048098590204,Hawkish
15,8, 허수/NNG,23,2.722551014136095,Hawkish
18,13, 비용/NNG;부담/NNG;증가/NNG,31,2.010499210438963,Hawkish
39,26, 긴축정책/NNG;강화/NNG,65,2.1780408113088763,Hawkish
11,5, 원화/NNG;강세/NNG;금리/NNG;상승/NNG,16,3.1944598565863513,Hawkish
10,10, 도매/NNG;판매/NNG;증가/NNG,20,1.4520272075392509,Hawkish
10,6, 전망/NNG;예상/NNG;낮/VA,16,2.420045345898751,Hawkish
23,16, 교역/NNG;확대/NNG,39,2.087289110837673,Hawkish
203,219,세제/NNG,422,1.345943027993004,Hawkish
21,21, 수입기업/NNG,42,1.4520272075392509,Hawkish
9,7, 기본공제/NNG,16,1.866892123979037,Hawkish
11,9, 나신/NNG,20,1.774699920325751,Hawkish
10,9, 수요/NNG;확산/NNG,19,1.6133635639325008,Hawkish
10,10, 기업/NNG;금리/NNG;상승/NNG,20,1.4520272075392509,Hawkish
15,6, 수요측면/NNG;물가/NNG;상승/NNG;압력/NNG;높/VA,21,3.6300680188481267,Hawkish
24,26, 가계/NNG;대출/NNG;증가/NNG;둔화/NNG,50,1.3403328069593086,Hawkish
12,9, 경기/NNG;회복/NNG;확대/NNG,21,1.9360362767190011,Hawkish
16,11, 차주/NNG;부담/NNG,27,2.1120395746025467,Hawkish
15,7, 소비자/NNG;물가/NNG;농축수산물/NNG;가격/NNG;상승/NNG,22,3.1114868732983947,Hawkish
18,11, 세계/NNG;경제/NNG;회복/NNG;확대/NNG,29,2.376044521427865,Hawkish
14,6, 가격/NNG;상승/NNG;물가/NNG;안정/NNG,20,3.3880634842582515,Hawkish
19,20, 수출/NNG;부진/NNG;완화/NNG,39,1.3794258471622882,Hawkish
13,11, 재조/NNG,24,1.7160321543645694,Hawkish
17,9, 정부정책/NNG;불확실성/NNG,26,2.7427180586852518,Hawkish
30,33, 미/NNG;성장/NNG,63,1.3200247341265916,Hawkish
19,14, 전망/NNG;쉽/VA;않/VX,33,1.9706083530889835,Hawkish
16,8, 랜덤/NNG,24,2.9040544150785013,Hawkish
106,117, 기념일/NNG,223,1.3155118290526546,Hawkish
13,5, 위험자산/NNG;투자/NNG;확대/NNG,18,3.775270739602052,Hawkish
10,11, 대출/NNG;상승/NNG,21,1.3200247341265916,Hawkish
26,19, 투자/NNG;짧/VA,45,1.9869845997905538,Hawkish
13,12, 경제/NNG;탄탄/NNG;성장/NNG,25,1.5730294748341882,Hawkish
14,9, 투자수익률/NNG;높/VV,23,2.258708989505501,Hawkish
25,24, 되살렸/VV,49,1.5125283411867194,Hawkish
19,17, 금리/NNG;인상/NNG;많/VA,36,1.622853937837986,Hawkish
21,20,쉼/NNG,41,1.5246285679162133,Hawkish
11,7, 게시물/NNG,18,2.2817570404188228,Hawkish
19,6, 금리/NNG;인상/NNG;사이클/NNG;종료/NNG,25,4.598086157207628,Hawkish
14,14, 부채비율/NNG;떨어/VV,28,1.4520272075392509,Hawkish
23,22, 기존점/NNG,45,1.5180284442455803,Hawkish
16,11, 과연/MAG;금리/NNG;인상/NNG,27,2.1120395746025467,Hawkish
18,19, 베이시스/NNG;축소/NNG,37,1.375604722931922,Hawkish
82,47, 부보/NNG,129,2.5333240642174166,Hawkish
9,8,지/NNG,17,1.6335306084816572,Hawkish
95,74, 필립스곡선/NNG,169,1.8640889826517408,Hawkish
19,20, 담화문/NNG,39,1.3794258471622882,Hawkish
14,13, 부안/NNG,27,1.5637216081191931,Hawkish
15,12, 거주민/NNG,27,1.8150340094240633,Hawkish
16,2, 주택/NNG;판매/NNG;둔화/NNG,18,11.616217660314005,Hawkish
16,16, 가격/NNG;방어/NNG,32,1.4520272075392506,Hawkish
41,44, 시켜서/XSV,85,1.3530253524797564,Hawkish
23,15, 띈/VV,38,2.2264417182268508,Hawkish
19,21, 황개/NNG,40,1.3137389020593222,Hawkish
63,63, 민정/NNG,126,1.4520272075392509,Hawkish
18,0, 편편/NNG,18,inf,Hawkish
22,5, 등반/NNG,27,6.388919713172703,Hawkish
31,1, 듯/VV,32,45.012843433716775,Hawkish
23,4, 요국/NNG,27,8.349156443350692,Hawkish
19,21, 금리/NNG;인상/NNG;속도/NNG;불확실성/NNG,40,1.3137389020593222,Hawkish
29,29, 고난/NNG,58,1.4520272075392509,Hawkish
22,24, 응대/NNG,46,1.331024940244313,Hawkish
21,12, 최저임금/NNG;상승/NNG,33,2.5410476131936885,Hawkish
11,6, 가격/NNG;개선/NNG,17,2.662049880488626,Hawkish
18,11, 뒤바꿀/VV,29,2.376044521427865,Hawkish
15,12, 수출/NNG;투자/NNG;개선/NNG,27,1.8150340094240633,Hawkish
23,18, 전망/NNG;소폭/MAG;웃돌/VV,41,1.855368098522376,Hawkish
15,4, 교역/NNG;여건/NNG;악화/NNG,19,5.44510202827219,Hawkish
18,11, 금리/NNG;플래트닝/NNG,29,2.376044521427865,Hawkish
17,17, 안정/NNG;개선/NNG,34,1.4520272075392509,Hawkish
11,7, 보릿고개/NNG,18,2.2817570404188228,Hawkish
11,12,두려움/NNG,23,1.331024940244313,Hawkish
33,31, 명회/NNG,64,1.5457063822192025,Hawkish
41,36, 일체/MAG,77,1.6536976530308134,Hawkish
18,1, 결일/NNG,19,26.136489735706515,Hawkish
33,31, 사주/NNG,64,1.5457063822192025,Hawkish
26,23, 두고두고/MAG,49,1.6414220606965444,Hawkish
17,13, 잠재손실/NNG,30,1.8988048098590204,Hawkish
22,0, 간간/NNG,22,inf,Hawkish
37,29, 산식/NNG,66,1.8525864372052512,Hawkish
54,42, 평가손익/NNG,96,1.8668921239790368,Hawkish
19,2, 보간법/NNG,21,13.794258471622884,Hawkish
169,0, 별주/NNG,169,inf,Hawkish
56,2, 달달/MAG,58,40.656761811099024,Hawkish
12,6, 주택/NNG;경기/NNG;침체/NNG;우려/NNG,18,2.9040544150785017,Hawkish
25,21, 건설/NNG;강세/NNG,46,1.7286038184991082,Hawkish
11,5, 좋아한다/VV,16,3.1944598565863513,Hawkish
13,10, 하단/NNG;이탈/NNG,23,1.887635369801026,Hawkish
477,469, 손해율/NNG,946,1.476795262252074,Hawkish
55,13, 합산비율/NNG,68,6.14319203189683,Hawkish
113,50, 사업비율/NNG,163,3.281581489038707,Hawkish
13,10, 장기위험손해율/NNG,23,1.887635369801026,Hawkish
10,9, 이익/NNG;안정/NNG,19,1.6133635639325008,Hawkish
31,9, 트럼프트레이드/NNG,40,5.001427048190753,Hawkish
12,11, 나간다고/VV,23,1.58402968095191,Hawkish
11,8, 높/VA;지정학/NNG;위험/NNG,19,1.9965374103664697,Hawkish
14,11, 끝마쳤/VV,25,1.8480346277772284,Hawkish
24,24, 여우/NNG,48,1.4520272075392509,Hawkish
38,32, 셔/NNG,70,1.7242823089528605,Hawkish
9,9, 개선/NNG;기대/NNG;살/VV,18,1.4520272075392509,Hawkish
39,36, 개혁의지/NNG,75,1.5730294748341884,Hawkish
14,6, 스왑레이트/NNG;마이너스/NNG,20,3.3880634842582515,Hawkish
52,55, 피인수/NNG,107,1.3728257234916554,Hawkish
66,69, 괴리율/NNG,135,1.3888955898201527,Hawkish
17,15, 처지/VV,32,1.645630835211151,Hawkish
12,6, 경영/NNG;불확실성/NNG,18,2.9040544150785017,Hawkish
57,42, 기장/NNG,99,1.970608353088983,Hawkish
19,21, 덤덤/NNG,40,1.3137389020593222,Hawkish
16,9, 금공/NNG,25,2.5813817022920014,Hawkish
36,37, 식형/NNG,73,1.412783228957109,Hawkish
24,25, 담보보완대출/NNG,49,1.393946119237681,Hawkish
40,21, 금융계정/NNG,61,2.765766109598573,Hawkish
9,10, 무역신용/NNG,19,1.3068244867853258,Hawkish
15,6, 기업/NNG;이익/NNG;훼손/NNG,21,3.6300680188481267,Hawkish
28,24, 기업/NNG;이익/NNG;회복/NNG,52,1.6940317421291258,Hawkish
29,26, 사회서비스/NNG,55,1.6195688084091644,Hawkish
32,23, 실효세율/NNG,55,2.0202117670111313,Hawkish
14,15, 중소벤처기업부/NNG,29,1.3552253937033008,Hawkish
26,27, 건너뛰/VV,53,1.3982484220748341,Hawkish
22,22, 국고채/NNG;발행/NNG;늘/VV,44,1.4520272075392509,Hawkish
17,6, 공급/NNG;증대/NNG,23,4.114077088027877,Hawkish
34,35, 외식업/NNG,69,1.4105407158952723,Hawkish
115,123, 페니/NNG,238,1.357586413552958,Hawkish
14,12, 고용시장/NNG;호조/NNG;임금/NNG;상승/NNG,26,1.6940317421291258,Hawkish
12,8, 물가/NNG;영향/NNG;줄/VV,20,2.1780408113088763,Hawkish
8,8, 실업/NNG;심각/NNG,16,1.4520272075392506,Hawkish
20,16, 판매/NNG;회복/NNG,36,1.8150340094240636,Hawkish
29,30, 방향설정/NNG,59,1.4036263006212757,Hawkish
17,9, 상향수/NNG,26,2.7427180586852518,Hawkish
15,7, 신용위험액/NNG,22,3.1114868732983947,Hawkish
14,15, 분양시장/NNG;호황/NNG,29,1.3552253937033008,Hawkish
34,17, 장수/NNG;위험/NNG,51,2.9040544150785017,Hawkish
30,24, 턴/VV,54,1.8150340094240633,Hawkish
12,8, 경기/NNG;선행/NNG;지수/NNG;회복/NNG,20,2.1780408113088763,Hawkish
9,10, 당분간/MAG;금리/NNG;인상/NNG;어렵/VA,19,1.3068244867853258,Hawkish
36,34, 인플레이션/NNG;우려/NNG;높/VV,70,1.5374405726886184,Hawkish
15,12, 가격/NNG;상승/NNG;부담/NNG,27,1.8150340094240633,Hawkish
16,15, 정책/NNG;불확실성/NNG;높/VA,31,1.5488290213752007,Hawkish
19,19, 바닥/NNG;다지/VV;상승/NNG,38,1.4520272075392509,Hawkish
10,7, 위축/NNG;우려/NNG;크/VV,17,2.07432458219893,Hawkish
12,13, 교역/NNG;늘/VV,25,1.3403328069593086,Hawkish
33,19, 닻/NNG,52,2.5219419920418567,Hawkish
16,14, 경제력집중/NNG,30,1.6594596657591438,Hawkish
18,10, 국가채무비중/NNG,28,2.6136489735706516,Hawkish
11,5, 무상교/NNG,16,3.1944598565863513,Hawkish
13,11, 상과/NNG,24,1.7160321543645694,Hawkish
49,53, 국공립/NNG,102,1.342440248479685,Hawkish
24,13, 도시재생뉴딜/NNG,37,2.680665613918617,Hawkish
11,8, 전학/NNG,19,1.9965374103664697,Hawkish
18,13, 특별소비세/NNG,31,2.010499210438963,Hawkish
29,32, 살폈/VV,61,1.315899656832446,Hawkish
18,17, 재미없/VA,35,1.5374405726886184,Hawkish
49,42, 추문/NNG,91,1.694031742129126,Hawkish
18,7, 닥/NNG,25,3.733784247958074,Hawkish
20,17, 금리/NNG;하락/NNG;부담/NNG,37,1.7082673029873539,Hawkish
14,12, 구조재편/NNG,26,1.6940317421291258,Hawkish
13,6, 가계/NNG;부채/NNG;증가/NNG;지정학/NNG;위험/NNG,19,3.1460589496683764,Hawkish
12,5, 전망/NNG;경로/NNG;소폭/MAG;상회/NNG,17,3.484865298094202,Hawkish
14,6, 경제/NNG;소비/NNG;증가/NNG,20,3.3880634842582515,Hawkish
22,0, 볼드체/NNG,22,inf,Hawkish
14,10, 폐지안/NNG,24,2.032838090554951,Hawkish
30,28, 휴회/NNG,58,1.5557434366491973,Hawkish
13,14, 외유/NNG,27,1.3483109784293044,Hawkish
42,30, 중화학공업/NNG,72,2.032838090554951,Hawkish
13,11, 동구권/NNG,24,1.7160321543645694,Hawkish
13,12, 분업/NNG,25,1.5730294748341882,Hawkish
11,10, 상호출자/NNG,21,1.5972299282931757,Hawkish
46,19, 스튜어드십코드/NNG,65,3.5154342919371335,Hawkish
22,22, 중거리/NNG,44,1.4520272075392509,Hawkish
45,49, 주둔/NNG,94,1.3334943742707404,Hawkish
29,31, 시중/NNG;유동성/NNG;줄/VV,60,1.3583480328592992,Hawkish
12,9, 수출/NNG;투자/NNG;호조/NNG,21,1.9360362767190011,Hawkish
21,20, 예상/NNG;매파/NNG;않/VX,41,1.5246285679162133,Hawkish
11,5, 다운스트림/NNG,16,3.1944598565863513,Hawkish
21,23, 이익/NNG;확대/NNG,44,1.325763972101055,Hawkish
17,16, 주택담보대출/NNG;금리/NNG;높/VA,33,1.5427789080104541,Hawkish
12,13, 물가/NNG;상승률/NNG;전망/NNG;낮/VA,25,1.3403328069593086,Hawkish
13,7, 헤르메스/NNG,20,2.6966219568586087,Hawkish
10,6, 물가/NNG;상승률/NNG;상회/NNG,16,2.420045345898751,Hawkish
22,24, 지수/NNG;확장/NNG,46,1.331024940244313,Hawkish
81,86, 하방/NNG;경직/NNG;확보/NNG,167,1.3676070210544107,Hawkish
17,16, 기업/NNG;이익/NNG;둔화/NNG,33,1.5427789080104541,Hawkish
9,9, 주택/NNG;경기/NNG;둔화/NNG;우려/NNG,18,1.4520272075392509,Hawkish
29,20, 구인난/NNG,49,2.1054394509319136,Hawkish
16,11, 퍼센트/NNG,27,2.1120395746025467,Hawkish
16,15, 업종평균/NNG,31,1.5488290213752007,Hawkish
9,7, 숙/VV,16,1.866892123979037,Hawkish
31,26, 생산성/NNG;둔화/NNG,57,1.731263208989107,Hawkish
22,18, 생산성/NNG;떨어/VV,40,1.774699920325751,Hawkish
19,20, 상승률/NNG;떨어/VV,39,1.3794258471622882,Hawkish
10,9, 가격/NNG;둔화/NNG,19,1.6133635639325008,Hawkish
24,24, 생산성/NNG;높/VA,48,1.4520272075392509,Hawkish
20,1, 사보험/NNG,21,29.040544150785017,Hawkish
27,27, 대출/NNG;규제/NNG;금리/NNG;인상/NNG,54,1.4520272075392506,Hawkish
23,23, 부동산/NNG;경기/NNG;냉각/NNG,46,1.4520272075392506,Hawkish
34,26, 건설/NNG;경기/NNG;위축/NNG,60,1.8988048098590204,Hawkish
24,21, 본청/NNG,45,1.6594596657591438,Hawkish
10,8, 무위험수익률/NNG,18,1.8150340094240636,Hawkish
10,9, 저축률/NNG;떨어/VV,19,1.6133635639325008,Hawkish
13,6, 핵심/NNG;인플레이션/NNG;상승/NNG,19,3.1460589496683764,Hawkish
35,25, 초대형투자은행/NNG,60,2.0328380905549515,Hawkish
11,8, 종합투자계좌/NNG,19,1.9965374103664697,Hawkish
13,10, 도자기/NNG,23,1.887635369801026,Hawkish
46,27, 수탁액/NNG,73,2.473824131363168,Hawkish
16,12, 동자/NNG,28,1.9360362767190007,Hawkish
9,7, 화백/NNG,16,1.866892123979037,Hawkish
86,85, 이타/NNG,171,1.4691098805691243,Hawkish
26,22, 먼지/NNG,48,1.7160321543645694,Hawkish
17,18, 정례화/NNG,35,1.3713590293426259,Hawkish
9,7, 부채/NNG;듀레이션/NNG;확대/NNG,16,1.866892123979037,Hawkish
12,9, 이익/NNG;견조/NNG,21,1.9360362767190011,Hawkish
15,14, 흘러간다면/VV,29,1.5557434366491973,Hawkish
9,8, 경제/NNG;성장/NNG;방해/NNG,17,1.6335306084816572,Hawkish
10,6, 역/MAG,16,2.420045345898751,Hawkish
9,8, 면세사업/NNG,17,1.6335306084816572,Hawkish
11,12, 굴/VV,23,1.331024940244313,Hawkish
9,8, 제조업/NNG;부정적/VAX,17,1.6335306084816572,Hawkish
8,8, 환경/NNG;부담/NNG,16,1.4520272075392506,Hawkish
32,31, 경영/NNG;부담/NNG,63,1.4988667948792267,Hawkish
46,44, 알고리즘/NNG,90,1.5180284442455803,Hawkish
15,16, 환경/NNG;완화/NNG,31,1.3612755070680476,Hawkish
82,78,미리/MAG,160,1.5264901412592125,Hawkish
12,11, 사업손실/NNG,23,1.58402968095191,Hawkish
18,13, 공종/NNG,31,2.010499210438963,Hawkish
15,8, 지급여력비율/NNG;하락/NNG,23,2.722551014136095,Hawkish
20,17, 핸/XSV,37,1.7082673029873539,Hawkish
23,20, 신용조합/NNG,43,1.6698312886701383,Hawkish
14,7, 과대계상/NNG,21,2.9040544150785017,Hawkish
13,8, 경제/NNG;성장률/NNG;긍정적/VAX,21,2.359544212251283,Hawkish
40,39, 심심/NNG,79,1.4892586743992315,Hawkish
16,17, 밸/VV,33,1.3666138423898828,Hawkish
39,24, 업태/NNG,63,2.3595442122512824,Hawkish
13,6, 식료품/NNG;가격/NNG;안정/NNG,19,3.1460589496683764,Hawkish
14,9,미미/NNG,23,2.258708989505501,Hawkish
170,166, icbm/NNG,336,1.4870158149498351,Hawkish
12,11, 도지/NNG,23,1.58402968095191,Hawkish
13,12, 쿠션/NNG,25,1.5730294748341882,Hawkish
9,10, 관공/NNG,19,1.3068244867853258,Hawkish
31,33, 경제/NNG;전망/NNG;긍정적/VAX,64,1.364025558597478,Hawkish
42,31, 글로벌/NNG;긴축/NNG;우려/NNG,73,1.967262668278985,Hawkish
31,28, 인플레이션/NNG;일시적/VAX,59,1.6076015512041708,Hawkish
20,16, 물가/NNG;상승률/NNG;금리/NNG;인상/NNG,36,1.8150340094240636,Hawkish
9,10, 외환시장/NNG;영향/NNG;줄/VV,19,1.3068244867853258,Hawkish
9,9, 추경/NNG;성장/NNG,18,1.4520272075392509,Hawkish
15,13, 거시/NNG;성장/NNG,28,1.6754160086991354,Hawkish
31,22, 임금/NNG;오르/VV;않/VX,53,2.046038337896217,Hawkish
15,2, 지켜갈/VV,17,10.89020405654438,Hawkish
77,66, 등록제/NNG,143,1.694031742129126,Hawkish
18,16, 햇/VV,34,1.6335306084816572,Hawkish
11,12, 기결/NNG,23,1.331024940244313,Hawkish
39,41, 지환/NNG,80,1.3811966120495314,Hawkish
18,18, 국공/NNG,36,1.4520272075392509,Hawkish
10,8, 안정성/NNG;개선/NNG,18,1.8150340094240636,Hawkish
8,8, 전세기/NNG,16,1.4520272075392506,Hawkish
10,9, 금리/NNG;많이/MAG;오르/VV;않/VX,19,1.6133635639325008,Hawkish
121,65, 혁신성장/NNG,186,2.703004494034605,Hawkish
16,8, 일자리/NNG;안정/NNG,24,2.9040544150785013,Hawkish
42,32, 요망/NNG,74,1.9057857098952666,Hawkish
68,36,세제개편/NNG,104,2.7427180586852518,Hawkish
16,16, 승복/NNG,32,1.4520272075392506,Hawkish
10,6, 확장/NNG;회복/NNG,16,2.420045345898751,Hawkish
34,35, 경제/NNG;지지/NNG,69,1.4105407158952723,Hawkish
19,21, 신선식품지수/NNG,40,1.3137389020593222,Hawkish
15,16, 자본축적/NNG,31,1.3612755070680476,Hawkish
10,8, 기업/NNG;디폴트/NNG;위험/NNG,18,1.8150340094240636,Hawkish
14,15,제자리/NNG,29,1.3552253937033008,Hawkish
17,18, 물가/NNG;바닥/NNG,35,1.3713590293426259,Hawkish
13,13, 어려울수록/VA,26,1.4520272075392509,Hawkish
22,9, 자영/NNG,31,3.549399840651502,Hawkish
32,29, 주점/NNG,61,1.6022369186640009,Hawkish
22,19, 올라갈수록/VV,41,1.6812946613612378,Hawkish
50,41, 인건비/NNG;상승/NNG,91,1.7707648872429889,Hawkish
18,12, 괴/VV,30,2.1780408113088763,Hawkish
33,16, 프로퍼티/NNG,49,2.9948061155497046,Hawkish
11,8, 급유/NNG,19,1.9965374103664697,Hawkish
22,17, 식수/NNG,39,1.879094033286089,Hawkish
10,7, 퍼블릭/NNG,17,2.07432458219893,Hawkish
16,7, 자본지출/NNG;증가/NNG,23,3.3189193315182877,Hawkish
150,153, 탄도미사일/NNG,303,1.423556085822795,Hawkish
43,38, 영변/NNG,81,1.6430834190575734,Hawkish
16,12, fed/NNG;자산/NNG;축소/NNG;금리/NNG;인상/NNG,28,1.9360362767190007,Hawkish
17,11, 금리/NNG;시장/NNG;금리/NNG;상승/NNG,28,2.244042048015206,Hawkish
34,18, 핵보유국/NNG,52,2.7427180586852518,Hawkish
39,21, 창건일/NNG,60,2.6966219568586087,Hawkish
38,33, 응징/NNG,71,1.6720313298936829,Hawkish
15,14, 망명/NNG,29,1.5557434366491973,Hawkish
21,10, 전술핵/NNG,31,3.0492571358324265,Hawkish
32,34, 장거리/NNG,66,1.3666138423898828,Hawkish
70,65, 남북경협/NNG,135,1.5637216081191934,Hawkish
10,8, 물가/NNG;상승효과/NNG,18,1.8150340094240636,Hawkish
13,4, 무뎌졌/VA,17,4.719088424502566,Hawkish
12,8, 채권/NNG;관심/NNG;높/VA,20,2.1780408113088763,Hawkish
12,12, 북한리스크/NNG;경계/NNG,24,1.4520272075392509,Hawkish
15,12, 인큐베이터/NNG,27,1.8150340094240633,Hawkish
76,70, 수령액/NNG,146,1.5764866824711867,Hawkish
31,24, 다중/NNG,55,1.8755351430715321,Hawkish
9,8, 금리/NNG;이미/MAG;금리/NNG;인상/NNG,17,1.6335306084816572,Hawkish
8,8, 무역/NNG;정책/NNG;불확실성/NNG,16,1.4520272075392506,Hawkish
44,40, 금리/NNG;오르/VV;인상/NNG,84,1.5972299282931757,Hawkish
15,12, 채권시장/NNG;인상/NNG,27,1.8150340094240633,Hawkish
20,17, 투자심리/NNG;좋/VA,37,1.7082673029873539,Hawkish
28,18,조류/NNG,46,2.258708989505501,Hawkish
18,18, 줄여도/VV,36,1.4520272075392509,Hawkish
52,36, 예결위/NNG,88,2.097372633112251,Hawkish
14,12, 급전환/NNG,26,1.6940317421291258,Hawkish
13,11, 원가/NNG;개선/NNG,24,1.7160321543645694,Hawkish
29,17, 전화기/NNG,46,2.476987589331663,Hawkish
13,14, 사철/NNG,27,1.3483109784293044,Hawkish
14,15, 벌린/VV,29,1.3552253937033008,Hawkish
14,15, 금리/NNG;인상/NNG;보유자산/NNG;축소/NNG,29,1.3552253937033008,Hawkish
10,9, 원달러/NNG;변동성/NNG;크/VV,19,1.6133635639325008,Hawkish
13,9, 채권시장/NNG;급등/NNG,22,2.097372633112251,Hawkish
13,9, 집값/NNG;상승/NNG;둔화/NNG,22,2.097372633112251,Hawkish
10,9, 물가/NNG;압력/NNG;높/VA;않/VX,19,1.6133635639325008,Hawkish
28,26, 부동산/NNG;가격/NNG;불안/NNG,54,1.5637216081191931,Hawkish
23,7, 수소폭탄/NNG,30,4.7709465390575385,Hawkish
25,19, 주변부/NNG,44,1.9105621151832248,Hawkish
46,50, 미/NNG;비농업/NNG;고용/NNG;증가/NNG,96,1.3358650309361106,Hawkish
11,10, 수주/NNG;급증/NNG,21,1.5972299282931757,Hawkish
24,3, 트렌드분석/NNG,27,11.616217660314007,Hawkish
17,7, 프라이버시/NNG,24,3.526351789738181,Hawkish
199,35, 어마/NNG,234,8.25581183715174,Hawkish
9,8, 고정자산/NNG;투자/NNG;둔화/NNG,17,1.6335306084816572,Hawkish
18,17, 물가/NNG;금리/NNG;오르/VV,35,1.5374405726886184,Hawkish
13,13, 재무구조/NNG;안정/NNG,26,1.4520272075392509,Hawkish
14,9, 뒤쳐졌/VV,23,2.258708989505501,Hawkish
19,14, 객원/NNG,33,1.9706083530889835,Hawkish
12,10, 재임명/NNG,22,1.742432649047101,Hawkish
50,54, 허리/NNG,104,1.3444696366104174,Hawkish
12,10, 금리/NNG;인상/NNG;확률/NNG;낮/VA,22,1.742432649047101,Hawkish
11,6, 원료/NNG;가격/NNG;상승/NNG,17,2.662049880488626,Hawkish
42,45, 실리콘밸리/NNG,87,1.3552253937033008,Hawkish
20,20, 얼리/NNG,40,1.4520272075392509,Hawkish
13,10, 우이/NNG,23,1.887635369801026,Hawkish
23,9, 리츠지수/NNG,32,3.710736197044752,Hawkish
19,19, 중흥/NNG,38,1.4520272075392509,Hawkish
13,10, 집단적자위권/NNG,23,1.887635369801026,Hawkish
86,95, 지폐/NNG,181,1.3144667352460586,Hawkish
14,9, 채권시장/NNG;금리/NNG;인상/NNG;우려/NNG,23,2.258708989505501,Hawkish
15,16, 외국은행지점/NNG,31,1.3612755070680476,Hawkish
12,11, 학술회의/NNG,23,1.58402968095191,Hawkish
14,10, 금리/NNG;인상/NNG;불확실성/NNG;높/VA,24,2.032838090554951,Hawkish
36,35, fed/NNG;물가/NNG;부진/NNG,71,1.4935136991832296,Hawkish
57,62, 설전/NNG,119,1.3349282391893114,Hawkish
14,12, 견도/NNG,26,1.6940317421291258,Hawkish
23,18, 통화정책/NNG;완화/NNG;축소/NNG,41,1.855368098522376,Hawkish
11,10, 외국인/NNG;위험/NNG,21,1.5972299282931757,Hawkish
9,8, 외국인/NNG;국채선물/NNG;매도/NNG;상승/NNG,17,1.6335306084816572,Hawkish
13,4, 금리/NNG;인상/NNG;끝/VV;않/VX,17,4.719088424502566,Hawkish
15,16, 북한리스크/NNG;위험/NNG,31,1.3612755070680476,Hawkish
23,16, 지수/NNG;하향/NNG,39,2.087289110837673,Hawkish
80,88, 다자/NNG,168,1.3200247341265916,Hawkish
13,8, 미지급금/NNG,21,2.359544212251283,Hawkish
16,13, 가격/NNG;상향/NNG,29,1.7871104092790777,Hawkish
12,4, 금융시장/NNG;지정학/NNG;위험/NNG,16,4.356081622617753,Hawkish
21,5, 수출/NNG;높/VA;증가/NNG,26,6.098514271664853,Hawkish
11,8, 금리/NNG;인상/NNG;가능성/NNG;급등/NNG,19,1.9965374103664697,Hawkish
18,15, 응시자/NNG,33,1.742432649047101,Hawkish
9,9, 외채/NNG;감소/NNG,18,1.4520272075392509,Hawkish
22,13, 국민건강보험/NNG,35,2.457276812758732,Hawkish
10,11, 증익/NNG,21,1.3200247341265916,Hawkish
9,7, 격한/VV,16,1.866892123979037,Hawkish
20,19, 변액보증준비금/NNG,39,1.5284496921465798,Hawkish
26,19, 이자부자산/NNG,45,1.9869845997905538,Hawkish
27,30, 비급여/NNG,57,1.3068244867853256,Hawkish
66,20, 전입액/NNG,86,4.791689784879527,Hawkish
39,24, 영업비/NNG,63,2.3595442122512824,Hawkish
22,21, 자살보험금/NNG,43,1.5211713602792152,Hawkish
15,7, 위험/NNG;손해율/NNG;개선/NNG,22,3.1114868732983947,Hawkish
15,8, 실손/NNG;보험료/NNG;인하/NNG,23,2.722551014136095,Hawkish
15,5, 마진/NNG;증가/NNG,20,4.356081622617752,Hawkish
14,15, 인상/NNG;상승/NNG,29,1.3552253937033008,Hawkish
16,15, 냈었/VV,31,1.5488290213752007,Hawkish
61,54, 분배금/NNG,115,1.6402529566647093,Hawkish
20,17, 물가/NNG;경제/NNG;성장/NNG,37,1.7082673029873539,Hawkish
13,3, 호조/NNG;높/VA,16,6.292117899336753,Hawkish
26,23, 인플레이션/NNG;상승/NNG;압박/NNG,49,1.6414220606965444,Hawkish
9,9, 하락/NNG;가능성/NNG;제한적/VAX,18,1.4520272075392509,Hawkish
14,6, 수요/NNG;위축/NNG;우려/NNG,20,3.3880634842582515,Hawkish
23,1, 결증/NNG,24,33.39662577340277,Hawkish
65,72, 주식선물/NNG,137,1.3108578956951569,Hawkish
113,63, 학술/NNG,176,2.6044297532053227,Hawkish
53,39,스캔들/NNG,92,1.9732677435789818,Hawkish
9,9, 은행/NNG;금리/NNG;높/VV,18,1.4520272075392509,Hawkish
16,7, 왕좌/NNG,23,3.3189193315182877,Hawkish
46,49, 수락/NNG,95,1.363127582587868,Hawkish
43,28, 장교/NNG,71,2.2298989258638495,Hawkish
18,19, 서둘렀/VV,37,1.375604722931922,Hawkish
11,8, 가계/NNG;높/VA,19,1.9965374103664697,Hawkish
13,14, 중관/NNG,27,1.3483109784293044,Hawkish
19,19, 높/VA;물가/NNG;상승/NNG;압력/NNG,38,1.4520272075392509,Hawkish
38,31, 금리/NNG;인상/NNG;유보/NNG,69,1.7799043189190817,Hawkish
18,10, 세제개편안/NNG;불확실성/NNG,28,2.6136489735706516,Hawkish
33,18, 가점제/NNG,51,2.662049880488626,Hawkish
44,47, 약대/NNG,91,1.3593446198239796,Hawkish
58,51, 운용계획/NNG,109,1.651325059554442,Hawkish
10,8, 양시/NNG,18,1.8150340094240636,Hawkish
20,19, 리스료/NNG,39,1.5284496921465798,Hawkish
26,27, 투자유망종목/NNG,53,1.3982484220748341,Hawkish
18,15, 위중/NNG,33,1.742432649047101,Hawkish
60,48, 선진국/NNG;금리/NNG;인상/NNG,108,1.8150340094240633,Hawkish
10,6, 경제/NNG;성장률/NNG;안정/NNG,16,2.420045345898751,Hawkish
13,9, 투자금액/NNG;증가/NNG,22,2.097372633112251,Hawkish
24,19, 근육/NNG,43,1.834139630575896,Hawkish
13,8, 고보/NNG,21,2.359544212251283,Hawkish
18,15, 대출/NNG;증가/NNG;억제/NNG,33,1.742432649047101,Hawkish
23,16, 피어나/VV,39,2.087289110837673,Hawkish
24,24, 행중/NNG,48,1.4520272075392509,Hawkish
19,16, 경제/NNG;성장률/NNG;성장/NNG,35,1.7242823089528605,Hawkish
13,8, 기업/NNG;생산성/NNG;향상/NNG,21,2.359544212251283,Hawkish
15,14, 건설/NNG;투자/NNG;둔화/NNG,29,1.5557434366491973,Hawkish
33,33, 이자/NNG;부담/NNG;증가/NNG,66,1.4520272075392506,Hawkish
17,9, 완화정책/NNG;반대/NNG,26,2.7427180586852518,Hawkish
9,7, 완화정책/NNG;벗어나/VV,16,1.866892123979037,Hawkish
19,13, 지급보험금/NNG,32,2.122193611018905,Hawkish
20,15, 신계약비/NNG,35,1.936036276719001,Hawkish
42,37, 연납/NNG,79,1.6482471004499601,Hawkish
97,60, 수해/NNG,157,2.347443985521789,Hawkish
9,7, 순이익/NNG;하회/NNG,16,1.866892123979037,Hawkish
11,7, 이자/NNG;인상/NNG,18,2.2817570404188228,Hawkish
20,22, 어렵/VA;위험/NNG,42,1.3200247341265916,Hawkish
32,35, 가계/NNG;부채/NNG;금리/NNG;인상/NNG,67,1.327567732607315,Hawkish
28,8, 커머스/NNG,36,5.082095226387378,Hawkish
14,12, 인플레이션/NNG;압력/NNG;제한적/VAX,26,1.6940317421291258,Hawkish
12,5, 가격/NNG;금리/NNG;상승/NNG,17,3.484865298094202,Hawkish
15,9, 소매유통업/NNG,24,2.420045345898751,Hawkish
10,11, 비용/NNG;증가/NNG;우려/NNG,21,1.3200247341265916,Hawkish
434,403, 근모/NNG,837,1.5637216081191934,Hawkish
420,384, 발표문/NNG,804,1.5881547582460553,Hawkish
23,6, 중한/NNG,29,5.566104295567127,Hawkish
51,54,투자자문/NNG,105,1.3713590293426257,Hawkish
30,30, 인플레이션/NNG;압력/NNG;억제/NNG,60,1.4520272075392506,Hawkish
83,83, 원년/NNG,166,1.4520272075392506,Hawkish
30,31, 기울인/VV,61,1.405187620199275,Hawkish
9,8,공통점/NNG,17,1.6335306084816572,Hawkish
125,137,적립식/NNG,262,1.324842342645302,Hawkish
18,14,급락장/NNG,32,1.866892123979037,Hawkish
126,137,주식형/NNG,263,1.3354410813864643,Hawkish
271,260, 성장형/NNG,531,1.5134591278582192,Hawkish
56,48, 장형/NNG,104,1.6940317421291258,Hawkish
125,124,설정액/NNG,249,1.4637371043742449,Hawkish
311,338, 블루칩/NNG,649,1.3360368684754644,Hawkish
56,51, 대투/NNG,107,1.59438281612153,Hawkish
9,10, 방긋/MAG,19,1.3068244867853258,Hawkish
97,91, 지표채권/NNG,188,1.5477652651792015,Hawkish
19,13, 총수탁고/NNG,32,2.122193611018905,Hawkish
29,29, 과밀억제권역/NNG,58,1.4520272075392509,Hawkish
12,4, 금리/NNG;지나치/VA;떨어/VV,16,4.356081622617753,Hawkish
611,640,장외시장/NNG,1251,1.3862322246976284,Hawkish
404,438,장내시장/NNG,842,1.3393127667713638,Hawkish
20,18, 경제/NNG;견고/NNG;성장/NNG,38,1.6133635639325008,Hawkish
96,97,매물/NNG,193,1.4370578548842072,Hawkish
9,10, 대반/NNG,19,1.3068244867853258,Hawkish
370,360, 6자회담/NNG,730,1.4923612966375635,Hawkish
9,7, 이익/NNG;전망/NNG;밝/VA,16,1.866892123979037,Hawkish
12,11, 호황/NNG;불황/NNG,23,1.58402968095191,Hawkish
44,21, 황소/NNG,65,3.0423427205584304,Hawkish
20,22,전망보고서/NNG,42,1.3200247341265916,Hawkish
141,133,핵/NNG,274,1.5393671899476267,Hawkish
76,65,고준/NNG,141,1.6977548888151242,Hawkish
59,47, 교차판매/NNG,106,1.8227575584003362,Hawkish
35,28,주가지수연동/NNG,63,1.8150340094240638,Hawkish
16,16, 고유가/NNG;금리/NNG;인상/NNG,32,1.4520272075392506,Hawkish
11,11, 다로/NNG,22,1.4520272075392509,Hawkish
16,10, 유가/NNG;금리/NNG;인상/NNG,26,2.323243532062801,Hawkish
14,8, 기업/NNG;실적/NNG;향상/NNG,22,2.541047613193689,Hawkish
34,29, 교대/NNG,63,1.7023767260805012,Hawkish
22,20, 로저/NNG,42,1.5972299282931757,Hawkish
22,17,오일머니/NNG,39,1.879094033286089,Hawkish
18,16,프라이빗뱅킹/NNG,34,1.6335306084816572,Hawkish
13,7, 샤리아/NNG,20,2.6966219568586087,Hawkish
11,8, 금하/VV,19,1.9965374103664697,Hawkish
13,12, 길들이/VV,25,1.5730294748341882,Hawkish
118,129,트인/VV,247,1.3282109340281518,Hawkish
97,94, 유료뉴스/NNG,191,1.4983685013968866,Hawkish
87,76, 유료뉴스/NNG;시장/NNG;플러스/NNG,163,1.6621890402094055,Hawkish
14,14, 전망/NNG;시장/NNG;플러스/NNG,28,1.4520272075392509,Hawkish
45,29,경과물/NNG,74,2.253145666871251,Hawkish
58,60,건설교통부/NNG,118,1.4036263006212757,Hawkish
11,6, 소폭/MAG;적자/NNG,17,2.662049880488626,Hawkish
49,37, 토지시장/NNG,86,1.9229549505249537,Hawkish
10,7, 거시/NNG;통제/NNG,17,2.07432458219893,Hawkish
155,169,긴축정책/NNG,324,1.3317409299916205,Hawkish
16,13, 연감/NNG,29,1.7871104092790777,Hawkish
16,15, 친목/NNG,31,1.5488290213752007,Hawkish
9,10, 금융시스템/NNG;불안정/NNG,19,1.3068244867853258,Hawkish
21,8,고정환율제/NNG,29,3.8115714197905333,Hawkish
24,23, 절상/NNG;우려/NNG,47,1.5151588252583488,Hawkish
20,18,어소/NNG,38,1.6133635639325008,Hawkish
19,18, 가격/NNG;압력/NNG,37,1.5326953857358758,Hawkish
17,15, 빗댄/VV,32,1.645630835211151,Hawkish
13,13,수수께끼/NNG,26,1.4520272075392509,Hawkish
23,18, 금리/NNG;인상/NNG;공포/NNG,41,1.855368098522376,Hawkish
54,57, 건설교통부/NNG,111,1.3756047229319217,Hawkish
49,53,필라델피아반도체지수/NNG,102,1.342440248479685,Hawkish
15,15, 소환장/NNG,30,1.4520272075392506,Hawkish
18,15, 링컨/NNG,33,1.742432649047101,Hawkish
207,134, fed/NNG;금리/NNG;인상/NNG;중단/NNG,341,2.2430569549300365,Hawkish
26,26, 경영지표/NNG,52,1.4520272075392509,Hawkish
52,51, 미간/NNG,103,1.4804983292557066,Hawkish
13,10,제일/NNG,23,1.887635369801026,Hawkish
29,32,텍/NNG,61,1.315899656832446,Hawkish
39,42,스틸/NNG,81,1.3483109784293044,Hawkish
34,37, 강건/NNG,71,1.3342952717928251,Hawkish
12,8, 주동력/NNG,20,2.1780408113088763,Hawkish
48,52,동일점/NNG,100,1.3403328069593086,Hawkish
80,83,노동당/NNG,163,1.3995442964233742,Hawkish
20,12, 지수선물/NNG;하락/NNG,32,2.420045345898751,Hawkish
28,31,기다리/VV,59,1.3115084455193233,Hawkish
29,30, 간절/NNG,59,1.4036263006212757,Hawkish
16,15, 금리/NNG;인상/NNG;우려/NNG;덜/VV,31,1.5488290213752007,Hawkish
215,162,미사일/NNG,377,1.9270731458082648,Hawkish
15,11,까다롭/VA,26,1.9800371011898874,Hawkish
131,125,암로/NNG,256,1.5217245135011348,Hawkish
16,16, 뽑힌/VV,32,1.4520272075392506,Hawkish
22,22, 지표/NNG;금리/NNG;국고채/NNG;수익률/NNG;하락/NNG,44,1.4520272075392509,Hawkish
42,43,이월/NNG,85,1.4182591329453147,Hawkish
26,17, 지수연동/NNG,43,2.22074749388356,Hawkish
28,23,증권예탁결제원/NNG,51,1.76768529613474,Hawkish
15,8, 일시적/VAX;침체/NNG,23,2.722551014136095,Hawkish
11,7, 절상/NNG;환율/NNG;하락/NNG,18,2.2817570404188228,Hawkish
8,8, 북한리스크/NNG;불확실성/NNG,16,1.4520272075392506,Hawkish
30,26, 채권/NNG;금리/NNG;소폭/MAG;오르/VV,56,1.6754160086991354,Hawkish
10,6, 주무르/VV,16,2.420045345898751,Hawkish
12,13, 잦아졌/VV,25,1.3403328069593086,Hawkish
11,9,충당금적립전/NNG,20,1.774699920325751,Hawkish
29,31, 이자부문이익/NNG,60,1.3583480328592992,Hawkish
57,51,한/NNG,108,1.622853937837986,Hawkish
45,44, 상위권/NNG,89,1.4850278258924157,Hawkish
585,526,종금/NNG,1111,1.6148971794875697,Hawkish
1599,1136,콜/NNG,2735,2.043830550048646,Hawkish
12,8, fed/NNG;물가/NNG;압력/NNG,20,2.1780408113088763,Hawkish
14,10, 세계/NNG;경기/NNG;호조/NNG,24,2.032838090554951,Hawkish
10,10, 옮아갈/VV,20,1.4520272075392509,Hawkish
12,13,쌍둥이적자/NNG,25,1.3403328069593086,Hawkish
11,10, 지표/NNG;금리/NNG;국고채/NNG;수익률/NNG;상승/NNG,21,1.5972299282931757,Hawkish
35,38, 양해/NNG,73,1.3373934806282575,Hawkish
28,31,자주/MAG,59,1.3115084455193233,Hawkish
10,7, 산중/NNG,17,2.07432458219893,Hawkish
26,24, 국고채/NNG;수익률/NNG;떨어/VV,50,1.5730294748341882,Hawkish
166,116,북핵/NNG,282,2.077901003892376,Hawkish
14,6, 금리/NNG;아직/MAG;낮/VA,20,3.3880634842582515,Hawkish
10,11, 금리/NNG;인상/NNG;둔화/NNG,21,1.3200247341265916,Hawkish
15,10,노던/NNG,25,2.178040811308876,Hawkish
229,244,목표가격/NNG,473,1.3627632398626577,Hawkish
77,70, v자형/NNG,147,1.597229928293176,Hawkish
21,14, v자형/NNG;회복/NNG,35,2.1780408113088763,Hawkish
16,12, 태권/NNG,28,1.9360362767190007,Hawkish
16,15, 다림/NNG,31,1.5488290213752007,Hawkish
30,15,미간/NNG,45,2.9040544150785013,Hawkish
13,12, 일시적/VAX;급락/NNG,25,1.5730294748341882,Hawkish
15,12, 높/VA;위안/NNG;절상/NNG,27,1.8150340094240633,Hawkish
14,15, 정밀도/NNG,29,1.3552253937033008,Hawkish
19,14, 픽쳐/NNG,33,1.9706083530889835,Hawkish
23,16, 튜브/NNG,39,2.087289110837673,Hawkish
119,116, 본토기업/NNG,235,1.4895796353204382,Hawkish
47,46, 불복/NNG,93,1.4835930163987996,Hawkish
15,12, 화간/NNG,27,1.8150340094240633,Hawkish
11,8,연관/NNG,19,1.9965374103664697,Hawkish
25,23,혼/NNG,48,1.5782904429774465,Hawkish
28,19,가솔린/NNG,47,2.1398295690052116,Hawkish
22,24, 신/VV,46,1.331024940244313,Hawkish
9,8,공개매수/NNG,17,1.6335306084816572,Hawkish
21,23, 제조회사/NNG,44,1.325763972101055,Hawkish
13,10,거물/NNG,23,1.887635369801026,Hawkish
51,53, 상승률/NNG;넘/VV,104,1.397233728009468,Hawkish
75,51,발표문/NNG,126,2.1353341287341925,Hawkish
12,10,바통/NNG,22,1.742432649047101,Hawkish
9,10, 인상/NNG;확대/NNG,19,1.3068244867853258,Hawkish
49,42, 경기/NNG;과열/NNG;억제/NNG,91,1.694031742129126,Hawkish
96,98, 양봉/NNG,194,1.4223939992221233,Hawkish
28,25,액정/NNG,53,1.626270472443961,Hawkish
11,11, 일어섰/VV,22,1.4520272075392509,Hawkish
71,48,메이저/NNG,119,2.147790244485142,Hawkish
21,16, 끈기/NNG,37,1.9057857098952666,Hawkish
18,18, 드리워졌/VV,36,1.4520272075392509,Hawkish
9,8, 서비스업/NNG;생산/NNG;늘/VV,17,1.6335306084816572,Hawkish
12,9, 연기금펀드/NNG,21,1.9360362767190011,Hawkish
35,38,보고/NNG,73,1.3373934806282575,Hawkish
83,86,고정자산/NNG,169,1.4013750956483466,Hawkish
13,10,지부/NNG,23,1.887635369801026,Hawkish
15,11, 인플레이션/NNG;전망/NNG;낮/VA,26,1.9800371011898874,Hawkish
32,25, 토해/VV,57,1.858594825650241,Hawkish
10,9, 엊그제/NNG,19,1.6133635639325008,Hawkish
11,7,청화/NNG,18,2.2817570404188228,Hawkish
27,26, 난야/NNG,53,1.5078744078292219,Hawkish
15,13, 기대/NNG;높/VA;오르/VV,28,1.6754160086991354,Hawkish
31,17,블/NNG,48,2.6478143196303985,Hawkish
70,77, 테이프/NNG,147,1.3200247341265916,Hawkish
47,46, 수거/NNG,93,1.4835930163987996,Hawkish
21,19, 커트/NNG,40,1.604872176753909,Hawkish
10,7, 버너/NNG,17,2.07432458219893,Hawkish
17,18,베리/NNG,35,1.3713590293426259,Hawkish
173,139, 콜/NNG;금리/NNG;오르/VV,312,1.8071993302466933,Hawkish
31,32, 회고록/NNG,63,1.4066513573036492,Hawkish
50,42, 세무서/NNG,92,1.7286038184991082,Hawkish
12,8, 연두/NNG,20,2.1780408113088763,Hawkish
14,14, 승낙/NNG,28,1.4520272075392509,Hawkish
68,66, 브리지/NNG,134,1.4960280320101373,Hawkish
9,8,불신/NNG,17,1.6335306084816572,Hawkish
13,8,회고록/NNG,21,2.359544212251283,Hawkish
27,30, 패널티/NNG,57,1.3068244867853256,Hawkish
97,91, 시판/NNG,188,1.5477652651792015,Hawkish
9,9, 채권/NNG;금리/NNG;소폭/MAG;내리/VV,18,1.4520272075392509,Hawkish
20,5, 통안채/NNG;입찰/NNG;부담/NNG,25,5.808108830157003,Hawkish
21,11,특약/NNG,32,2.7720519416658425,Hawkish
23,25, fed/NNG;인플레이션/NNG;억제/NNG,48,1.3358650309361106,Hawkish
13,13, 산업/NNG;오르/VV,26,1.4520272075392509,Hawkish
43,45, 불꽃/NNG,88,1.3874926649819508,Hawkish
23,25,고평가/NNG,48,1.3358650309361106,Hawkish
19,15,의존도/NNG,34,1.839234462883051,Hawkish
9,9,혼/VV,18,1.4520272075392509,Hawkish
11,9,뒷걸음질/NNG,20,1.774699920325751,Hawkish
56,52, 만든다고/VV,108,1.5637216081191931,Hawkish
15,10, 해외/NNG;수요/NNG;증가/NNG,25,2.178040811308876,Hawkish
14,7, 수출/NNG;강세/NNG,21,2.9040544150785017,Hawkish
9,9,증권투자신탁/NNG,18,1.4520272075392509,Hawkish
22,14, 동시분양/NNG,36,2.2817570404188228,Hawkish
154,115, 청약통장/NNG,269,1.9444538257482142,Hawkish
20,19, 국고채/NNG;뛰/VV,39,1.5284496921465798,Hawkish
19,19, 섣불/MAG;금리/NNG;오르/VV,38,1.4520272075392509,Hawkish
44,35,승선/NNG,79,1.825405632335058,Hawkish
24,17,이환/NNG,41,2.0499207635848244,Hawkish
13,9, 전합니다/VV,22,2.097372633112251,Hawkish
51,55,반응/NNG,106,1.3464252288091234,Hawkish
28,30, 노숙/NNG,58,1.3552253937033008,Hawkish
42,46, 성금/NNG,88,1.325763972101055,Hawkish
29,18, 대손충당금/NNG;감소/NNG,47,2.3393771677021262,Hawkish
19,5, 선진금융기법/NNG,24,5.517703388649153,Hawkish
45,39, 예대마진/NNG;확대/NNG,84,1.6754160086991354,Hawkish
10,6, 종합통장대출/NNG,16,2.420045345898751,Hawkish
16,15, 첨/NNG,31,1.5488290213752007,Hawkish
15,14,변동환율제/NNG,29,1.5557434366491973,Hawkish
14,15, 외환보유액/NNG;급증/NNG,29,1.3552253937033008,Hawkish
12,8, 산유국/NNG;원유/NNG;감산/NNG,20,2.1780408113088763,Hawkish
10,10,가난/NNG,20,1.4520272075392509,Hawkish
12,9, 국제/NNG;수지/NNG;개선/NNG,21,1.9360362767190011,Hawkish
27,30, 지표/NNG;금리/NNG;국고채/NNG;수익률/NNG;오르/VV,57,1.3068244867853256,Hawkish
313,336, 株/NNG,649,1.352632487975552,Hawkish
17,17, 세계/NNG;금리/NNG;상승/NNG,34,1.4520272075392509,Hawkish
9,7, 회복/NNG;확산/NNG,16,1.866892123979037,Hawkish
13,8, 부풀려져/VV,21,2.359544212251283,Hawkish
21,17, 지표/NNG;금리/NNG;국고채/NNG;수익률/NNG;낮/VA,38,1.7936806681367214,Hawkish
30,33, 사놓/VV,63,1.3200247341265916,Hawkish
13,9, 노이/NNG,22,2.097372633112251,Hawkish
9,9, 죈/VV,18,1.4520272075392509,Hawkish
34,34, 만주/NNG,68,1.4520272075392509,Hawkish
18,11, 물가/NNG;압력/NNG;크/VV,29,2.376044521427865,Hawkish
20,15, 발칵/MAG,35,1.936036276719001,Hawkish
11,9, 회합/NNG,20,1.774699920325751,Hawkish
193,214,칼럼니스트/NNG,407,1.309538556332128,Hawkish
10,9, 절상/NNG;가능성/NNG;높/VA,19,1.6133635639325008,Hawkish
13,8, 유동성/NNG;경기/NNG;회복/NNG,21,2.359544212251283,Hawkish
141,153, 콜/NNG;금리/NNG;인하/NNG,294,1.338142720673427,Hawkish
20,10,미주/NNG,30,2.9040544150785017,Hawkish
24,20, 잠재/NNG;성장률/NNG;웃돌/VV,44,1.742432649047101,Hawkish
9,10, 성장/NNG;저조/NNG,19,1.3068244867853258,Hawkish
19,18, 조인식/NNG,37,1.5326953857358758,Hawkish
35,32, 부동산/NNG;투기/NNG;억제/NNG,67,1.5881547582460558,Hawkish
51,55,델/VV,106,1.3464252288091234,Hawkish
12,13, 연구비/NNG,25,1.3403328069593086,Hawkish
23,19,경쟁업체/NNG,42,1.7577171459685668,Hawkish
355,371,옵션/NNG,726,1.3894060880766415,Hawkish
18,15,그저/MAG,33,1.742432649047101,Hawkish
22,17, 공급처/NNG,39,1.879094033286089,Hawkish
23,17, 통신부/NNG,40,1.9645073984354566,Hawkish
22,22, 국제원자력기구/NNG,44,1.4520272075392509,Hawkish
93,102, 사찰/NNG,195,1.323907159815199,Hawkish
13,14,함성/NNG,27,1.3483109784293044,Hawkish
32,35, 땅값/NNG;상승/NNG,67,1.327567732607315,Hawkish
21,18, 중개시장/NNG,39,1.6940317421291258,Hawkish
13,8, 부단/NNG,21,2.359544212251283,Hawkish
25,24, 이자손실/NNG,49,1.5125283411867194,Hawkish
9,8, 가렸/VV,17,1.6335306084816572,Hawkish
28,30,재경/NNG,58,1.3552253937033008,Hawkish
30,27, 건설/NNG;경기/NNG;활성화/NNG,57,1.6133635639325008,Hawkish
9,10, 기반시설부담금제/NNG,19,1.3068244867853258,Hawkish
24,18,국민경제자문회의/NNG,42,1.9360362767190011,Hawkish
26,24,경제자유구역/NNG,50,1.5730294748341882,Hawkish
46,50, 경관/NNG,96,1.3358650309361106,Hawkish
204,193, 간접투자/NNG,397,1.5347852349119542,Hawkish
62,40, 기업도시/NNG,102,2.250642171685839,Hawkish
86,88, 주택담보대출/NNG;금리/NNG;오르/VV,174,1.419026589186086,Hawkish
31,32, 대충/MAG,63,1.4066513573036492,Hawkish
28,17, 금리/NNG;콜/NNG;금리/NNG;인상/NNG,45,2.3915742241822953,Hawkish
19,18, 행정규제/NNG,37,1.5326953857358758,Hawkish
9,8, 내수/NNG;지표/NNG;회복/NNG,17,1.6335306084816572,Hawkish
13,14, 투기/NNG;막/VV,27,1.3483109784293044,Hawkish
18,15, 환시채/NNG,33,1.742432649047101,Hawkish
14,14,부통령/NNG,28,1.4520272075392509,Hawkish
30,33,결코/MAG,63,1.3200247341265916,Hawkish
15,16, 수입/NNG;부담/NNG,31,1.3612755070680476,Hawkish
13,7, 환경단체/NNG,20,2.6966219568586087,Hawkish
21,15, 내달렸/VV,36,2.032838090554951,Hawkish
10,7, 재환/NNG,17,2.07432458219893,Hawkish
18,14,로드쇼/NNG,32,1.866892123979037,Hawkish
10,11, 무역/NNG;적자/NNG;개선/NNG,21,1.3200247341265916,Hawkish
33,31,부동산중개업/NNG,64,1.5457063822192025,Hawkish
12,12, 고용창출/NNG;부진/NNG,24,1.4520272075392509,Hawkish
27,23, 원화/NNG;고평가/NNG,50,1.7045536784156423,Hawkish
9,7, 취업자/NNG;줄/VV,16,1.866892123979037,Hawkish
18,18, 소비/NNG;많/VA,36,1.4520272075392509,Hawkish
27,27, 기업/NNG;채산성/NNG;악화/NNG,54,1.4520272075392506,Hawkish
9,7, 경상/NNG;수지/NNG;확대/NNG,16,1.866892123979037,Hawkish
11,12, 준다면서/VV,23,1.331024940244313,Hawkish
10,8, 꺼림칙/NNG,18,1.8150340094240636,Hawkish
13,8, 휘둘렸/VV,21,2.359544212251283,Hawkish
9,8, 지수/NNG;지지부진/NNG,17,1.6335306084816572,Hawkish
25,27,재개/NNG,52,1.3444696366104174,Hawkish
62,67,헤드라인/NNG,129,1.3436669681706501,Hawkish
30,22,안정형/NNG,52,1.9800371011898874,Hawkish
25,19,의사결정/NNG,44,1.9105621151832248,Hawkish
23,25, 연락처/NNG,48,1.3358650309361106,Hawkish
11,11, 해독/NNG,22,1.4520272075392509,Hawkish
34,30, 귄/NNG,64,1.645630835211151,Hawkish
9,10, 투기등급/NNG;추락/NNG,19,1.3068244867853258,Hawkish
10,7, 반짝/MAG;상승/NNG;그치/VV,17,2.07432458219893,Hawkish
12,5,절/NNG,17,3.484865298094202,Hawkish
131,141, 경제/NNG;지표/NNG;호전/NNG,272,1.3490465545222827,Hawkish
31,29, 양도성/NNG,60,1.552167014955751,Hawkish
69,63,시간외거래/NNG,132,1.5903155130191795,Hawkish
23,23, 부닥칠/VV,46,1.4520272075392506,Hawkish
18,16,타행/NNG,34,1.6335306084816572,Hawkish
26,25, 유방암/NNG,51,1.510108295840821,Hawkish
9,7, 자궁암/NNG,16,1.866892123979037,Hawkish
9,10, 어렵/VA;밖/NNG;없/VA,19,1.3068244867853258,Hawkish
28,25, 유혈/NNG,53,1.626270472443961,Hawkish
100,94, 시위대/NNG,194,1.5447097952545223,Hawkish
13,5, 여관/NNG,18,3.775270739602052,Hawkish
23,25, 성의/NNG,48,1.3358650309361106,Hawkish
312,322, 李/NNG,634,1.4069331948827524,Hawkish
153,147, 열린우리당/NNG,300,1.5112936241735058,Hawkish
158,141, 학년도/NNG,299,1.6270943176680965,Hawkish
35,34, 康/NNG,69,1.4947338901139346,Hawkish
10,10, 奉/NNG,20,1.4520272075392509,Hawkish
14,12, 골절/NNG,26,1.6940317421291258,Hawkish
19,18, 태운/VV,37,1.5326953857358758,Hawkish
61,63, 원당/NNG,124,1.405931105712608,Hawkish
17,18, 납품/NNG;가격/NNG;인하/NNG,35,1.3713590293426259,Hawkish
9,7, 윈윈전략/NNG,16,1.866892123979037,Hawkish
22,24, 품질향상/NNG,46,1.331024940244313,Hawkish
16,12,만드/VV,28,1.9360362767190007,Hawkish
34,22, 전자입찰/NNG,56,2.244042048015206,Hawkish
42,29,벤처기업/NNG,71,2.102935955746501,Hawkish
30,33,대금/NNG,63,1.3200247341265916,Hawkish
20,18, 자금/NNG;부담/NNG;덜/VV,38,1.6133635639325008,Hawkish
14,12, 노무비/NNG,26,1.6940317421291258,Hawkish
65,72, 부동산중개업/NNG,137,1.3108578956951569,Hawkish
12,11,내수기업/NNG,23,1.58402968095191,Hawkish
44,43,영업이익률/NNG,87,1.4857952821331868,Hawkish
12,7, 자산/NNG;가격/NNG;불안/NNG,19,2.489189498638716,Hawkish
26,25,장기주택마련저축/NNG,51,1.510108295840821,Hawkish
11,12, 하락/NNG;증시/NNG;하락/NNG,23,1.331024940244313,Hawkish
15,12, 수출/NNG;악재/NNG,27,1.8150340094240633,Hawkish
16,13,익숙/NNG,29,1.7871104092790777,Hawkish
12,12, 재채기/NNG,24,1.4520272075392509,Hawkish
32,34,적극/NNG,66,1.3666138423898828,Hawkish
43,48, 실속/NNG,91,1.3007743734205788,Hawkish
11,10, 미신고/NNG,21,1.5972299282931757,Hawkish
95,102,과열/NNG,197,1.3523782815316552,Hawkish
15,12, 낙관/NNG;아니/VCN,27,1.8150340094240633,Hawkish
29,27, 땅값/NNG;오르/VV,56,1.559584778468084,Hawkish
9,7,꺼내/VV,16,1.866892123979037,Hawkish
36,39, gdp/NNG;상승/NNG,75,1.3403328069593086,Hawkish
8,8, 실적/NNG;위축/NNG,16,1.4520272075392506,Hawkish
13,6, 세계/NNG;최대/NNG;하락/NNG,19,3.1460589496683764,Hawkish
20,21, 높/VA;경고/NNG,41,1.3828830547992865,Hawkish
27,30, 뒷심부족/NNG,57,1.3068244867853256,Hawkish
10,9, 유가/NNG;강하/VA,19,1.6133635639325008,Hawkish
17,18, 더프/NNG,35,1.3713590293426259,Hawkish
27,23,세금환급/NNG,50,1.7045536784156423,Hawkish
28,31, 대출/NNG;최저/NNG,59,1.3115084455193233,Hawkish
18,12, 감격/NNG,30,2.1780408113088763,Hawkish
11,10, 새기/VV,21,1.5972299282931757,Hawkish
36,24, 풍년/NNG,60,2.1780408113088763,Hawkish
25,27, 비틀거리/VV,52,1.3444696366104174,Hawkish
9,10, 채권펀드/NNG;금리/NNG;상승/NNG,19,1.3068244867853258,Hawkish
36,16, 검사국/NNG,52,3.2670612169633144,Hawkish
44,49, 과열경쟁/NNG,93,1.3038611659536128,Hawkish
10,11, 불러냈/VV,21,1.3200247341265916,Hawkish
10,10, 강공/NNG,20,1.4520272075392509,Hawkish
80,68, 암로/NNG,148,1.7082673029873539,Hawkish
18,20,제정/NNG,38,1.3068244867853258,Hawkish
18,17, 약시/NNG,35,1.5374405726886184,Hawkish
17,12,연환산/NNG,29,2.0570385440139387,Hawkish
28,18, 인플레이션/NNG;위험/NNG;높/VA,46,2.258708989505501,Hawkish
11,8, 수출/NNG;무역/NNG;흑자/NNG,19,1.9965374103664697,Hawkish
11,10,노출/NNG,21,1.5972299282931757,Hawkish
34,36,종일/NNG,70,1.3713590293426259,Hawkish
38,34,비하/VV,72,1.622853937837986,Hawkish
10,10, 낮/VA;인플레이션/NNG;위험/NNG,20,1.4520272075392509,Hawkish
18,20,아버지/NNG,38,1.3068244867853258,Hawkish
105,98, 아버지/NNG,203,1.5557434366491973,Hawkish
11,10, 급감/NNG;그치/VV,21,1.5972299282931757,Hawkish
9,10, 쾨/NNG,19,1.3068244867853258,Hawkish
10,11,제철/NNG,21,1.3200247341265916,Hawkish
25,23,단기성/NNG,48,1.5782904429774465,Hawkish
11,9, 국고채/NNG;떨어/VV;국고채/NNG;떨어/VV,20,1.774699920325751,Hawkish
19,18, 인플레이션/NNG;우려/NNG;덜/VV,37,1.5326953857358758,Hawkish
13,13, 구매력/NNG;저하/NNG,26,1.4520272075392509,Hawkish
12,13, 세계/NNG;최대/NNG;업체/NNG;하락/NNG,25,1.3403328069593086,Hawkish
26,16, 은행/NNG;대출/NNG;억제/NNG,42,2.359544212251283,Hawkish
8,8, 높/VA;수출/NNG;증가/NNG,16,1.4520272075392506,Hawkish
62,44, 매물대/NNG,106,2.046038337896217,Hawkish
23,18,프로그램차익거래/NNG,41,1.855368098522376,Hawkish
35,26, 간접투자시장/NNG,61,1.9546520101489917,Hawkish
19,12,전용상품/NNG,31,2.299043078603814,Hawkish
15,15, 비과세저축/NNG,30,1.4520272075392506,Hawkish
18,16, 맬/VV,34,1.6335306084816572,Hawkish
16,15, gdp/NNG;성장률/NNG;증가/NNG,31,1.5488290213752007,Hawkish
43,43, 경기/NNG;지표/NNG;호전/NNG,86,1.4520272075392506,Hawkish
26,28,순수출/NNG,54,1.3483109784293044,Hawkish
19,16, gdp/NNG;상향/NNG,35,1.7242823089528605,Hawkish
43,33,폭발/NNG,76,1.8920354522481146,Hawkish
28,29, 베이시스/NNG;악화/NNG,57,1.4019573038310007,Hawkish
18,14, 문제지/NNG,32,1.866892123979037,Hawkish
11,12,이타/NNG,23,1.331024940244313,Hawkish
20,21, 연체/NNG;늘/VV,41,1.3828830547992865,Hawkish
79,82, 미/NNG;무역/NNG;적자/NNG,161,1.3989042609219613,Hawkish
19,9, 위험/NNG;오르/VV,28,3.0653907714717517,Hawkish
14,5, 듬뿍/MAG,19,4.065676181109902,Hawkish
11,11,열풍/NNG,22,1.4520272075392509,Hawkish
26,28, 거느린/VV,54,1.3483109784293044,Hawkish
15,7,토지시장/NNG,22,3.1114868732983947,Hawkish
13,12, 든든히/MAG,25,1.5730294748341882,Hawkish
13,10, 경제/NNG;인플레이션/NNG;우려/NNG,23,1.887635369801026,Hawkish
63,57,프라임/NNG,120,1.6048721767539087,Hawkish
35,25, 道/NNG,60,2.0328380905549515,Hawkish
11,11,유통금리/NNG,22,1.4520272075392509,Hawkish
20,22, 박스권장/NNG,42,1.3200247341265916,Hawkish
23,19,조휘/NNG,42,1.7577171459685668,Hawkish
32,35,서둘/VV,67,1.327567732607315,Hawkish
8,8, 가계/NNG;타격/NNG,16,1.4520272075392506,Hawkish
23,23,초순/NNG,46,1.4520272075392506,Hawkish
14,14, 냉방/NNG,28,1.4520272075392509,Hawkish
16,10, 지표/NNG;금리/NNG;국고채/NNG;수익률/NNG;내리/VV,26,2.323243532062801,Hawkish
36,32,영복/NNG,68,1.6335306084816572,Hawkish
15,8, 차입/NNG;비용/NNG;증가/NNG,23,2.722551014136095,Hawkish
18,6, 승전/NNG,24,4.356081622617753,Hawkish
49,54,간부/NNG,103,1.3175802438782092,Hawkish
21,20, 주택담보대출/NNG;위험/NNG,41,1.5246285679162133,Hawkish
27,21,욱/NNG,48,1.8668921239790368,Hawkish
91,78,예보/NNG,169,1.6940317421291258,Hawkish
9,8,부보/NNG,17,1.6335306084816572,Hawkish
28,27, 계년/NNG,55,1.5058059930036674,Hawkish
11,12, 런던금시장/NNG,23,1.331024940244313,Hawkish
13,11, 매매손실/NNG,24,1.7160321543645694,Hawkish
10,11,예산편성/NNG,21,1.3200247341265916,Hawkish
66,57, 집어넣/VV,123,1.6812946613612376,Hawkish
9,7, 탔으나/VV,16,1.866892123979037,Hawkish
22,23, 코리안페이퍼/NNG,45,1.388895589820153,Hawkish
15,16, 채권/NNG;수익률/NNG;낮/VA,31,1.3612755070680476,Hawkish
88,96, 盧/NNG,184,1.331024940244313,Hawkish
18,19, 평론가/NNG,37,1.375604722931922,Hawkish
19,12, 가격/NNG;상승/NNG;막/VV,31,2.299043078603814,Hawkish
82,90,신용카드사/NNG,172,1.3229581224246507,Hawkish
15,14, 떠들/VV,29,1.5557434366491973,Hawkish
11,12, 호시탐탐/NNG,23,1.331024940244313,Hawkish
11,10, 이평선/NNG;하향/NNG;이탈/NNG,21,1.5972299282931757,Hawkish
12,5, 전통주/NNG,17,3.484865298094202,Hawkish
11,9, 외환시장/NNG;개입/NNG;자제/NNG,20,1.774699920325751,Hawkish
11,9, 기환/NNG,20,1.774699920325751,Hawkish
12,9, 송심/NNG,21,1.9360362767190011,Hawkish
186,182, 가나다순/NNG,368,1.4839398934192343,Hawkish
10,7, 무주군/NNG,17,2.07432458219893,Hawkish
84,81, 社/NNG,165,1.5058059930036676,Hawkish
14,11, oecd/NNG;성장/NNG,25,1.8480346277772284,Hawkish
8,8, 집념/NNG,16,1.4520272075392506,Hawkish
11,11, 피워/VV,22,1.4520272075392509,Hawkish
19,18,적당/NNG,37,1.5326953857358758,Hawkish
36,35, 수모/NNG,71,1.4935136991832296,Hawkish
71,75,운송/NNG,146,1.3745857564704909,Hawkish
18,18, 슬럼프/NNG,36,1.4520272075392509,Hawkish
46,44,프리/NNG,90,1.5180284442455803,Hawkish
13,10,귄/NNG,23,1.887635369801026,Hawkish
27,11, 부양책/NNG;제거/NNG,38,3.5640667821417975,Hawkish
47,52,기념/NNG,99,1.3124092068143227,Hawkish
18,11, 인상/NNG;중단/NNG,29,2.376044521427865,Hawkish
17,15, 위기/NNG;피하/VV,32,1.645630835211151,Hawkish
9,10, 주택담보대출/NNG;금리/NNG;최대/NNG,19,1.3068244867853258,Hawkish
26,9, 경상거래/NNG,35,4.194745266224502,Hawkish
62,69,총장/NNG,131,1.3047200995280226,Hawkish
20,15,모토/NNG,35,1.936036276719001,Hawkish
8,8, crb/NNG;지수/NNG;하락/NNG,16,1.4520272075392506,Hawkish
12,9, 종합금융회사/NNG,21,1.9360362767190011,Hawkish
25,23,굿/NNG,48,1.5782904429774465,Hawkish
25,26,상반/NNG,51,1.3961800072492796,Hawkish
11,8, 유적지/NNG,19,1.9965374103664697,Hawkish
20,14, 교내/NNG,34,2.07432458219893,Hawkish
30,25, 기념관/NNG,55,1.742432649047101,Hawkish
19,20, 중수/NNG,39,1.3794258471622882,Hawkish
15,12, 유물/NNG,27,1.8150340094240633,Hawkish
31,28, 납기/NNG,59,1.6076015512041708,Hawkish
9,10,간단히/MAG,19,1.3068244867853258,Hawkish
29,26, 취해졌/VV,55,1.6195688084091644,Hawkish
14,3, 수요/NNG;상승/NNG;압력/NNG,17,6.776126968516503,Hawkish
34,23, 기대/NNG;작/VA;않/VX,57,2.1464750024493275,Hawkish
16,13, 묶음/NNG,29,1.7871104092790777,Hawkish
32,21,상승형/NNG,53,2.212612887678858,Hawkish
45,31,세계화/NNG,76,2.1077814302989126,Hawkish
9,9, 은행/NNG;건전/NNG,18,1.4520272075392509,Hawkish
19,21,포괄/NNG,40,1.3137389020593222,Hawkish
47,45, 외쳤/VV,92,1.5165617500965507,Hawkish
33,30, 쏙/MAG,63,1.5972299282931757,Hawkish
17,12, 부동산세금/NNG,29,2.0570385440139387,Hawkish
12,10, 저렇게/MAG,22,1.742432649047101,Hawkish
12,9, 끌어당기/VV,21,1.9360362767190011,Hawkish
73,77,오일/NNG,150,1.376597222732017,Hawkish
11,12, 백가쟁명/NNG,23,1.331024940244313,Hawkish
31,26, 이니셜/NNG,57,1.731263208989107,Hawkish
18,19,오너/NNG,37,1.375604722931922,Hawkish
10,8, 담겨져/VV,18,1.8150340094240636,Hawkish
23,18, 미덥/VA,41,1.855368098522376,Hawkish
23,24, gdp/NNG;성장률/NNG;상향/NNG,47,1.3915260738917818,Hawkish
19,21, 환율체제/NNG,40,1.3137389020593222,Hawkish
70,31, 상표권/NNG,101,3.278771113798309,Hawkish
14,15, 하차/NNG,29,1.3552253937033008,Hawkish
9,10, 산업/NNG;생산/NNG;예상/NNG;밑돌/VV,19,1.3068244867853258,Hawkish
9,9, 경기/NNG;회복/NNG;실적/NNG;개선/NNG,18,1.4520272075392509,Hawkish
11,10, 단기/NNG;원화/NNG;강세/NNG,21,1.5972299282931757,Hawkish
18,17, 가계/NNG;대출/NNG;금리/NNG;하락/NNG,35,1.5374405726886184,Hawkish
30,25,급감/NNG,55,1.742432649047101,Hawkish
30,31, 및/VV,61,1.405187620199275,Hawkish
23,20, 스트래티지스/NNG,43,1.6698312886701383,Hawkish
11,5, 신용연계채권/NNG,16,3.1944598565863513,Hawkish
24,18,인생/NNG,42,1.9360362767190011,Hawkish
10,9, 시황관/NNG,19,1.6133635639325008,Hawkish
67,73,칼럼/NNG,140,1.3326825055497233,Hawkish
42,45,개막/NNG,87,1.3552253937033008,Hawkish
12,7, 단기/NNG;과열/NNG;우려/NNG,19,2.489189498638716,Hawkish
40,32,양극화/NNG,72,1.8150340094240636,Hawkish
8,8,전반기/NNG,16,1.4520272075392506,Hawkish
66,69, 다져/VV,135,1.3888955898201527,Hawkish
41,35, 노고/NNG,76,1.7009461574031224,Hawkish
8,8, 패기/NNG,16,1.4520272075392506,Hawkish
17,13,정확/NNG,30,1.8988048098590204,Hawkish
30,32, 손색/NNG,62,1.3612755070680476,Hawkish
9,10, 돈/NNG;벌/VV;쉽/VA,19,1.3068244867853258,Hawkish
18,15, 접했/VV,33,1.742432649047101,Hawkish
24,19, 청약금액/NNG,43,1.834139630575896,Hawkish
13,14, 경착륙/NNG;가능성/NNG;낮/VA,27,1.3483109784293044,Hawkish
11,12, 수출/NNG;둔화/NNG;상쇄/NNG,23,1.331024940244313,Hawkish
60,31, 콜/NNG;금리/NNG;목표/NNG;인상/NNG,91,2.81037524039855,Hawkish
34,32, 반장/NNG,66,1.5427789080104541,Hawkish
9,8, 복사기/NNG,17,1.6335306084816572,Hawkish
19,16, 사살/NNG,35,1.7242823089528605,Hawkish
23,21,스티븐로치/NNG,44,1.5903155130191793,Hawkish
16,16, 미/NNG;국채/NNG;수익률/NNG;떨어/VV,32,1.4520272075392506,Hawkish
31,34, 자부/NNG,65,1.3239071598151992,Hawkish
14,12,어느새/MAG,26,1.6940317421291258,Hawkish
35,29, 지수/NNG;지지/NNG,64,1.752446629788751,Hawkish
26,28, 인플레이션/NNG;압력/NNG;낮/VV,54,1.3483109784293044,Hawkish
46,42, 녹아웃/NNG,88,1.5903155130191793,Hawkish
22,23, 기쁜/VA,45,1.388895589820153,Hawkish
15,16, 부어야/VV,31,1.3612755070680476,Hawkish
41,44, 가입일/NNG,85,1.3530253524797564,Hawkish
29,20, 경솔/NNG,49,2.1054394509319136,Hawkish
14,11, 인상/NNG;금리/NNG;오르/VV,25,1.8480346277772284,Hawkish
93,61, 금리/NNG;인상/NNG;종결/NNG,154,2.2137463983795134,Hawkish
19,19,안착/NNG,38,1.4520272075392509,Hawkish
99,80, 주택/NNG;경기/NNG;둔화/NNG,179,1.796883669329823,Hawkish
50,54,대손비용/NNG,104,1.3444696366104174,Hawkish
12,8,뱅가드그룹/NNG,20,2.1780408113088763,Hawkish
21,23, 맬/NNG,44,1.325763972101055,Hawkish
9,8, 기관수/NNG,17,1.6335306084816572,Hawkish
27,23,잡지/NNG,50,1.7045536784156423,Hawkish
10,8, 노모/NNG,18,1.8150340094240636,Hawkish
9,10,서남/NNG,19,1.3068244867853258,Hawkish
43,33, 소매체/NNG,76,1.8920354522481146,Hawkish
112,111, 다자녀/NNG,223,1.465108533733298,Hawkish
21,14, 서비스업/NNG;경쟁력/NNG;강화/NNG,35,2.1780408113088763,Hawkish
24,23,금융허브/NNG,47,1.5151588252583488,Hawkish
46,39, 홀딩/NNG,85,1.7126474755591161,Hawkish
17,16, 꼽혀/VV,33,1.5427789080104541,Hawkish
11,12, 옵서버/NNG,23,1.331024940244313,Hawkish
9,9, 빚어져/VV,18,1.4520272075392509,Hawkish
12,4, 미/NNG;경제/NNG;충격/NNG,16,4.356081622617753,Hawkish
21,22,난방유/NNG,43,1.3860259708329212,Hawkish
10,9,그램/NNG,19,1.6133635639325008,Hawkish
46,21, 아이팟/NNG,67,3.1806310260383586,Hawkish
22,21, 미끄러진/VV,43,1.5211713602792152,Hawkish
31,33, 경기/NNG;찬물/NNG,64,1.364025558597478,Hawkish
12,11, 마음놓/VV,23,1.58402968095191,Hawkish
18,10, 부작용/NNG;해소/NNG,28,2.6136489735706516,Hawkish
12,13,비준/NNG,25,1.3403328069593086,Hawkish
9,8,부동산투자신탁/NNG,17,1.6335306084816572,Hawkish
11,8, 차렸/VV,19,1.9965374103664697,Hawkish
15,16,국제투자은행/NNG,31,1.3612755070680476,Hawkish
16,10, 소송법/NNG,26,2.323243532062801,Hawkish
54,57, 모험/NNG,111,1.3756047229319217,Hawkish
32,20, 서머랠리/NNG,52,2.323243532062801,Hawkish
36,25, 경제정책조정회의/NNG,61,2.0909191788565216,Hawkish
78,79, 경제자유구역/NNG,157,1.4336471163045768,Hawkish
8,8, 들립니다/VV,16,1.4520272075392506,Hawkish
12,9, 올라앉/VV,21,1.9360362767190011,Hawkish
21,21, 불감증/NNG,42,1.4520272075392509,Hawkish
16,15, 과도/NNG;아니/VCN,31,1.5488290213752007,Hawkish
19,18, 타인자본/NNG,37,1.5326953857358758,Hawkish
55,57, 사채업자/NNG,112,1.401078884467698,Hawkish
67,59,6자회담/NNG,126,1.6489122526293187,Hawkish
17,11, 당분간/MAG;금리/NNG;오르/VV;않/VX,28,2.244042048015206,Hawkish
11,9, 빈곤퇴치/NNG,20,1.774699920325751,Hawkish
28,29, 元/NNG,57,1.4019573038310007,Hawkish
21,22, 임대주택법/NNG,43,1.3860259708329212,Hawkish
11,10, 孝/NNG,21,1.5972299282931757,Hawkish
28,22, 학살/NNG,50,1.8480346277772284,Hawkish
17,15, 육로/NNG,32,1.645630835211151,Hawkish
23,23, 다녀왔/VV,46,1.4520272075392506,Hawkish
70,71,관세청/NNG,141,1.4315761201091206,Hawkish
222,218,투신사/NNG,440,1.478669908595017,Hawkish
37,40,연이/NNG,77,1.343125166973807,Hawkish
13,12, 고리대금업/NNG,25,1.5730294748341882,Hawkish
26,7, 카드깡/NNG,33,5.3932439137172175,Hawkish
13,5, 채권펀드/NNG;수탁고/NNG;감소/NNG,18,3.775270739602052,Hawkish
19,21, 의구심/NNG;않/VX,40,1.3137389020593222,Hawkish
9,8,안개/NNG,17,1.6335306084816572,Hawkish
41,44,실세/NNG,85,1.3530253524797564,Hawkish
25,26, 메웠/VV,51,1.3961800072492796,Hawkish
167,157, cd/NNG;금리/NNG;오르/VV,324,1.5445130169366554,Hawkish
35,37,멤버스/NNG,72,1.373539250374967,Hawkish
22,23,자부담/NNG,45,1.388895589820153,Hawkish
28,26, 자금계획/NNG,54,1.5637216081191931,Hawkish
12,9, 실적/NNG;전망/NNG;높/VV,21,1.9360362767190011,Hawkish
51,10,하비/NNG,61,7.405338758450179,Hawkish
11,8, 제조업체/NNG;하락/NNG,19,1.9965374103664697,Hawkish
28,28,인스트루먼트/NNG,56,1.4520272075392509,Hawkish
24,20, 경제/NNG;고속/NNG;성장/NNG,44,1.742432649047101,Hawkish
19,19, 연체금/NNG,38,1.4520272075392509,Hawkish
22,12, 혈압/NNG,34,2.662049880488626,Hawkish
9,8, 백업/NNG,17,1.6335306084816572,Hawkish
14,11, 광대역/NNG,25,1.8480346277772284,Hawkish
28,30,겪/VV,58,1.3552253937033008,Hawkish
10,11,인터랙티브/NNG,21,1.3200247341265916,Hawkish
54,35, 임상시험/NNG,89,2.240270548774844,Hawkish
89,79,역외세력/NNG,168,1.6358281198859914,Hawkish
59,65,복지부/NNG,124,1.31799392684332,Hawkish
14,5, 추안/NNG,19,4.065676181109902,Hawkish
9,10, 리본/NNG,19,1.3068244867853258,Hawkish
17,13, 부동산거래세/NNG,30,1.8988048098590204,Hawkish
17,7, 노동/NNG;비용/NNG;오르/VV,24,3.526351789738181,Hawkish
34,33,블랙베리/NNG,67,1.4960280320101373,Hawkish
18,12, 매출/NNG;전망/NNG;상향/NNG,30,2.1780408113088763,Hawkish
10,7, 대망/NNG,17,2.07432458219893,Hawkish
15,12,만호/NNG,27,1.8150340094240633,Hawkish
60,59,유가상승/NNG,119,1.4766378381755094,Hawkish
26,29, 마술/NNG,55,1.3018174964145008,Hawkish
44,48, 참으로/MAG,92,1.331024940244313,Hawkish
12,12, 전야/NNG,24,1.4520272075392509,Hawkish
9,9, 잠재/NNG;성장률/NNG;성장/NNG,18,1.4520272075392509,Hawkish
15,15, 앙등/NNG,30,1.4520272075392506,Hawkish
11,9, 올바로/MAG,20,1.774699920325751,Hawkish
24,24,분류/NNG,48,1.4520272075392509,Hawkish
22,21, 변종/NNG,43,1.5211713602792152,Hawkish
12,9, 공공임대/NNG;주택/NNG;공급/NNG;확대/NNG,21,1.9360362767190011,Hawkish
20,9, 금리/NNG;인상/NNG;끝/NNG,29,3.2267271278650016,Hawkish
29,29, 불용/NNG,58,1.4520272075392509,Hawkish
11,8, 訴/NNG,19,1.9965374103664697,Hawkish
52,39, 추징금/NNG,91,1.9360362767190011,Hawkish
25,17, 무역/NNG;적자/NNG;증가/NNG,42,2.1353341287341925,Hawkish
11,5, 무역/NNG;적자/NNG;재정/NNG;적자/NNG,16,3.1944598565863513,Hawkish
9,7, 물가/NNG;지표/NNG;하락/NNG,16,1.866892123979037,Hawkish
12,13, 서늘/NNG,25,1.3403328069593086,Hawkish
17,14,마라톤/NNG,31,1.7631758948690905,Hawkish
10,11, 주택구입/NNG;제한/NNG,21,1.3200247341265916,Hawkish
19,20,초단/NNG,39,1.3794258471622882,Hawkish
13,13,불구/NNG,26,1.4520272075392509,Hawkish
16,17,정반대/NNG,33,1.3666138423898828,Hawkish
11,8, 달아나/VV,19,1.9965374103664697,Hawkish
10,11, 혔/XSV,21,1.3200247341265916,Hawkish
20,22,구본/NNG,42,1.3200247341265916,Hawkish
16,16, 단본/NNG,32,1.4520272075392506,Hawkish
16,14, 장난/NNG,30,1.6594596657591438,Hawkish
15,16, 몰린다는/VV,31,1.3612755070680476,Hawkish
13,11, 담보대출/NNG;제한/NNG,24,1.7160321543645694,Hawkish
35,20,웬만/NNG,55,2.541047613193689,Hawkish
9,7, 생깁니다/VV,16,1.866892123979037,Hawkish
18,17, 시늉/NNG,35,1.5374405726886184,Hawkish
8,8, 너나없이/MAG,16,1.4520272075392506,Hawkish
15,15, 따진/VV,30,1.4520272075392506,Hawkish
104,106, 출제/NNG,210,1.4246304677743593,Hawkish
12,11, 부동산/NNG;거품/NNG;경고/NNG,23,1.58402968095191,Hawkish
55,32, 원가/NNG;부담/NNG,87,2.495671762958087,Hawkish
8,8, 차오르/VV,16,1.4520272075392506,Hawkish
71,63,추격/NNG,134,1.6364116148458223,Hawkish
12,12, 공모금액/NNG,24,1.4520272075392509,Hawkish
19,6, 학제/NNG,25,4.598086157207628,Hawkish
11,12, 내몰려/VV,23,1.331024940244313,Hawkish
47,44,등록금/NNG,91,1.551029062598745,Hawkish
14,13, 학연/NNG,27,1.5637216081191931,Hawkish
12,13,중간재/NNG,25,1.3403328069593086,Hawkish
9,8, 相/NNG,17,1.6335306084816572,Hawkish
35,34, 泰/NNG,69,1.4947338901139346,Hawkish
10,9, 長/NNG,19,1.6133635639325008,Hawkish
69,63,추/NNG,132,1.5903155130191795,Hawkish
27,30, 종합지원/NNG,57,1.3068244867853256,Hawkish
9,9, 구명/NNG,18,1.4520272075392509,Hawkish
19,18, 현장경영/NNG,37,1.5326953857358758,Hawkish
8,8, 가수요/NNG;억제/NNG,16,1.4520272075392506,Hawkish
72,74, 당론/NNG,146,1.412783228957109,Hawkish
8,8, 양론/NNG,16,1.4520272075392506,Hawkish
52,58, 이종통화/NNG,110,1.3018174964145008,Hawkish
16,17, 신디케이션/NNG,33,1.3666138423898828,Hawkish
8,8, 은행/NNG;주택담보대출/NNG;늘/VV,16,1.4520272075392506,Hawkish
17,15,金/NNG,32,1.645630835211151,Hawkish
28,31, 夫/NNG,59,1.3115084455193233,Hawkish
32,34,기대수익률/NNG,66,1.3666138423898828,Hawkish
31,29, 당혹감/NNG,60,1.552167014955751,Hawkish
24,23,팔자/NNG,47,1.5151588252583488,Hawkish
11,8, 부동산/NNG;가격/NNG;상승/NNG;억제/NNG,19,1.9965374103664697,Hawkish
13,14, 유례없/VA;호황/NNG,27,1.3483109784293044,Hawkish
33,31, 주택담보대출/NNG;제한/NNG,64,1.5457063822192025,Hawkish
38,38, 지수/NNG;플러스/NNG,76,1.4520272075392509,Hawkish
14,13, 물가/NNG;기대/NNG;안정/NNG,27,1.5637216081191931,Hawkish
13,13,런/NNG,26,1.4520272075392509,Hawkish
16,17, 수주/NNG;모멘텀/NNG,33,1.3666138423898828,Hawkish
11,10, 당연지사/NNG,21,1.5972299282931757,Hawkish
16,12, 뿌렸/VV,28,1.9360362767190007,Hawkish
17,13, 근원/NNG;인플레이션/NNG;압력/NNG,30,1.8988048098590204,Hawkish
58,39, 광복/NNG,97,2.1594250778788857,Hawkish
12,7, 안정/NNG;찾/VV;상승/NNG,19,2.489189498638716,Hawkish
10,8,인디펜던스/NNG,18,1.8150340094240636,Hawkish
12,10,재건/NNG,22,1.742432649047101,Hawkish
15,13, 주종/NNG,28,1.6754160086991354,Hawkish
11,12, 명약관화/NNG,23,1.331024940244313,Hawkish
10,11, 환경영향평가/NNG,21,1.3200247341265916,Hawkish
17,18,관측/NNG,35,1.3713590293426259,Hawkish
22,11, 느낀다는/VV,33,2.9040544150785017,Hawkish
29,30,블랙먼데이/NNG,59,1.4036263006212757,Hawkish
21,13,의료비/NNG,34,2.3455824121787896,Hawkish
12,8, 유가/NNG;거품/NNG,20,2.1780408113088763,Hawkish
31,30,대검/NNG,61,1.5004281144572258,Hawkish
24,20,통화정책당국/NNG,44,1.742432649047101,Hawkish
11,10, 금리/NNG;인상/NNG;잡/VV,21,1.5972299282931757,Hawkish
44,39, 떠돌/VV,83,1.6381845418391547,Hawkish
13,8, 이자소득/NNG;증가/NNG,21,2.359544212251283,Hawkish
28,28,유독/MAG,56,1.4520272075392509,Hawkish
43,38, 슬그머니/MAG,81,1.6430834190575734,Hawkish
72,75, 주무/NNG,147,1.3939461192376807,Hawkish
19,14, 미/NNG;경상/NNG;수지/NNG;적자/NNG,33,1.9706083530889835,Hawkish
24,24, 사중/NNG,48,1.4520272075392509,Hawkish
56,58,늘/MAG,114,1.4019573038310007,Hawkish
9,10, 심리/NNG;해소/NNG,19,1.3068244867853258,Hawkish
9,7, 매달린/VV,16,1.866892123979037,Hawkish
13,12, 실수요/NNG;많/VA,25,1.5730294748341882,Hawkish
23,9, 외환시장/NNG;환율/NNG;하락/NNG,32,3.710736197044752,Hawkish
11,11, 공급/NNG;제약/NNG,22,1.4520272075392509,Hawkish
39,41, 이자율/NNG;제한/NNG,80,1.3811966120495314,Hawkish
25,12, 실적/NNG;긍정적/VAX;영향/NNG;줄/VV,37,3.025056682373439,Hawkish
18,18,모집금액/NNG,36,1.4520272075392509,Hawkish
20,11, 대유행/NNG,31,2.640049468253183,Hawkish
15,16, 위기사태/NNG,31,1.3612755070680476,Hawkish
32,33,성적/NNG,65,1.4080263830683644,Hawkish
22,13,기/VA,35,2.457276812758732,Hawkish
17,14, 위세/NNG,31,1.7631758948690905,Hawkish
11,6,주택건설업지수/NNG,17,2.662049880488626,Hawkish
77,52,패니매/NNG,129,2.1501172111638907,Hawkish
33,27,토마토/NNG,60,1.7746999203257507,Hawkish
9,10,연방법원/NNG,19,1.3068244867853258,Hawkish
35,23, 태극기/NNG,58,2.2096066201684255,Hawkish
54,52, 꿈틀/MAG,106,1.5078744078292219,Hawkish
10,8, 실적/NNG;견고/NNG,18,1.8150340094240636,Hawkish
9,9, 자금/NNG;유입/NNG;차단/NNG,18,1.4520272075392509,Hawkish
11,12,공업협회/NNG,23,1.331024940244313,Hawkish
22,18, 획단/NNG,40,1.774699920325751,Hawkish
32,31,교보/NNG,63,1.4988667948792267,Hawkish
28,31,주택사업/NNG,59,1.3115084455193233,Hawkish
9,7,재보험/NNG,16,1.866892123979037,Hawkish
12,11,환율제도/NNG,23,1.58402968095191,Hawkish
10,11,張/NNG,21,1.3200247341265916,Hawkish
16,17,정해지/VV,33,1.3666138423898828,Hawkish
20,14,가수요/NNG,34,2.07432458219893,Hawkish
32,28, 공공분양/NNG,60,1.6594596657591438,Hawkish
19,6, 절상/NNG;없/VA,25,4.598086157207628,Hawkish
13,6, 부동산/NNG;거품/NNG;터지/VV,19,3.1460589496683764,Hawkish
44,43, 혁신기업/NNG,87,1.4857952821331868,Hawkish
11,9, 프리보드/NNG,20,1.774699920325751,Hawkish
9,10, 척척/MAG,19,1.3068244867853258,Hawkish
10,10, 특별배당/NNG,20,1.4520272075392509,Hawkish
65,68,증자/NNG,133,1.3879671836772247,Hawkish
22,20, 숱한/VA,42,1.5972299282931757,Hawkish
10,6,정책과제/NNG,16,2.420045345898751,Hawkish
49,42,빈/VV,91,1.694031742129126,Hawkish
14,14, ff/NNG;금리/NNG;상승/NNG,28,1.4520272075392509,Hawkish
12,10, 원기/NNG,22,1.742432649047101,Hawkish
8,8, 금리/NNG;오르/VV;높/VA,16,1.4520272075392506,Hawkish
15,9, 소득/NNG;성장/NNG,24,2.420045345898751,Hawkish
9,7, 채권/NNG;운용/NNG;금리/NNG;오르/VV,16,1.866892123979037,Hawkish
9,9, 더치/NNG,18,1.4520272075392509,Hawkish
16,10, 금리/NNG;상승/NNG;주택가격/NNG;하락/NNG,26,2.323243532062801,Hawkish
29,12, 산자부/NNG,41,3.509065751553189,Hawkish
12,10, 문지/NNG,22,1.742432649047101,Hawkish
27,18, 신경제/NNG,45,2.1780408113088763,Hawkish
20,22,수시로/MAG,42,1.3200247341265916,Hawkish
8,8, 신고가종목/NNG,16,1.4520272075392506,Hawkish
13,12,인피/NNG,25,1.5730294748341882,Hawkish
60,31, 노던/NNG,91,2.81037524039855,Hawkish
14,13, 리보금리/NNG;오르/VV,27,1.5637216081191931,Hawkish
367,303,프리미엄/NNG,670,1.758726023653152,Hawkish
12,11, 부푼/VV,23,1.58402968095191,Hawkish
19,19,무난/NNG,38,1.4520272075392509,Hawkish
25,22, 인플레이션/NNG;상승/NNG;위험/NNG,47,1.6500309176582397,Hawkish
13,7, 펀드오브펀드/NNG,20,2.6966219568586087,Hawkish
23,18, 열대야/NNG,41,1.855368098522376,Hawkish
18,15, 상장요건/NNG,33,1.742432649047101,Hawkish
36,20, 원가연동제/NNG,56,2.6136489735706516,Hawkish
15,15, 장마철/NNG,30,1.4520272075392506,Hawkish
45,38, 내수관련주/NNG,83,1.7195059036649023,Hawkish
9,7, 자금관리서비스/NNG,16,1.866892123979037,Hawkish
35,29,성장형/NNG,64,1.752446629788751,Hawkish
11,8, 집값/NNG;하향/NNG,19,1.9965374103664697,Hawkish
17,15, 차입/NNG;금리/NNG;상승/NNG,32,1.645630835211151,Hawkish
9,9, 관심주/NNG,18,1.4520272075392509,Hawkish
11,11, 가격/NNG;인하/NNG;압력/NNG,22,1.4520272075392509,Hawkish
11,7, 이익/NNG;높/VA,18,2.2817570404188228,Hawkish
27,21, 역배열/NNG,48,1.8668921239790368,Hawkish
27,10, 북태평양/NNG,37,3.9204734603559768,Hawkish
71,73, 실적호전주/NNG,144,1.4122456402094086,Hawkish
10,9, 이자율/NNG;하향/NNG,19,1.6133635639325008,Hawkish
44,47, 자기앞수표/NNG,91,1.3593446198239796,Hawkish
81,49,풀/NNG,130,2.400289873687333,Hawkish
26,27, 수출기업/NNG;채산성/NNG;악화/NNG,53,1.3982484220748341,Hawkish
11,11, 채권/NNG;매력/NNG;떨어/VV,22,1.4520272075392509,Hawkish
16,16, 주택구매자금/NNG,32,1.4520272075392506,Hawkish
18,19, 과열/NNG;방지/NNG,37,1.375604722931922,Hawkish
16,16, 대홍수/NNG,32,1.4520272075392506,Hawkish
38,36, 對中/NNG,74,1.5326953857358758,Hawkish
40,10, 丁/NNG,50,5.808108830157003,Hawkish
20,15, 姜/NNG,35,1.936036276719001,Hawkish
37,33, 보고회/NNG,70,1.6280305054227964,Hawkish
18,14,盧/NNG,32,1.866892123979037,Hawkish
83,83, 스톡옵션/NNG,166,1.4520272075392506,Hawkish
29,32, 청약증거금/NNG,61,1.315899656832446,Hawkish
13,14, 이자/NNG;세계/NNG;최대/NNG,27,1.3483109784293044,Hawkish
21,20, 세계/NNG;경제/NNG;호조/NNG,41,1.5246285679162133,Hawkish
23,19, 경기/NNG;침체/NNG;금리/NNG;인상/NNG,42,1.7577171459685668,Hawkish
16,17, 초호황/NNG,33,1.3666138423898828,Hawkish
11,6, 주택시장/NNG;불황/NNG,17,2.662049880488626,Hawkish
17,18, 지표/NNG;예상/NNG;좋/VA,35,1.3713590293426259,Hawkish
12,12, 꿰차/VV,24,1.4520272075392509,Hawkish
10,6,순상환/NNG,16,2.420045345898751,Hawkish
25,22,마이너스대출/NNG,47,1.6500309176582397,Hawkish
22,24, 애썼/VV,46,1.331024940244313,Hawkish
14,11, 부단히/MAG,25,1.8480346277772284,Hawkish
16,11, 선다고/VV,27,2.1120395746025467,Hawkish
17,17, 쫓기/VV,34,1.4520272075392509,Hawkish
12,11, 지수/NNG;상승/NNG;크/VV,23,1.58402968095191,Hawkish
11,6,조종사/NNG,17,2.662049880488626,Hawkish
8,8, 하락/NNG;돌아/VV;상승/NNG,16,1.4520272075392506,Hawkish
20,14, 속한다고/VV,34,2.07432458219893,Hawkish
37,41,동행/NNG,78,1.3103660165598119,Hawkish
12,12, 경기/NNG;회복/NNG;지지부진/NNG,24,1.4520272075392509,Hawkish
15,12,기준지수/NNG,27,1.8150340094240633,Hawkish
15,12, 고유가/NNG;악재/NNG,27,1.8150340094240633,Hawkish
17,13, 너트/NNG,30,1.8988048098590204,Hawkish
23,23, 어지럽/VA,46,1.4520272075392506,Hawkish
16,15, 부제/NNG,31,1.5488290213752007,Hawkish
9,9, 고유가/NNG;고금리/NNG,18,1.4520272075392509,Hawkish
14,7, 유출/NNG;압력/NNG,21,2.9040544150785017,Hawkish
12,13,공급우위/NNG,25,1.3403328069593086,Hawkish
18,6, 예상/NNG;시장/NNG;집계/NNG;웃돌/VV,24,4.356081622617753,Hawkish
28,25, 만발/NNG,53,1.626270472443961,Hawkish
13,14,소프트/NNG,27,1.3483109784293044,Hawkish
16,12, 필라델피아반도체지수/NNG;하락/NNG,28,1.9360362767190007,Hawkish
19,11,분식회계/NNG,30,2.5080469948405244,Hawkish
16,17,안성/NNG,33,1.3666138423898828,Hawkish
30,23, 기획팀/NNG,53,1.8939485315729356,Hawkish
25,27, 펙/NNG,52,1.3444696366104174,Hawkish
10,9,중화학공업/NNG,19,1.6133635639325008,Hawkish
77,80, 사령관/NNG,157,1.3975761872565289,Hawkish
39,27,윈도드레싱/NNG,66,2.097372633112251,Hawkish
10,8, 콜/NNG;금리/NNG;인상/NNG;반대/NNG,18,1.8150340094240636,Hawkish
19,4, 금리/NNG;인상/NNG;계획/NNG;없/VA,23,6.897129235811442,Hawkish
76,69, 年/NNG,145,1.5993343155504791,Hawkish
10,6, 짱/NNG,16,2.420045345898751,Hawkish
9,7, 절대/MAG;금리/NNG;오르/VV,16,1.866892123979037,Hawkish
12,10, fed/NNG;금리/NNG;인상/NNG;종결/NNG,22,1.742432649047101,Hawkish
15,10,재평가/NNG,25,2.178040811308876,Hawkish
8,8, 국채선물/NNG;금리/NNG;인상/NNG,16,1.4520272075392506,Hawkish
54,48, 억류/NNG,102,1.633530608481657,Hawkish
40,19, 피랍/NNG,59,3.0568993842931595,Hawkish
55,61, 대검/NNG,116,1.3092048592567016,Hawkish
21,23,민주화/NNG,44,1.325763972101055,Hawkish
59,63,경쟁사/NNG,122,1.359835003885965,Hawkish
16,15, 안보/NNG;위험/NNG,31,1.5488290213752007,Hawkish
11,6, 공포증/NNG,17,2.662049880488626,Hawkish
18,19,배리/NNG,37,1.375604722931922,Hawkish
9,10, 패드/NNG,19,1.3068244867853258,Hawkish
26,26, 건설/NNG;지출/NNG;감소/NNG,52,1.4520272075392509,Hawkish
11,7,고수/NNG,18,2.2817570404188228,Hawkish
13,4, 선견지명/NNG,17,4.719088424502566,Hawkish
39,18, 소비자전망조사/NNG,57,3.146058949668377,Hawkish
32,33,잇달/VV,65,1.4080263830683644,Hawkish
11,12, 재적/NNG,23,1.331024940244313,Hawkish
19,15, 콜/NNG;금리/NNG;인상/NNG;부담/NNG,34,1.839234462883051,Hawkish
12,9,불리/NNG,21,1.9360362767190011,Hawkish
15,13, 금리/NNG;상승/NNG;악재/NNG,28,1.6754160086991354,Hawkish
14,8, 코리아디스카운트/NNG;해소/NNG,22,2.541047613193689,Hawkish
25,21,반년/NNG,46,1.7286038184991082,Hawkish
24,16, 국립대/NNG,40,2.1780408113088763,Hawkish
12,10, 투자/NNG;활력/NNG,22,1.742432649047101,Hawkish
26,23,참여연대/NNG,49,1.6414220606965444,Hawkish
16,17, ism/NNG;제조업/NNG;지수/NNG;상승/NNG,33,1.3666138423898828,Hawkish
13,9,친디아/NNG,22,2.097372633112251,Hawkish
20,12, 건드릴/VV,32,2.420045345898751,Hawkish
9,7, 지수/NNG;좋/VA,16,1.866892123979037,Hawkish
9,10, 정비례/NNG,19,1.3068244867853258,Hawkish
11,12,보편/NNG,23,1.331024940244313,Hawkish
48,47, 거주지/NNG,95,1.4829214034443414,Hawkish
200,198, 수능/NNG,398,1.4666941490295462,Hawkish
20,15,대입/NNG,35,1.936036276719001,Hawkish
16,10, 유행어/NNG,26,2.323243532062801,Hawkish
46,33, 전세시장/NNG;안정/NNG,79,2.0240379256607737,Hawkish
18,18, 수호천사/NNG,36,1.4520272075392509,Hawkish
12,11,무배당/NNG,23,1.58402968095191,Hawkish
14,15, 변액유니버셜보험/NNG,29,1.3552253937033008,Hawkish
16,11, 보험가입금액/NNG,27,2.1120395746025467,Hawkish
12,9, 유불리/NNG,21,1.9360362767190011,Hawkish
37,36, 펴낸/VV,73,1.4923612966375635,Hawkish
12,13,우수기업/NNG,25,1.3403328069593086,Hawkish
18,15, 고용보험기금/NNG,33,1.742432649047101,Hawkish
51,48, 응답기업/NNG,99,1.542778908010454,Hawkish
38,34,절상/NNG,72,1.622853937837986,Hawkish
14,6,해산/NNG,20,3.3880634842582515,Hawkish
88,62, 문항/NNG,150,2.0609418429589366,Hawkish
10,9, 仁/NNG,19,1.6133635639325008,Hawkish
20,22, 중앙행정/NNG,42,1.3200247341265916,Hawkish
10,11, 불상/NNG,21,1.3200247341265916,Hawkish
21,9, 알권리/NNG,30,3.3880634842582515,Hawkish
14,15, 허물어지/VV,29,1.3552253937033008,Hawkish
18,17, 맹위/NNG,35,1.5374405726886184,Hawkish
9,8, 기업/NNG;자금/NNG;수요/NNG;늘/VV,17,1.6335306084816572,Hawkish
12,10, 벗겨/VV,22,1.742432649047101,Hawkish
17,7, 방폐/NNG,24,3.526351789738181,Hawkish
23,9, 밀수/NNG,32,3.710736197044752,Hawkish
10,9, 가격/NNG;꺾/VV,19,1.6133635639325008,Hawkish
13,7, 경제/NNG;성장률/NNG;목표/NNG;하향/NNG,20,2.6966219568586087,Hawkish
18,16,상식/NNG,34,1.6335306084816572,Hawkish
244,261,글/NNG,505,1.3574507227570007,Hawkish
19,20, 혀/NNG,39,1.3794258471622882,Hawkish
16,16,전인/NNG,32,1.4520272075392506,Hawkish
44,11,베이비스텝/NNG,55,5.808108830157003,Hawkish
28,29, 잰걸음/NNG,57,1.4019573038310007,Hawkish
19,13,신주인수권/NNG,32,2.122193611018905,Hawkish
67,70,재무구조/NNG,137,1.389797470073283,Hawkish
9,7,레그/NNG,16,1.866892123979037,Hawkish
18,15, 금리/NNG;인상/NNG;심각/NNG,33,1.742432649047101,Hawkish
27,19, 제와/NNG,46,2.0634070843978827,Hawkish
18,15, 중유/NNG,33,1.742432649047101,Hawkish
48,37, 불교/NNG,85,1.8837109719428118,Hawkish
17,13, 회복/NNG;자신/NNG,30,1.8988048098590204,Hawkish
11,10, 부끄럽/VA,21,1.5972299282931757,Hawkish
29,26, 공권력/NNG,55,1.6195688084091644,Hawkish
19,14, 적재적소/NNG,33,1.9706083530889835,Hawkish
19,18, 금리/NNG;인상/NNG;결정/NNG;내리/VV,37,1.5326953857358758,Hawkish
10,9, 금리/NNG;인상/NNG;가능성/NNG;점차/MAG;높/VA,19,1.6133635639325008,Hawkish
17,14, 더해진다/VV,31,1.7631758948690905,Hawkish
9,10, 모진/NNG,19,1.3068244867853258,Hawkish
34,12, 갑작/VA;금리/NNG;인상/NNG,46,4.114077088027877,Hawkish
13,5, 용보/NNG,18,3.775270739602052,Hawkish
17,11,경제정책조정회의/NNG,28,2.244042048015206,Hawkish
40,37,명동/NNG,77,1.5697591432856766,Hawkish
10,9,학년/NNG,19,1.6133635639325008,Hawkish
22,24, 정부과천청사/NNG,46,1.331024940244313,Hawkish
38,41,한국인/NNG,79,1.3457813143046715,Hawkish
23,19, 비상근무/NNG,42,1.7577171459685668,Hawkish
25,27, 덮쳤/VV,52,1.3444696366104174,Hawkish
14,13,매수강도/NNG,27,1.5637216081191931,Hawkish
11,12,노사관계/NNG,23,1.331024940244313,Hawkish
26,26,유치/NNG,52,1.4520272075392509,Hawkish
16,15, 사은/NNG,31,1.5488290213752007,Hawkish
25,25,재난/NNG,50,1.4520272075392509,Hawkish
18,18, 현물/NNG;가격/NNG;하락/NNG,36,1.4520272075392509,Hawkish
13,14, 갈길/VV,27,1.3483109784293044,Hawkish
38,36, 희/VA,74,1.5326953857358758,Hawkish
21,20, 폭발물/NNG,41,1.5246285679162133,Hawkish
21,22, 초저/NNG,43,1.3860259708329212,Hawkish
27,26,부동자금/NNG,53,1.5078744078292219,Hawkish
45,47,출자/NNG,92,1.39023881572907,Hawkish
40,37, 공보/NNG,77,1.5697591432856766,Hawkish
11,7, 부식/NNG,18,2.2817570404188228,Hawkish
10,10,출자총액제한제도/NNG,20,1.4520272075392509,Hawkish
8,8, 외국인/NNG;직접/MAG;투자/NNG;증가/NNG,16,1.4520272075392506,Hawkish
35,29, 결정지수/NNG,64,1.752446629788751,Hawkish
15,15, 순이익/NNG;최대/NNG,30,1.4520272075392506,Hawkish
128,132, 순이자마진/NNG;개선/NNG,260,1.4080263830683644,Hawkish
16,10,이자부문이익/NNG,26,2.323243532062801,Hawkish
22,24, 사견/NNG,46,1.331024940244313,Hawkish
24,18,미증/NNG,42,1.9360362767190011,Hawkish
14,14, 최고가/NNG;오르/VV,28,1.4520272075392509,Hawkish
12,12, 장기물/NNG;시장/NNG;활성화/NNG,24,1.4520272075392509,Hawkish
39,32,출/VV,71,1.769658159188462,Hawkish
170,78, 총제/NNG,248,3.164674683098367,Hawkish
81,89, 저력/NNG,170,1.3215079079851608,Hawkish
11,5, 금리/NNG;인상/NNG;전망/NNG;약세/NNG,16,3.1944598565863513,Hawkish
52,54, 대명사/NNG,106,1.3982484220748341,Hawkish
15,8,공산품/NNG,23,2.722551014136095,Hawkish
27,27, 자긍심/NNG,54,1.4520272075392506,Hawkish
10,11, 애국/NNG,21,1.3200247341265916,Hawkish
12,13, 경제/NNG;냉각/NNG,25,1.3403328069593086,Hawkish
9,7, 냉각/NNG;조짐/NNG,16,1.866892123979037,Hawkish
22,24, 年/NNG,46,1.331024940244313,Hawkish
19,16, 불안/NNG;감추/VV;못하/VX,35,1.7242823089528605,Hawkish
10,8,꺼지/VV,18,1.8150340094240636,Hawkish
21,18, 지가/NNG,39,1.6940317421291258,Hawkish
20,22, 부동산/NNG;경착륙/NNG,42,1.3200247341265916,Hawkish
42,41, 순이자마진/NNG;회복/NNG,83,1.4874425052841107,Hawkish
191,106,허리케인/NNG,297,2.616388647547141,Hawkish
17,16, 친지/NNG,33,1.5427789080104541,Hawkish
16,15, 전시관/NNG,31,1.5488290213752007,Hawkish
59,64, 눌러/VV,123,1.3385875819502469,Hawkish
15,10, 경기/NNG;긴축/NNG,25,2.178040811308876,Hawkish
50,25, 레포츠/NNG,75,2.9040544150785017,Hawkish
9,8, 농산어촌/NNG,17,1.6335306084816572,Hawkish
28,17, 판매/NNG;강화/NNG,45,2.3915742241822953,Hawkish
35,35, 속앓이/NNG,70,1.4520272075392509,Hawkish
15,5, 누트/NNG,20,4.356081622617752,Hawkish
14,14, 지표/NNG;증가/NNG,28,1.4520272075392509,Hawkish
10,7, 건설/NNG;기성/NNG;증가/NNG,17,2.07432458219893,Hawkish
9,10, 성장/NNG;잠재력/NNG;회복/NNG,19,1.3068244867853258,Hawkish
9,7, 채권펀드/NNG;감소/NNG,16,1.866892123979037,Hawkish
9,9, 채권형/NNG;감소/NNG,18,1.4520272075392509,Hawkish
14,8, 주택담보대출/NNG;위험관리/NNG;강화/NNG,22,2.541047613193689,Hawkish
18,14, 민회/NNG,32,1.866892123979037,Hawkish
10,6, 대북송전/NNG,16,2.420045345898751,Hawkish
24,21,양대/NNG,45,1.6594596657591438,Hawkish
29,27, 골랐/VV,56,1.559584778468084,Hawkish
12,7,의중/NNG,19,2.489189498638716,Hawkish
52,57, 지지대/NNG,109,1.324656399860369,Hawkish
21,23, 어겼/VV,44,1.325763972101055,Hawkish
15,16, 박용/NNG,31,1.3612755070680476,Hawkish
24,25, 불요불급/NNG,49,1.393946119237681,Hawkish
42,21, 고점/NNG;부담/NNG,63,2.9040544150785017,Hawkish
9,10, 관광사업/NNG,19,1.3068244867853258,Hawkish
13,14, 실적/NNG;압박/NNG,27,1.3483109784293044,Hawkish
18,18, 실적/NNG;예상/NNG;넘/VV,36,1.4520272075392509,Hawkish
16,14, 보호막/NNG,30,1.6594596657591438,Hawkish
22,18, 금리/NNG;인하/NNG;가능성/NNG;줄/VV,40,1.774699920325751,Hawkish
11,11, 세계/NNG;최대/NNG;업체/NNG;상승/NNG,22,1.4520272075392509,Hawkish
23,23, 고정금리채/NNG,46,1.4520272075392506,Hawkish
11,10,전량/NNG,21,1.5972299282931757,Hawkish
18,9,기반시설/NNG,27,2.9040544150785017,Hawkish
43,32, 국고채/NNG;내리/VV;국고채/NNG;하락/NNG,75,1.9511615601308683,Hawkish
18,16, 궁여지책/NNG,34,1.6335306084816572,Hawkish
8,8, 단기/NNG;급등/NNG;피로/NNG,16,1.4520272075392506,Hawkish
21,23, 시세조종/NNG,44,1.325763972101055,Hawkish
9,8, 갈라지/VV,17,1.6335306084816572,Hawkish
14,15, 표선/NNG,29,1.3552253937033008,Hawkish
13,11, 무정부/NNG,24,1.7160321543645694,Hawkish
71,71, 소비자/NNG;부담/NNG,142,1.4520272075392509,Hawkish
12,9, 기본세율/NNG,21,1.9360362767190011,Hawkish
9,10, 광전/NNG,19,1.3068244867853258,Hawkish
24,25,흑자전환/NNG,49,1.393946119237681,Hawkish
88,90,외화차입/NNG,178,1.4197599362606008,Hawkish
17,18,올/NNG,35,1.3713590293426259,Hawkish
15,13, 준해/VV,28,1.6754160086991354,Hawkish
17,16,예견/NNG,33,1.5427789080104541,Hawkish
14,5, 가격/NNG;상승/NNG;오르/VV,19,4.065676181109902,Hawkish
10,8, 동일업종/NNG,18,1.8150340094240636,Hawkish
15,14, 손실/NNG;피하/VV,29,1.5557434366491973,Hawkish
9,8, 지수선물/NNG;강세/NNG,17,1.6335306084816572,Hawkish
13,8,불공정거래/NNG,21,2.359544212251283,Hawkish
22,18, 양형/NNG,40,1.774699920325751,Hawkish
28,26,통화바스켓/NNG,54,1.5637216081191931,Hawkish
15,12,놀/VV,27,1.8150340094240633,Hawkish
18,18, 보유비용/NNG,36,1.4520272075392509,Hawkish
21,9, 채권시장/NNG;금리/NNG;오르/VV,30,3.3880634842582515,Hawkish
24,20, 물가/NNG;안정/NNG;위협/NNG,44,1.742432649047101,Hawkish
22,23,기업인수/NNG,45,1.388895589820153,Hawkish
105,105, gdp/NNG;호조/NNG,210,1.4520272075392506,Hawkish
19,18, 경제/NNG;성장/NNG;지탱/NNG,37,1.5326953857358758,Hawkish
15,7, 구매력/NNG;크/VV,22,3.1114868732983947,Hawkish
24,10, 격동/NNG,34,3.484865298094202,Hawkish
10,6, 순이익/NNG;상승/NNG,16,2.420045345898751,Hawkish
21,21, 토익/NNG,42,1.4520272075392509,Hawkish
22,20, 번호표/NNG,42,1.5972299282931757,Hawkish
13,13, 기업/NNG;실적/NNG;견조/NNG,26,1.4520272075392509,Hawkish
24,25, 순이익/NNG;전망/NNG;상향/NNG,49,1.393946119237681,Hawkish
20,11,전미부동산협회/NNG,31,2.640049468253183,Hawkish
19,19, 울트라/NNG,38,1.4520272075392509,Hawkish
32,21, 전망/NNG;높/VV;잡/VV,53,2.212612887678858,Hawkish
15,15,시장리스크/NNG,30,1.4520272075392506,Hawkish
13,9,경질/NNG,22,2.097372633112251,Hawkish
9,7, 기름/NNG;가격/NNG;인상/NNG,16,1.866892123979037,Hawkish
15,12,예산처/NNG,27,1.8150340094240633,Hawkish
10,11, 미/NNG;경제/NNG;지표/NNG;개선/NNG,21,1.3200247341265916,Hawkish
17,18,소스/NNG,35,1.3713590293426259,Hawkish
26,23, 은행/NNG;실적/NNG;개선/NNG,49,1.6414220606965444,Hawkish
12,13,모호/NNG,25,1.3403328069593086,Hawkish
22,10,월급통장/NNG,32,3.1944598565863513,Hawkish
165,145, 보통예금/NNG,310,1.652306822372251,Hawkish
9,7, 카운트다운/NNG,16,1.866892123979037,Hawkish
13,9, 중소기업/NNG;자금난/NNG;완화/NNG,22,2.097372633112251,Hawkish
15,7, 역사적/VAX;고점/NNG;넘/VV,22,3.1114868732983947,Hawkish
15,8, 과열/NNG;아니/VCN,23,2.722551014136095,Hawkish
18,15, 산책/NNG,33,1.742432649047101,Hawkish
8,8, 채근/NNG,16,1.4520272075392506,Hawkish
8,8,명분/NNG,16,1.4520272075392506,Hawkish
15,14,접근성/NNG,29,1.5557434366491973,Hawkish
32,28,기조적/VAX,60,1.6594596657591438,Hawkish
18,17, 창궐/NNG,35,1.5374405726886184,Hawkish
13,10,특혜/NNG,23,1.887635369801026,Hawkish
21,17,말잔액/NNG,38,1.7936806681367214,Hawkish
16,17,로드/NNG,33,1.3666138423898828,Hawkish
53,51, 출장소/NNG,104,1.5089694509721625,Hawkish
9,8, 토르/NNG,17,1.6335306084816572,Hawkish
11,10,내부통제/NNG,21,1.5972299282931757,Hawkish
9,7, 개발부담금제/NNG,16,1.866892123979037,Hawkish
24,25,사무실/NNG,49,1.393946119237681,Hawkish
15,10, 멎/VV,25,2.178040811308876,Hawkish
22,20, 오가/NNG,42,1.5972299282931757,Hawkish
16,15, 신용/NNG;좋/VA,31,1.5488290213752007,Hawkish
22,24,불/VV,46,1.331024940244313,Hawkish
15,13,예방/NNG,28,1.6754160086991354,Hawkish
12,10, 예상밖/NNG;급등/NNG,22,1.742432649047101,Hawkish
55,57, 충실하/VV,112,1.401078884467698,Hawkish
15,13,견실/NNG,28,1.6754160086991354,Hawkish
9,7, 체할/VV,16,1.866892123979037,Hawkish
15,14,출한/NNG,29,1.5557434366491973,Hawkish
156,120, 역모기지/NNG,276,1.887635369801026,Hawkish
21,4, 역모기지/NNG;활성화/NNG,25,7.6231428395810665,Hawkish
9,8, 기회/NNG;잡/VV;못하/VX,17,1.6335306084816572,Hawkish
12,11, 양자택일/NNG,23,1.58402968095191,Hawkish
11,7, 달려드/VV,18,2.2817570404188228,Hawkish
19,9, 선도주/NNG,28,3.0653907714717517,Hawkish
25,25, 손꼽힌다/VV,50,1.4520272075392509,Hawkish
16,14, 생명력/NNG,30,1.6594596657591438,Hawkish
24,18, 단명/NNG,42,1.9360362767190011,Hawkish
14,7,소나기/NNG,21,2.9040544150785017,Hawkish
15,10, 덥/VA,25,2.178040811308876,Hawkish
36,31,소비자금융/NNG,67,1.6862251442391303,Hawkish
18,20, 모리/NNG,38,1.3068244867853258,Hawkish
14,10,입출금통장/NNG,24,2.032838090554951,Hawkish
11,10,맡기/VV,21,1.5972299282931757,Hawkish
22,21, 도의/NNG,43,1.5211713602792152,Hawkish
36,35,시큐리티/NNG,71,1.4935136991832296,Hawkish
24,22, 경제/NNG;지표/NNG;나쁘/VA;않/VX,46,1.58402968095191,Hawkish
18,8,편지/NNG,26,3.2670612169633144,Hawkish
13,10, 물줄기/NNG,23,1.887635369801026,Hawkish
13,8, 官/NNG,21,2.359544212251283,Hawkish
13,14, 얘깁니다/NNG,27,1.3483109784293044,Hawkish
15,7,정답/NNG,22,3.1114868732983947,Hawkish
23,23,인간/NNG,46,1.4520272075392506,Hawkish
10,6, 실적/NNG;기대/NNG;오르/VV,16,2.420045345898751,Hawkish
31,22, 채권입찰제/NNG,53,2.046038337896217,Hawkish
15,10,사업단/NNG,25,2.178040811308876,Hawkish
21,19, 호경기/NNG,40,1.604872176753909,Hawkish
28,22, 지음/NNG,50,1.8480346277772284,Hawkish
16,12,옮김/VV,28,1.9360362767190007,Hawkish
12,9, 지음/VV,21,1.9360362767190011,Hawkish
8,8, 가르쳐/VV,16,1.4520272075392506,Hawkish
21,1,파일/NNG,22,30.492571358324266,Hawkish
21,17, 경기/NNG;촉진/NNG,38,1.7936806681367214,Hawkish
10,8, 바닷속/NNG,18,1.8150340094240636,Hawkish
10,7,렌트/NNG,17,2.07432458219893,Hawkish
23,17, 노숙인/NNG,40,1.9645073984354566,Hawkish
10,10, 쪽방/NNG,20,1.4520272075392509,Hawkish
38,37, 재계약/NNG,75,1.4912711861213928,Hawkish
14,14,최장기/NNG,28,1.4520272075392509,Hawkish
19,21,압력/NNG,40,1.3137389020593222,Hawkish
12,11, 유가/NNG;위험/NNG,23,1.58402968095191,Hawkish
15,11, 투자/NNG;증가/NNG;둔화/NNG,26,1.9800371011898874,Hawkish
41,40, 북돋/VV,81,1.488327887727732,Hawkish
21,23, 침체/NNG;조짐/NNG,44,1.325763972101055,Hawkish
13,7, 단기/NNG;인플레이션/NNG;압력/NNG,20,2.6966219568586087,Hawkish
40,35,맞서/VV,75,1.6594596657591438,Hawkish
34,11,스톡옵션/NNG,45,4.488084096030412,Hawkish
18,19, 하락/NNG;원화/NNG;상승/NNG,37,1.375604722931922,Hawkish
21,17, 선도은행/NNG,38,1.7936806681367214,Hawkish
10,7,전설/NNG,17,2.07432458219893,Hawkish
8,8, 비농업/NNG;신규/NNG;일자리/NNG;증가/NNG,16,1.4520272075392506,Hawkish
13,9, 지수/NNG;낙폭/NNG;확대/NNG,22,2.097372633112251,Hawkish
52,54, 주택시장/NNG;냉각/NNG,106,1.3982484220748341,Hawkish
9,7, 투자심리/NNG;빨리/MAG;냉각/NNG,16,1.866892123979037,Hawkish
13,6, 필라델피아반도체지수/NNG;떨어/VV,19,3.1460589496683764,Hawkish
28,31,델파이/NNG,59,1.3115084455193233,Hawkish
9,7, 과열/NNG;우려/NNG;크/VV,16,1.866892123979037,Hawkish
80,81, 개별주/NNG,161,1.4341009457177787,Hawkish
16,16, 상승률/NNG;밑돌/VV,32,1.4520272075392506,Hawkish
31,20,광복/NNG,51,2.250642171685839,Hawkish
29,23, 관람권/NNG,52,1.830816913853838,Hawkish
16,2, 손녀/NNG,18,11.616217660314005,Hawkish
23,23, 관저/NNG,46,1.4520272075392506,Hawkish
14,3, 경축사/NNG,17,6.776126968516503,Hawkish
33,27, 특별사면/NNG,60,1.7746999203257507,Hawkish
14,12, 정례회/NNG,26,1.6940317421291258,Hawkish
11,11, 원자재/NNG;가격/NNG;부담/NNG,22,1.4520272075392509,Hawkish
13,10,바이아웃/NNG,23,1.887635369801026,Hawkish
9,9, 진정서/NNG,18,1.4520272075392509,Hawkish
18,18,하트/NNG,36,1.4520272075392509,Hawkish
9,8, 우일/NNG,17,1.6335306084816572,Hawkish
15,8, 재상/NNG,23,2.722551014136095,Hawkish
27,17, 경수로/NNG,44,2.3061608590329277,Hawkish
26,21, 북송/NNG,47,1.7977479712390725,Hawkish
26,18, 순이자마진/NNG;확대/NNG,44,2.097372633112251,Hawkish
9,9,아르/NNG,18,1.4520272075392509,Hawkish
10,8, 신관/NNG,18,1.8150340094240636,Hawkish
11,5, 실적/NNG;호조/NNG;힘입/VV;상승/NNG,16,3.1944598565863513,Hawkish
14,12,소집/NNG,26,1.6940317421291258,Hawkish
9,10,잠깐/MAG,19,1.3068244867853258,Hawkish
9,9,토/XSV,18,1.4520272075392509,Hawkish
14,12, 절정기/NNG,26,1.6940317421291258,Hawkish
12,10, 지급보증수수료/NNG,22,1.742432649047101,Hawkish
17,14, 급브레이크/NNG,31,1.7631758948690905,Hawkish
20,21, 고무줄/NNG,41,1.3828830547992865,Hawkish
17,18,관하/VV,35,1.3713590293426259,Hawkish
22,24, 경계수위/NNG,46,1.331024940244313,Hawkish
11,10, 지표/NNG;긴축/NNG,21,1.5972299282931757,Hawkish
28,26, 긴축/NNG;공포/NNG,54,1.5637216081191931,Hawkish
61,24, 통화정책발표문/NNG,85,3.6905691524955957,Hawkish
33,30, 급락/NNG;벗어나/VV,63,1.5972299282931757,Hawkish
9,7, 고용/NNG;지표/NNG;하락/NNG,16,1.866892123979037,Hawkish
9,7, 채산성/NNG;떨어/VV,16,1.866892123979037,Hawkish
25,27, 호감/NNG,52,1.3444696366104174,Hawkish
12,6, 성장/NNG;희생/NNG,18,2.9040544150785017,Hawkish
10,10,주택보급률/NNG,20,1.4520272075392509,Hawkish
23,21, 출두/NNG,44,1.5903155130191793,Hawkish
10,10,걸음/NNG,20,1.4520272075392509,Hawkish
16,12, 금리/NNG;오르/VV;이유/NNG;없/VA,28,1.9360362767190007,Hawkish
11,12,자율적/VAX,23,1.331024940244313,Hawkish
69,70,자문위원/NNG,139,1.4312839617172617,Hawkish
21,22, 신생기업/NNG,43,1.3860259708329212,Hawkish
203,216,창업/NNG,419,1.3646366811595736,Hawkish
17,15,고교/NNG,32,1.645630835211151,Hawkish
65,68, 성취/NNG,133,1.3879671836772247,Hawkish
10,9, 대출/NNG;잡/VV,19,1.6133635639325008,Hawkish
31,34, 적자/NNG;흑자/NNG,65,1.3239071598151992,Hawkish
36,31, 헌혈/NNG,67,1.6862251442391303,Hawkish
21,18, 금리/NNG;인상/NNG;환율/NNG;하락/NNG,39,1.6940317421291258,Hawkish
9,8, 은행/NNG;수익/NNG;감소/NNG,17,1.6335306084816572,Hawkish
12,11,모델포트폴리오/NNG,23,1.58402968095191,Hawkish
19,16, 채권/NNG;운용/NNG;금리/NNG;인상/NNG,35,1.7242823089528605,Hawkish
12,5, 뒷부분/NNG,17,3.484865298094202,Hawkish
12,9, 싱겁/VA,21,1.9360362767190011,Hawkish
50,1,난/NNG,51,72.60136037696255,Hawkish
10,8, 창세/NNG,18,1.8150340094240636,Hawkish
48,42,국경/NNG,90,1.6594596657591438,Hawkish
17,17, 안정/NNG;경기/NNG;회복/NNG,34,1.4520272075392509,Hawkish
22,24, 인터넷대출/NNG,46,1.331024940244313,Hawkish
28,30, 실적/NNG;호조/NNG;급등/NNG,58,1.3552253937033008,Hawkish
12,10, 실적발표/NNG;하락/NNG,22,1.742432649047101,Hawkish
18,20,딱/MAG,38,1.3068244867853258,Hawkish
13,14, 바삐/MAG,27,1.3483109784293044,Hawkish
9,10,잔뜩/MAG,19,1.3068244867853258,Hawkish
15,14,젠/NNG,29,1.5557434366491973,Hawkish
16,15, 심적/VAX,31,1.5488290213752007,Hawkish
21,20, 베이시스/NNG;개선/NNG,41,1.5246285679162133,Hawkish
11,11, 지수/NNG;상승/NNG;확대/NNG,22,1.4520272075392509,Hawkish
19,19, 합성선물/NNG,38,1.4520272075392509,Hawkish
15,6, 리버설/NNG,21,3.6300680188481267,Hawkish
41,26,감세정책/NNG,67,2.2897352118888183,Hawkish
9,10, 지표/NNG;경기/NNG;개선/NNG,19,1.3068244867853258,Hawkish
26,27, 경제/NNG;불확실/NNG,53,1.3982484220748341,Hawkish
22,16, 영업이익/NNG;급증/NNG,38,1.9965374103664697,Hawkish
14,6, 경기/NNG;회복/NNG;강하/VA;자신/NNG,20,3.3880634842582515,Hawkish
18,12,외조/NNG,30,2.1780408113088763,Hawkish
12,11, 국채/NNG;수익률/NNG;안정/NNG,23,1.58402968095191,Hawkish
10,11, 뒤쳐져/VV,21,1.3200247341265916,Hawkish
12,10, 기름/NNG;가격/NNG;상승/NNG,22,1.742432649047101,Hawkish
78,79, 취재/NNG,157,1.4336471163045768,Hawkish
23,20,수혜주/NNG,43,1.6698312886701383,Hawkish
10,9, 수요측면/NNG;상승/NNG;압력/NNG,19,1.6133635639325008,Hawkish
9,10, 가계/NNG;부담/NNG;증가/NNG,19,1.3068244867853258,Hawkish
23,23, 하락/NNG;밀리/VV,46,1.4520272075392506,Hawkish
12,13, 영세업자/NNG,25,1.3403328069593086,Hawkish
44,42, 기업/NNG;이익/NNG;성장/NNG,86,1.5211713602792152,Hawkish
11,9, 주먹/NNG,20,1.774699920325751,Hawkish
17,18, 자장면/NNG,35,1.3713590293426259,Hawkish
10,9, 금리/NNG;대출/NNG;금리/NNG;높/VA,19,1.6133635639325008,Hawkish
13,9, 휴가제/NNG,22,2.097372633112251,Hawkish
71,73, 특별공급/NNG,144,1.4122456402094086,Hawkish
31,31, 생활필수품/NNG,62,1.452027207539251,Hawkish
11,11, 금리/NNG;인상/NNG;발목/NNG;잡/VV,22,1.4520272075392509,Hawkish
11,11, 불확실성/NNG;덜/VV,22,1.4520272075392509,Hawkish
28,19, 금리/NNG;목표/NNG;오르/VV,47,2.1398295690052116,Hawkish
10,8,일제/NNG,18,1.8150340094240636,Hawkish
14,12, 하달/NNG,26,1.6940317421291258,Hawkish
26,29,북측/NNG,55,1.3018174964145008,Hawkish
24,22, 분단/NNG,46,1.58402968095191,Hawkish
25,15, 경제/NNG;지표/NNG;경제/NNG;성장/NNG,40,2.4200453458987514,Hawkish
16,8, 금리/NNG;길/VA,24,2.9040544150785013,Hawkish
11,12, 得/NNG,23,1.331024940244313,Hawkish
9,7, 영화배우/NNG,16,1.866892123979037,Hawkish
14,13, 탤런트/NNG,27,1.5637216081191931,Hawkish
9,9, 타산/NNG,18,1.4520272075392509,Hawkish
12,12, 용강/NNG,24,1.4520272075392509,Hawkish
28,21, v자형/NNG;상승/NNG,49,1.9360362767190011,Hawkish
11,5, 금리/NNG;상단/NNG;하단/NNG,16,3.1944598565863513,Hawkish
27,29,남창/NNG,56,1.3518874001227508,Hawkish
12,12, 주택시장/NNG;경착륙/NNG,24,1.4520272075392509,Hawkish
27,29, 구매력/NNG;떨어/VV,56,1.3518874001227508,Hawkish
23,15, 원자재/NNG;가격/NNG;인상/NNG,38,2.2264417182268508,Hawkish
12,11, 만석/NNG,23,1.58402968095191,Hawkish
54,49, 후계/NNG,103,1.6001932491248887,Hawkish
9,8, 옐로칩/NNG,17,1.6335306084816572,Hawkish
10,11, 지수/NNG;오르/VV;그치/VV,21,1.3200247341265916,Hawkish
12,13, 우려/NNG;사그러들/VV;않/VX,25,1.3403328069593086,Hawkish
10,7, 유머/NNG,17,2.07432458219893,Hawkish
10,11, 셔츠/NNG,21,1.3200247341265916,Hawkish
11,12,파생금융상품/NNG,23,1.331024940244313,Hawkish
12,10, ecb/NNG;금리/NNG;인상/NNG;가능성/NNG;높/VA,22,1.742432649047101,Hawkish
652,571, 용익/NNG,1223,1.6580065487138205,Hawkish
30,33, 원부자재/NNG,63,1.3200247341265916,Hawkish
11,8, 하락/NNG;경기/NNG;침체/NNG,19,1.9965374103664697,Hawkish
8,8, 국제/NNG;유가/NNG;하락/NNG;상승/NNG,16,1.4520272075392506,Hawkish
12,8, 스테이션/NNG,20,2.1780408113088763,Hawkish
15,16,종종/MAG,31,1.3612755070680476,Hawkish
11,8, 원권/NNG,19,1.9965374103664697,Hawkish
39,43,낙폭과대/NNG,82,1.3169549091635064,Hawkish
11,11, 지표/NNG;예상/NNG;상회/NNG,22,1.4520272075392509,Hawkish
9,7, 주춤거릴/VV,16,1.866892123979037,Hawkish
24,22, 하락/NNG;멈추/VV;않/VX,46,1.58402968095191,Hawkish
11,5, 제조업/NNG;안정/NNG,16,3.1944598565863513,Hawkish
9,10, 관계회사/NNG,19,1.3068244867853258,Hawkish
73,78,연이/VV,151,1.358948540389299,Hawkish
24,20, 반지/NNG,44,1.742432649047101,Hawkish
25,21, 전시장/NNG,46,1.7286038184991082,Hawkish
9,8, 崔/NNG,17,1.6335306084816572,Hawkish
27,23, 國/NNG,50,1.7045536784156423,Hawkish
9,9, 궁전/NNG,18,1.4520272075392509,Hawkish
28,26,레/NNG,54,1.5637216081191931,Hawkish
20,7, 조동/NNG,27,4.14864916439786,Hawkish
10,9, 주택/NNG;판매가격/NNG;줄/VV,19,1.6133635639325008,Hawkish
10,9, 지국/NNG,19,1.6133635639325008,Hawkish
23,22, 휘발유/NNG;가격/NNG;오르/VV,45,1.5180284442455803,Hawkish
14,6, 변동성/NNG;지나치/VA;확대/NNG,20,3.3880634842582515,Hawkish
25,15,학군/NNG,40,2.4200453458987514,Hawkish
9,10, 굶/VV,19,1.3068244867853258,Hawkish
27,26, 신생아/NNG,53,1.5078744078292219,Hawkish
12,8, 외화표시자산/NNG,20,2.1780408113088763,Hawkish
29,32, 가계/NNG;대출/NNG;금리/NNG;상승/NNG,61,1.315899656832446,Hawkish
31,26, 백지화/NNG,57,1.731263208989107,Hawkish
12,11, 지방세법/NNG,23,1.58402968095191,Hawkish
14,5, 적립식펀드투자/NNG,19,4.065676181109902,Hawkish
17,18, 사업주체/NNG,35,1.3713590293426259,Hawkish
12,4,이표채/NNG,16,4.356081622617753,Hawkish
9,9,남쪽/NNG,18,1.4520272075392509,Hawkish
19,21, 역자산효과/NNG,40,1.3137389020593222,Hawkish
16,17, 꺼리/NNG,33,1.3666138423898828,Hawkish
98,109,순서/NNG,207,1.3054923517325376,Hawkish
10,9,물질/NNG,19,1.6133635639325008,Hawkish
23,25,쟁점/NNG,48,1.3358650309361106,Hawkish
11,12, 비켜갔/VV,23,1.331024940244313,Hawkish
13,9, 대출/NNG;한도/NNG;높/VA,22,2.097372633112251,Hawkish
12,13, 과신/NNG,25,1.3403328069593086,Hawkish
19,12, 미꾸라지/NNG,31,2.299043078603814,Hawkish
30,31, 달래/NNG,61,1.405187620199275,Hawkish
10,11,하이테크/NNG,21,1.3200247341265916,Hawkish
15,14, 스카우트/NNG,29,1.5557434366491973,Hawkish
10,6, 통계학/NNG,16,2.420045345898751,Hawkish
37,37, 북상/NNG,74,1.4520272075392509,Hawkish
9,9, 소비자/NNG;지출/NNG;줄/VV,18,1.4520272075392509,Hawkish
10,8, 호환/NNG,18,1.8150340094240636,Hawkish
14,13, 렘/NNG,27,1.5637216081191931,Hawkish
37,36,현금흐름/NNG,73,1.4923612966375635,Hawkish
11,10, 새롭/VA;악재/NNG;아니/VCN,21,1.5972299282931757,Hawkish
10,8, 덮쳐/VV,18,1.8150340094240636,Hawkish
14,15, 딱딱/NNG,29,1.3552253937033008,Hawkish
17,8, 뱀/NNG,25,3.0855578160209083,Hawkish
16,16, 베이시스/NNG;하락/NNG,32,1.4520272075392506,Hawkish
75,67,연립/NNG,142,1.6254035905290123,Hawkish
12,12, 물가/NNG;상승/NNG;경기/NNG;회복/NNG,24,1.4520272075392509,Hawkish
10,8, 인플레이션/NNG;압력/NNG;통제/NNG,18,1.8150340094240636,Hawkish
22,20, 경제/NNG;견실/NNG,42,1.5972299282931757,Hawkish
13,11, 흘러내렸/VV,24,1.7160321543645694,Hawkish
10,9, 많/VA;적자/NNG,19,1.6133635639325008,Hawkish
29,31, 주식매입자금/NNG,60,1.3583480328592992,Hawkish
13,6, 은행/NNG;지준율/NNG;상향/NNG,19,3.1460589496683764,Hawkish
17,11, 인플레이션/NNG;차단/NNG,28,2.244042048015206,Hawkish
12,12, 기혼/NNG,24,1.4520272075392509,Hawkish
24,23, 모지기/NNG,47,1.5151588252583488,Hawkish
18,16, 최대/NNG;급락/NNG,34,1.6335306084816572,Hawkish
12,10, 경제/NNG;성장/NNG;악영향/NNG,22,1.742432649047101,Hawkish
12,12, 스트레이츠타임스지수/NNG,24,1.4520272075392509,Hawkish
35,35,뉴타운/NNG,70,1.4520272075392509,Hawkish
10,10, 뿌리내릴/VV,20,1.4520272075392509,Hawkish
12,9,양도/NNG,21,1.9360362767190011,Hawkish
28,26,취득/NNG,54,1.5637216081191931,Hawkish
10,8, 무역/NNG;흑자/NNG;증가/NNG,18,1.8150340094240636,Hawkish
13,12, 물씬/MAG,25,1.5730294748341882,Hawkish
14,3, 신종mmf/NNG,17,6.776126968516503,Hawkish
10,10, 분양시장/NNG;위축/NNG,20,1.4520272075392509,Hawkish
9,8, 이뤘으나/VV,17,1.6335306084816572,Hawkish
15,15, 노부모/NNG,30,1.4520272075392506,Hawkish
12,11,취/NNG,23,1.58402968095191,Hawkish
14,15, 기대수익률/NNG;하락/NNG,29,1.3552253937033008,Hawkish
16,14, 환위험/NNG;회피/NNG,30,1.6594596657591438,Hawkish
27,29,비차익거래/NNG,56,1.3518874001227508,Hawkish
25,24,유료/NNG,49,1.5125283411867194,Hawkish
38,30,강타/NNG,68,1.839234462883051,Hawkish
21,17, 각축/NNG,38,1.7936806681367214,Hawkish
27,26, 주택처분/NNG,53,1.5078744078292219,Hawkish
22,16, 외환시장/NNG;달러원/NNG;급락/NNG,38,1.9965374103664697,Hawkish
15,9, 우려/NNG;크/VV;금리/NNG;인상/NNG,24,2.420045345898751,Hawkish
12,5, 전매/NNG;제한/NNG;강화/NNG,17,3.484865298094202,Hawkish
36,36, 보상비/NNG,72,1.4520272075392509,Hawkish
22,19,재건축시장/NNG,41,1.6812946613612378,Hawkish
12,11, 풀릴지/VV,23,1.58402968095191,Hawkish
10,10, 풍전등화/NNG,20,1.4520272075392509,Hawkish
12,8, 불안/NNG;금리/NNG;오르/VV,20,2.1780408113088763,Hawkish
47,32, 경제/NNG;지표/NNG;경기/NNG;회복/NNG,79,2.1326649610732744,Hawkish
24,11,복구/NNG,35,3.16805936190382,Hawkish
10,7, 수재민/NNG,17,2.07432458219893,Hawkish
26,14,비서관/NNG,40,2.6966219568586087,Hawkish
18,11, 전세/NNG;수요/NNG;늘/VV,29,2.376044521427865,Hawkish
11,9, 단기/NNG;상승/NNG;부담/NNG,20,1.774699920325751,Hawkish
13,9, 확실/NNG;모멘텀/NNG,22,2.097372633112251,Hawkish
13,8, 타성/NNG,21,2.359544212251283,Hawkish
22,20, 팔려나갔/VV,42,1.5972299282931757,Hawkish
20,19, 지수/NNG;웃돌/VV,39,1.5284496921465798,Hawkish
25,19, 타격/NNG;입/VV;우려/NNG,44,1.9105621151832248,Hawkish
12,13,주식담보대출/NNG,25,1.3403328069593086,Hawkish
10,9, 선제/NNG;콜/NNG;금리/NNG;인상/NNG,19,1.6133635639325008,Hawkish
14,11, 이재민/NNG,25,1.8480346277772284,Hawkish
12,13, 박/NNG,25,1.3403328069593086,Hawkish
20,14, 현금흐름/NNG;좋/VA,34,2.07432458219893,Hawkish
12,11, 빌려와/VV,23,1.58402968095191,Hawkish
12,12,운용자금/NNG,24,1.4520272075392509,Hawkish
13,8,전적/NNG,21,2.359544212251283,Hawkish
12,10, 가계/NNG;지출/NNG;늘/VV,22,1.742432649047101,Hawkish
19,19,비해선/VV,38,1.4520272075392509,Hawkish
8,8, 내국세/NNG,16,1.4520272075392506,Hawkish
9,7, 금리/NNG;인상/NNG;경기/NNG;위축/NNG,16,1.866892123979037,Hawkish
19,14, 물류비용/NNG,33,1.9706083530889835,Hawkish
12,11, 경기/NNG;침체/NNG;물가/NNG;상승/NNG,23,1.58402968095191,Hawkish
13,11, 최고점/NNG;오르/VV,24,1.7160321543645694,Hawkish
14,11, 홀드/NNG,25,1.8480346277772284,Hawkish
19,19, 팟/NNG,38,1.4520272075392509,Hawkish
10,6, 전세가격/NNG;불안/NNG,16,2.420045345898751,Hawkish
24,26, 수요/NNG;떨어/VV,50,1.3403328069593086,Hawkish
10,8, 경기/NNG;침체/NNG;없/VA,18,1.8150340094240636,Hawkish
58,52,당좌/NNG,110,1.6195688084091644,Hawkish
9,10, 경기/NNG;변동성/NNG;크/VV,19,1.3068244867853258,Hawkish
9,10, 물가/NNG;목표/NNG;낮/VV,19,1.3068244867853258,Hawkish
40,33,예정이율/NNG,73,1.7600329788354554,Hawkish
8,8, 부동산/NNG;가격/NNG;오름/NNG;둔화/NNG,16,1.4520272075392506,Hawkish
9,8, 인플레이션/NNG;위험/NNG;차단/NNG,17,1.6335306084816572,Hawkish
18,16, 움츠렸/VV,34,1.6335306084816572,Hawkish
21,22,최우선/NNG,43,1.3860259708329212,Hawkish
14,13, 물가/NNG;상승/NNG;크/VV,27,1.5637216081191931,Hawkish
15,15,실현/NNG,30,1.4520272075392506,Hawkish
13,12, 경기/NNG;억제/NNG,25,1.5730294748341882,Hawkish
20,10, 금리/NNG;인상/NNG;그치/VV;않/VX,30,2.9040544150785017,Hawkish
30,14, fed/NNG;인플레이션/NNG;위험/NNG,44,3.1114868732983947,Hawkish
9,7, 지표/NNG;늘/VV,16,1.866892123979037,Hawkish
48,35, 균형환율/NNG,83,1.9913515989109727,Hawkish
21,13,매수의견/NNG,34,2.3455824121787896,Hawkish
14,10, 달군/VV,24,2.032838090554951,Hawkish
23,16, 동일점/NNG;매출/NNG;늘/VV,39,2.087289110837673,Hawkish
16,16, 느껴진다고/VV,32,1.4520272075392506,Hawkish
59,17, 탈레반/NNG,76,5.039388543812693,Hawkish
13,12, 여국/NNG,25,1.5730294748341882,Hawkish
11,11, 관세화유예/NNG,22,1.4520272075392509,Hawkish
11,6, 코드인사/NNG,17,2.662049880488626,Hawkish
13,13,각사/NNG,26,1.4520272075392509,Hawkish
10,8,목표지수/NNG,18,1.8150340094240636,Hawkish
14,8, 경제/NNG;성장/NNG;견고/NNG,22,2.541047613193689,Hawkish
15,16, 독성/NNG,31,1.3612755070680476,Hawkish
10,11, 기업/NNG;이자/NNG;부담/NNG,21,1.3200247341265916,Hawkish
12,9,닭/NNG,21,1.9360362767190011,Hawkish
37,39,응찰금액/NNG,76,1.3775642738192893,Hawkish
15,10, 콜/NNG;금리/NNG;인상/NNG;없/VA,25,2.178040811308876,Hawkish
13,14,접촉/NNG,27,1.3483109784293044,Hawkish
13,9, 경제/NNG;성장률/NNG;예상/NNG;웃돌/VV,22,2.097372633112251,Hawkish
24,23, 경기/NNG;가라앉/VV,47,1.5151588252583488,Hawkish
9,9,우연/NNG,18,1.4520272075392509,Hawkish
15,12, 직함/NNG,27,1.8150340094240633,Hawkish
10,7, 매우/MAG;경기/NNG;부양/NNG,17,2.07432458219893,Hawkish
20,22, 스타지수/NNG,42,1.3200247341265916,Hawkish
17,10, 실물인수도/NNG,27,2.4684462528167264,Hawkish
23,18, 끼워팔기/NNG,41,1.855368098522376,Hawkish
83,85, 관리목표/NNG,168,1.4178618614795038,Hawkish
13,14, 세계/NNG;경제/NNG;최대/NNG,27,1.3483109784293044,Hawkish
17,14,엠/NNG,31,1.7631758948690905,Hawkish
19,18, 근해/NNG,37,1.5326953857358758,Hawkish
21,12, 기체/NNG,33,2.5410476131936885,Hawkish
13,5, 순안/NNG,18,3.775270739602052,Hawkish
11,7, 접견실/NNG,18,2.2817570404188228,Hawkish
9,7,재청/NNG,16,1.866892123979037,Hawkish
8,8, 방재/NNG,16,1.4520272075392506,Hawkish
116,128,임직원/NNG,244,1.315899656832446,Hawkish
39,32, 응용/NNG,71,1.769658159188462,Hawkish
8,8,짚/VV,16,1.4520272075392506,Hawkish
17,15, 선급금/NNG,32,1.645630835211151,Hawkish
16,15,자본지출/NNG,31,1.5488290213752007,Hawkish
15,10,알짜/NNG,25,2.178040811308876,Hawkish
41,44, 명문/NNG,85,1.3530253524797564,Hawkish
80,57, 아프간/NNG,137,2.0379329228621064,Hawkish
23,16, 요주의여신/NNG,39,2.087289110837673,Hawkish
21,22, 무어/NNG,43,1.3860259708329212,Hawkish
11,5, 인플레이션/NNG;경계/NNG;늦/VV;않/VX,16,3.1944598565863513,Hawkish
25,23, 들여놓/VV,48,1.5782904429774465,Hawkish
27,15, 막대/NNG;무역/NNG;흑자/NNG,42,2.613648973570651,Hawkish
22,21, 투자율/NNG,43,1.5211713602792152,Hawkish
48,53, a-등급/NNG,101,1.3150435087147934,Hawkish
11,7, 자산/NNG;가격/NNG;과열/NNG,18,2.2817570404188228,Hawkish
64,64, 주택시장/NNG;둔화/NNG,128,1.4520272075392506,Hawkish
9,7, 쉰다/VV,16,1.866892123979037,Hawkish
14,12,경보/NNG,26,1.6940317421291258,Hawkish
9,8, 지수/NNG;상승/NNG;줄/VV,17,1.6335306084816572,Hawkish
15,9, 실적/NNG;모멘텀/NNG;강화/NNG,24,2.420045345898751,Hawkish
13,13, 異/NNG,26,1.4520272075392509,Hawkish
10,6,겉보기/NNG,16,2.420045345898751,Hawkish
13,11, 금리/NNG;인상/NNG;인플레이션/NNG;우려/NNG,24,1.7160321543645694,Hawkish
17,7, 가계/NNG;대출/NNG;이자/NNG;부담/NNG,24,3.526351789738181,Hawkish
60,51, cd/NNG;금리/NNG;급등/NNG,111,1.7082673029873536,Hawkish
677,643,서브프라임/NNG,1320,1.5288062511727416,Hawkish
11,9,흑인/NNG,20,1.774699920325751,Hawkish
20,16, 국제/NNG;유가/NNG;금리/NNG;인상/NNG,36,1.8150340094240636,Hawkish
12,8, 사로잡혔/VV,20,2.1780408113088763,Hawkish
12,13, 신흥시장/NNG;선호/NNG,25,1.3403328069593086,Hawkish
17,18, 물가고/NNG,35,1.3713590293426259,Hawkish
113,125,황금/NNG,238,1.3126325956154827,Hawkish
13,8, 끄떡/MAG,21,2.359544212251283,Hawkish
25,24, mmf/NNG;자금/NNG;이탈/NNG,49,1.5125283411867194,Hawkish
74,74, 통화/NNG;완화정책/NNG;종료/NNG,148,1.4520272075392509,Hawkish
14,15, 지수/NNG;흔들/VV,29,1.3552253937033008,Hawkish
13,9, 건설업지수/NNG,22,2.097372633112251,Hawkish
11,8, 실용화/NNG,19,1.9965374103664697,Hawkish
13,12, 관리기금/NNG,25,1.5730294748341882,Hawkish
15,16,핵무기/NNG,31,1.3612755070680476,Hawkish
13,6, 디스카운트/NNG;요인/NNG;해소/NNG,19,3.1460589496683764,Hawkish
15,3, 북핵/NNG;지정학/NNG;위험/NNG,18,7.260136037696253,Hawkish
14,10, 춰/VV,24,2.032838090554951,Hawkish
19,13, 북한리스크/NNG;해소/NNG,32,2.122193611018905,Hawkish
16,13,가락/NNG,29,1.7871104092790777,Hawkish
34,32, 지켜봐/VV,66,1.5427789080104541,Hawkish
12,11,제3자/NNG,23,1.58402968095191,Hawkish
17,16, 발했/VV,33,1.5427789080104541,Hawkish
130,22, 리타/NNG,152,8.580160771822845,Hawkish
54,60,정국/NNG,114,1.3068244867853256,Hawkish
10,9, 투자심리/NNG;꺾/VV,19,1.6133635639325008,Hawkish
19,2, 이미/MAG;콜/NNG;금리/NNG;인상/NNG,21,13.794258471622884,Hawkish
8,8, 상승률/NNG;안정/NNG,16,1.4520272075392506,Hawkish
26,20,국무/NNG,46,1.887635369801026,Hawkish
12,8,유찰/NNG,20,2.1780408113088763,Hawkish
9,9, 굴러떨어졌/VV,18,1.4520272075392509,Hawkish
21,14, 탐탁/NNG,35,2.1780408113088763,Hawkish
18,13, 종래/MAG,31,2.010499210438963,Hawkish
46,34,외/NNG,80,1.9645073984354566,Hawkish
32,35, 경제/NNG;하락/NNG;위험/NNG,67,1.327567732607315,Hawkish
12,6, 외평채/NNG;스프레드/NNG;하락/NNG,18,2.9040544150785017,Hawkish
12,11,돌리/VV,23,1.58402968095191,Hawkish
16,17,서킷/NNG,33,1.3666138423898828,Hawkish
13,11, 틈바구니/NNG,24,1.7160321543645694,Hawkish
21,14, 미/NNG;경제/NNG;금리/NNG;인상/NNG,35,2.1780408113088763,Hawkish
18,11, 롱텀캐피털매니지먼트/NNG,29,2.376044521427865,Hawkish
31,20, 인플레이션/NNG;경고/NNG,51,2.250642171685839,Hawkish
14,10,확정금리형/NNG,24,2.032838090554951,Hawkish
20,20, 경제/NNG;성장률/NNG;웃돌/VV,40,1.4520272075392509,Hawkish
26,24, 연합군/NNG,50,1.5730294748341882,Hawkish
18,9, 미관/NNG,27,2.9040544150785017,Hawkish
8,8, 간장/NNG,16,1.4520272075392506,Hawkish
11,10, 다이옥신/NNG,21,1.5972299282931757,Hawkish
16,13,활황/NNG,29,1.7871104092790777,Hawkish
12,12, cac40/NNG;지수/NNG;하락/NNG,24,1.4520272075392509,Hawkish
38,37,신제품/NNG,75,1.4912711861213928,Hawkish
27,20,책임자/NNG,47,1.9602367301779884,Hawkish
95,99, 컨트리/NNG,194,1.393359441578069,Hawkish
20,18,국민주택/NNG,38,1.6133635639325008,Hawkish
12,7, 苦/NNG,19,2.489189498638716,Hawkish
17,4, 스크린쿼터/NNG,21,6.171115632041817,Hawkish
13,11, 배소/NNG,24,1.7160321543645694,Hawkish
9,8, 번거롭/VA,17,1.6335306084816572,Hawkish
14,14, 이저리/MAG,28,1.4520272075392509,Hawkish
10,11, 선도자/NNG,21,1.3200247341265916,Hawkish
12,11, 총거래량/NNG,23,1.58402968095191,Hawkish
18,9, 지표/NNG;일시적/VAX,27,2.9040544150785017,Hawkish
10,8, 유가/NNG;급등/NNG;우려/NNG,18,1.8150340094240636,Hawkish
11,8, 로더/NNG,19,1.9965374103664697,Hawkish
13,10, 주택/NNG;수요/NNG;둔화/NNG,23,1.887635369801026,Hawkish
21,18, 인플레이션/NNG;기대/NNG;크/VV,39,1.6940317421291258,Hawkish
24,23,반대표/NNG,47,1.5151588252583488,Hawkish
22,15, 고꾸라질/VV,37,2.129639904390901,Hawkish
28,26, 수인/NNG,54,1.5637216081191931,Hawkish
34,5,리타/NNG,39,9.873785011266905,Hawkish
23,23, 고질병/NNG,46,1.4520272075392506,Hawkish
25,27, 경기/NNG;견조/NNG,52,1.3444696366104174,Hawkish
33,34,미치/VV,67,1.4093205249645666,Hawkish
13,8, 여대생/NNG,21,2.359544212251283,Hawkish
43,36, 금리/NNG;오르/VV;부담/NNG,79,1.7343658312274384,Hawkish
14,9, 전세/NNG;수요/NNG;증가/NNG,23,2.258708989505501,Hawkish
11,11,요동치/VV,22,1.4520272075392509,Hawkish
17,6, 금리/NNG;선제/NNG;오르/VV,23,4.114077088027877,Hawkish
9,10,심상/NNG,19,1.3068244867853258,Hawkish
26,24,영역/NNG,50,1.5730294748341882,Hawkish
10,7, 금리/NNG;인상/NNG;여파/NNG;하락/NNG,17,2.07432458219893,Hawkish
18,20, 고단위/NNG,38,1.3068244867853258,Hawkish
126,97, 원화/NNG;환율/NNG;오르/VV,223,1.8861384345355219,Hawkish
13,9, 통안채/NNG;오르/VV;상승/NNG,22,2.097372633112251,Hawkish
18,14, 이익구조/NNG,32,1.866892123979037,Hawkish
12,11,채권비중/NNG,23,1.58402968095191,Hawkish
31,28,개/NNG,59,1.6076015512041708,Hawkish
11,8, 전망/NNG;지수/NNG;하락/NNG,19,1.9965374103664697,Hawkish
9,10,부도율/NNG,19,1.3068244867853258,Hawkish
23,18,발행조건/NNG,41,1.855368098522376,Hawkish
10,10, 불안해할/VV,20,1.4520272075392509,Hawkish
13,10, 빠져나갈지/VV,23,1.887635369801026,Hawkish
13,9, 피난/NNG,22,2.097372633112251,Hawkish
18,9, 초본/NNG,27,2.9040544150785017,Hawkish
12,12, 변호사법/NNG,24,1.4520272075392509,Hawkish
14,4,도덕/NNG,18,5.082095226387378,Hawkish
24,25, 앞바다/NNG,49,1.393946119237681,Hawkish
18,18, 걸림돌/NNG;없/VA,36,1.4520272075392509,Hawkish
20,17,車/NNG,37,1.7082673029873539,Hawkish
13,13, 소비/NNG;지표/NNG;악화/NNG,26,1.4520272075392509,Hawkish
9,7, 경기/NNG;지표/NNG;금리/NNG;인상/NNG,16,1.866892123979037,Hawkish
9,10,선고/NNG,19,1.3068244867853258,Hawkish
20,15, 욕설/NNG,35,1.936036276719001,Hawkish
19,12,세력/NNG,31,2.299043078603814,Hawkish
19,18, 대손충당금/NNG;부담/NNG,37,1.5326953857358758,Hawkish
9,7, 이자부부채/NNG,16,1.866892123979037,Hawkish
24,24, 갑부/NNG,48,1.4520272075392509,Hawkish
24,25, 지표/NNG;경계/NNG,49,1.393946119237681,Hawkish
22,23, 향락/NNG,45,1.388895589820153,Hawkish
24,25,대폭/MAG,49,1.393946119237681,Hawkish
10,10, 쌍봉/NNG,20,1.4520272075392509,Hawkish
19,19, 전인미답/NNG,38,1.4520272075392509,Hawkish
28,28, 수신/NNG;금리/NNG;오르/VV,56,1.4520272075392509,Hawkish
15,14, 우르르/MAG,29,1.5557434366491973,Hawkish
10,6, 내준다/VV,16,2.420045345898751,Hawkish
11,9,산술/NNG,20,1.774699920325751,Hawkish
12,6, 문민정부/NNG,18,2.9040544150785017,Hawkish
17,17,사회안전망/NNG,34,1.4520272075392509,Hawkish
31,29, 짠/VV,60,1.552167014955751,Hawkish
16,11, 재정정책/NNG;긴축/NNG,27,2.1120395746025467,Hawkish
46,51,월비/NNG,97,1.3096715989569712,Hawkish
14,9,쌀가격/NNG,23,2.258708989505501,Hawkish
19,7, 석유비축/NNG,26,3.941216706177967,Hawkish
83,87,국방/NNG,170,1.3852673359282508,Hawkish
18,19, 공적개발원조/NNG,37,1.375604722931922,Hawkish
17,17, 다뤄졌/VV,34,1.4520272075392509,Hawkish
11,9, 유로존/NNG;인플레이션/NNG;우려/NNG,20,1.774699920325751,Hawkish
16,8, 물가/NNG;상승/NNG;확산/NNG,24,2.9040544150785013,Hawkish
9,9, 펴지/VV,18,1.4520272075392509,Hawkish
17,12, 흑자/NNG;추세/NNG,29,2.0570385440139387,Hawkish
10,10, 대외/NNG;신인도/NNG;개선/NNG,20,1.4520272075392509,Hawkish
12,10, 근원/NNG;소비자/NNG;물가/NNG;안정/NNG,22,1.742432649047101,Hawkish
8,8, 주택담보대출/NNG;둔화/NNG,16,1.4520272075392506,Hawkish
105,77,전세시장/NNG,182,1.9800371011898874,Hawkish
10,11, 살까/VV,21,1.3200247341265916,Hawkish
28,30, 은행가협회/NNG,58,1.3552253937033008,Hawkish
14,15, 換/NNG,29,1.3552253937033008,Hawkish
9,9, 친환경농산물/NNG,18,1.4520272075392509,Hawkish
15,12, 세유/NNG,27,1.8150340094240633,Hawkish
9,8, 금리/NNG;인상/NNG;적절/NNG;않/VX,17,1.6335306084816572,Hawkish
9,9, 집값/NNG;하향/NNG;안정/NNG,18,1.4520272075392509,Hawkish
12,12, 소비/NNG;심리/NNG;최악/NNG,24,1.4520272075392509,Hawkish
10,10, 흘러들어온/VV,20,1.4520272075392509,Hawkish
24,15, 이자/NNG;상환/NNG;부담/NNG;크/VV,39,2.3232435320628015,Hawkish
36,38,마이/MAG,74,1.375604722931922,Hawkish
9,10, 금리/NNG;인상/NNG;무산/NNG,19,1.3068244867853258,Hawkish
18,12, 만금/NNG,30,2.1780408113088763,Hawkish
17,17, 공탁금/NNG,34,1.4520272075392509,Hawkish
17,18, 준공식/NNG,35,1.3713590293426259,Hawkish
11,6,카르/NNG,17,2.662049880488626,Hawkish
26,26, 전력난/NNG,52,1.4520272075392509,Hawkish
11,10, 개발원조/NNG,21,1.5972299282931757,Hawkish
14,11, 마이너스/NNG;벗어나/VV;못하/VX,25,1.8480346277772284,Hawkish
18,4, 많이/MAG;오르/VV;부담/NNG,22,6.534122433926629,Hawkish
170,187,과잉/NNG,357,1.3200247341265916,Hawkish
13,8, 착하/VA,21,2.359544212251283,Hawkish
11,7, 팽창/NNG;막/VV,18,2.2817570404188228,Hawkish
11,12, 달굴/VV,23,1.331024940244313,Hawkish
18,18,소환/NNG,36,1.4520272075392509,Hawkish
10,10, 펴냈/VV,20,1.4520272075392509,Hawkish
32,31, 제로금리정책/NNG;종료/NNG,63,1.4988667948792267,Hawkish
21,15,福/NNG,36,2.032838090554951,Hawkish
34,28, 井/NNG,62,1.7631758948690905,Hawkish
25,19, 俊彦/NNG,44,1.9105621151832248,Hawkish
9,10, 구색/NNG,19,1.3068244867853258,Hawkish
10,6, 할인가격/NNG,16,2.420045345898751,Hawkish
9,9, 가격/NNG;증대/NNG,18,1.4520272075392509,Hawkish
26,29, 속담/NNG,55,1.3018174964145008,Hawkish
28,31,위험요인/NNG,59,1.3115084455193233,Hawkish
16,16, 마켓메이커/NNG,32,1.4520272075392506,Hawkish
22,17, 네트/NNG,39,1.879094033286089,Hawkish
24,12, 메세지/NNG,36,2.9040544150785017,Hawkish
16,13, 기업/NNG;실적/NNG;타격/NNG,29,1.7871104092790777,Hawkish
52,36, 의왕/NNG,88,2.097372633112251,Hawkish
24,11,전매/NNG,35,3.16805936190382,Hawkish
13,10, 재정/NNG;적자/NNG;급증/NNG,23,1.887635369801026,Hawkish
10,10, 위험/NNG;최대/NNG,20,1.4520272075392509,Hawkish
23,18,입금/NNG,41,1.855368098522376,Hawkish
16,13, 벌어들일/VV,29,1.7871104092790777,Hawkish
9,10, 좋/VA;밖/NNG;없/VA,19,1.3068244867853258,Hawkish
11,9, 대외/NNG;여건/NNG;나쁘/VA,20,1.774699920325751,Hawkish
62,67, 판매대수/NNG,129,1.3436669681706501,Hawkish
21,12, 귀신/NNG,33,2.5410476131936885,Hawkish
11,11, 주택가격/NNG;상승률/NNG;둔화/NNG,22,1.4520272075392509,Hawkish
12,10, 콜/NNG;금리/NNG;인상/NNG;가능성/NNG;높/VA,22,1.742432649047101,Hawkish
12,13,시야/NNG,25,1.3403328069593086,Hawkish
25,27, 적자/NNG;늘/VV,52,1.3444696366104174,Hawkish
44,39, 소비자/NNG;물가/NNG;상승률/NNG;넘/VV,83,1.6381845418391547,Hawkish
12,5, 인플레이션/NNG;위험/NNG;경고/NNG,17,3.484865298094202,Hawkish
12,10,원주/NNG,22,1.742432649047101,Hawkish
15,12, 진흙탕/NNG,27,1.8150340094240633,Hawkish
14,14, 실적발표/NNG;상승/NNG,28,1.4520272075392509,Hawkish
16,15, ecb/NNG;물가/NNG;상승/NNG,31,1.5488290213752007,Hawkish
14,4, 금리/NNG;인상/NNG;콜/NNG;금리/NNG;인상/NNG,18,5.082095226387378,Hawkish
13,11,고액권/NNG,24,1.7160321543645694,Hawkish
35,27,산타랠리/NNG,62,1.8822574912545844,Hawkish
15,9, 글로벌/NNG;증시/NNG;금리/NNG;인상/NNG,24,2.420045345898751,Hawkish
8,8,틈새시장/NNG,16,1.4520272075392506,Hawkish
39,23,납/NNG,62,2.4621330910448167,Hawkish
11,9, 한성/NNG,20,1.774699920325751,Hawkish
24,14,정부과천청사/NNG,38,2.489189498638716,Hawkish
12,13, 모락모락/MAG,25,1.3403328069593086,Hawkish
16,16, ecb/NNG;인플레이션/NNG;우려/NNG,32,1.4520272075392506,Hawkish
9,7,히/VV,16,1.866892123979037,Hawkish
9,7, 지표/NNG;물가/NNG;상승/NNG,16,1.866892123979037,Hawkish
38,32,타임/NNG,70,1.7242823089528605,Hawkish
28,30,특유/NNG,58,1.3552253937033008,Hawkish
32,34,즉각/MAG,66,1.3666138423898828,Hawkish
8,8, 둔화/NNG;가능성/NNG;크/VV,16,1.4520272075392506,Hawkish
11,9, 지방교부금/NNG,20,1.774699920325751,Hawkish
15,14, 韓美/NNG,29,1.5557434366491973,Hawkish
10,9, 경제/NNG;예상/NNG;좋/VA,19,1.6133635639325008,Hawkish
19,19, 우려/NNG;상승/NNG;제한/NNG,38,1.4520272075392509,Hawkish
23,22, 금리/NNG;인상/NNG;경제/NNG;둔화/NNG,45,1.5180284442455803,Hawkish
12,9, 흥미진진/NNG,21,1.9360362767190011,Hawkish
10,7,침공/NNG,17,2.07432458219893,Hawkish
13,7, 속행/NNG,20,2.6966219568586087,Hawkish
20,10, 따른다고/VV,30,2.9040544150785017,Hawkish
9,8, 소장파/NNG,17,1.6335306084816572,Hawkish
11,12, 불태우/VV,23,1.331024940244313,Hawkish
29,27,에이스/NNG,56,1.559584778468084,Hawkish
68,71,손해율/NNG,139,1.39067394524886,Hawkish
29,30,소호/NNG,59,1.4036263006212757,Hawkish
15,16,공휴일/NNG,31,1.3612755070680476,Hawkish
11,10,뭐니뭐니/MAG,21,1.5972299282931757,Hawkish
9,10, 거품/NNG;잡/VV,19,1.3068244867853258,Hawkish
15,16,멘트/NNG,31,1.3612755070680476,Hawkish
9,8, 투자/NNG;침체/NNG,17,1.6335306084816572,Hawkish
10,7, 신의/NNG,17,2.07432458219893,Hawkish
37,18, 세균/NNG,55,2.984722593275127,Hawkish
27,16, 對北/NNG,43,2.4502959127224857,Hawkish
10,11, 每日/NNG,21,1.3200247341265916,Hawkish
22,19,단속/NNG,41,1.6812946613612378,Hawkish
11,5,가늠/NNG,16,3.1944598565863513,Hawkish
23,25, 문안/NNG,48,1.3358650309361106,Hawkish
35,37, 임대형/NNG,72,1.373539250374967,Hawkish
12,8,임대형/NNG,20,2.1780408113088763,Hawkish
14,11, 인계/NNG,25,1.8480346277772284,Hawkish
23,19, 효능/NNG,42,1.7577171459685668,Hawkish
14,12, 섭섭/NNG,26,1.6940317421291258,Hawkish
19,20, 채권/NNG;수익률/NNG;높/VA,39,1.3794258471622882,Hawkish
26,29, 타격/NNG;주/VV;않/VX,55,1.3018174964145008,Hawkish
11,6, 가계/NNG;이자/NNG;부담/NNG;증가/NNG,17,2.662049880488626,Hawkish
29,25,해안/NNG,54,1.684351560745531,Hawkish
11,12, 낸데/VV,23,1.331024940244313,Hawkish
18,10, 은행/NNG;예금/NNG;금리/NNG;오르/VV,28,2.6136489735706516,Hawkish
15,15, 경기/NNG;둔화/NNG;악재/NNG,30,1.4520272075392506,Hawkish
9,8,플레이어/NNG,17,1.6335306084816572,Hawkish
24,21, 진행자/NNG,45,1.6594596657591438,Hawkish
31,27, 동국/NNG,58,1.6671423493969175,Hawkish
11,12, 준장/NNG,23,1.331024940244313,Hawkish
16,9, 태그/NNG,25,2.5813817022920014,Hawkish
20,12,저장/NNG,32,2.420045345898751,Hawkish
10,7,금전/NNG,17,2.07432458219893,Hawkish
10,10, 출납/NNG,20,1.4520272075392509,Hawkish
31,28, 후불제/NNG,59,1.6076015512041708,Hawkish
19,16,의결문/NNG,35,1.7242823089528605,Hawkish
12,12,株/NNG,24,1.4520272075392509,Hawkish
24,13, 준주/NNG,37,2.680665613918617,Hawkish
17,7, 성장/NNG;위축/NNG;우려/NNG,24,3.526351789738181,Hawkish
12,5, 인플레이션/NNG;전망/NNG;높/VV,17,3.484865298094202,Hawkish
16,17,기구/NNG,33,1.3666138423898828,Hawkish
14,10, 거품/NNG;차단/NNG,24,2.032838090554951,Hawkish
38,25,환전/NNG,63,2.2070813554596613,Hawkish
16,13, 고점/NNG;찍/VV;내리/VV,29,1.7871104092790777,Hawkish
27,25, 스파/NNG,52,1.568189384142391,Hawkish
14,14, 물고기/NNG,28,1.4520272075392509,Hawkish
10,6, 물가/NNG;상승/NNG;이어지/VV;않/VX,16,2.420045345898751,Hawkish
13,12, 디플레이션/NNG;늪/NNG;빠지/VV,25,1.5730294748341882,Hawkish
26,21, 무사/NNG,47,1.7977479712390725,Hawkish
20,13, 부채/NNG;부담/NNG;늘/VV,33,2.2338880115988475,Hawkish
12,8, 순소득/NNG,20,2.1780408113088763,Hawkish
17,17,역송금/NNG,34,1.4520272075392509,Hawkish
13,12,원조/NNG,25,1.5730294748341882,Hawkish
8,8, 맞물린다/VV,16,1.4520272075392506,Hawkish
11,10, 도하개발어젠다/NNG,21,1.5972299282931757,Hawkish
46,21,백금/NNG,67,3.1806310260383586,Hawkish
20,14, 천재/NNG,34,2.07432458219893,Hawkish
19,13, 레그/NNG,32,2.122193611018905,Hawkish
37,22,발행어음/NNG,59,2.4420457581341948,Hawkish
16,11, 금리/NNG;이미/MAG;오르/VV,27,2.1120395746025467,Hawkish
114,84, 월급통장/NNG,198,1.970608353088983,Hawkish
17,7, 물가/NNG;지표/NNG;안정/NNG,24,3.526351789738181,Hawkish
19,17, 환경/NNG;우호적/VAX;않/VX,36,1.622853937837986,Hawkish
8,8,강당/NNG,16,1.4520272075392506,Hawkish
12,6, 긴축/NNG;강화/NNG;우려/NNG,18,2.9040544150785017,Hawkish
12,12, 차근/MAG,24,1.4520272075392509,Hawkish
10,8, 쟁취/NNG,18,1.8150340094240636,Hawkish
9,8, 조목조목/MAG,17,1.6335306084816572,Hawkish
21,23, 걸어온/VV,44,1.325763972101055,Hawkish
89,73,신년/NNG,162,1.7702797461779907,Hawkish
16,5, 기아/NNG,21,4.646487064125602,Hawkish
14,15, 클라이맥스/NNG,29,1.3552253937033008,Hawkish
10,7, 끊어진/VV,17,2.07432458219893,Hawkish
9,9, 사이렌/NNG,18,1.4520272075392509,Hawkish
14,14, 울려/VV,28,1.4520272075392509,Hawkish
23,20, 각하/NNG,43,1.6698312886701383,Hawkish
14,15,비밀/NNG,29,1.3552253937033008,Hawkish
22,17, 부동산/NNG;불확실성/NNG,39,1.879094033286089,Hawkish
11,9, 톡톡/NNG,20,1.774699920325751,Hawkish
15,13,파이/NNG,28,1.6754160086991354,Hawkish
9,7, 배반/NNG,16,1.866892123979037,Hawkish
24,22,겨우/MAG,46,1.58402968095191,Hawkish
14,3,파산설/NNG,17,6.776126968516503,Hawkish
12,13, 파란불이/VA,25,1.3403328069593086,Hawkish
12,12,퇴진/NNG,24,1.4520272075392509,Hawkish
25,26, 실적/NNG;나쁘/VA;않/VX,51,1.3961800072492796,Hawkish
14,9, 금리/NNG;오르/VV;전망/NNG;우세/NNG,23,2.258708989505501,Hawkish
9,7, 하얀/VA,16,1.866892123979037,Hawkish
13,11, 어지럽히/VV,24,1.7160321543645694,Hawkish
31,34, 길거리/NNG,65,1.3239071598151992,Hawkish
11,6, 납니다/VV,17,2.662049880488626,Hawkish
10,11,인류/NNG,21,1.3200247341265916,Hawkish
10,6, 썩이/VV,16,2.420045345898751,Hawkish
25,20, 천덕꾸러기/NNG,45,1.8150340094240636,Hawkish
28,11, 경기/NNG;상승/NNG;둔화/NNG,39,3.6960692555544568,Hawkish
12,8, 실적/NNG;시장/NNG;예상/NNG;하회/NNG,20,2.1780408113088763,Hawkish
17,6, 긴축/NNG;우려/NNG;확산/NNG,23,4.114077088027877,Hawkish
26,29, 홀대/NNG,55,1.3018174964145008,Hawkish
19,12, 채권/NNG;수요/NNG;줄/VV,31,2.299043078603814,Hawkish
32,32, 신흥시장/NNG;자금/NNG;이탈/NNG,64,1.4520272075392506,Hawkish
12,10, 인플레이션/NNG;악화/NNG,22,1.742432649047101,Hawkish
15,14, 룸살롱/NNG,29,1.5557434366491973,Hawkish
43,48,출산/NNG,91,1.3007743734205788,Hawkish
26,23, 하금/NNG,49,1.6414220606965444,Hawkish
28,22,일회성요인/NNG,50,1.8480346277772284,Hawkish
11,11, 경제/NNG;성장률/NNG;최대/NNG,22,1.4520272075392509,Hawkish
12,11,현금비중/NNG,23,1.58402968095191,Hawkish
29,30, 태산/NNG,59,1.4036263006212757,Hawkish
16,5, 인플레이션/NNG;경기/NNG;둔화/NNG;우려/NNG,21,4.646487064125602,Hawkish
24,20, 전시작전통제권/NNG,44,1.742432649047101,Hawkish
9,7, 일몰조항/NNG,16,1.866892123979037,Hawkish
12,12,환투기/NNG,24,1.4520272075392509,Hawkish
14,10,동북/NNG,24,2.032838090554951,Hawkish
13,8, 아수/NNG,21,2.359544212251283,Hawkish
9,10, 통화/NNG;완화정책/NNG;중단/NNG,19,1.3068244867853258,Hawkish
37,30, 화물연대/NNG,67,1.790833555965076,Hawkish
55,56, 하락/NNG;과도/NNG,111,1.4260981502617642,Hawkish
9,10, 질/XSV,19,1.3068244867853258,Hawkish
14,13, 벌어진다는/VV,27,1.5637216081191931,Hawkish
33,32,자본이익률/NNG,65,1.4974030577748523,Hawkish
19,13, 실적/NNG;전망/NNG;밝/VA,32,2.122193611018905,Hawkish
20,14, 潘/NNG,34,2.07432458219893,Hawkish
10,7, 매점/NNG,17,2.07432458219893,Hawkish
11,9, 쇠/NNG,20,1.774699920325751,Hawkish
11,12, 다쳐/VV,23,1.331024940244313,Hawkish
14,5, 재결/NNG,19,4.065676181109902,Hawkish
50,45, 투자클럽/NNG,95,1.613363563932501,Hawkish
14,12,스트래티지스/NNG,26,1.6940317421291258,Hawkish
63,67,신용시장/NNG,130,1.3653390160443701,Hawkish
15,12, 근원/NNG;인플레이션/NNG;안정/NNG,27,1.8150340094240633,Hawkish
9,10,엔유로/NNG,19,1.3068244867853258,Hawkish
35,29,인준/NNG,64,1.752446629788751,Hawkish
25,15, 실적/NNG;호조/NNG;오르/VV,40,2.4200453458987514,Hawkish
46,33, 예리/NNG,79,2.0240379256607737,Hawkish
11,12, 금리/NNG;상승/NNG;둔화/NNG,23,1.331024940244313,Hawkish
11,12, 위용/NNG,23,1.331024940244313,Hawkish
29,28,매도우위/NNG,57,1.503885322094224,Hawkish
10,10, 달러비중/NNG;줄/VV,20,1.4520272075392509,Hawkish
28,29, 은행/NNG;대출/NNG;금리/NNG;인상/NNG,57,1.4019573038310007,Hawkish
11,9, 발군/NNG,20,1.774699920325751,Hawkish
13,13, 아쉬워했/VV,26,1.4520272075392509,Hawkish
22,20, 막스/NNG,42,1.5972299282931757,Hawkish
9,7, 다우존스뉴스/NNG,16,1.866892123979037,Hawkish
13,7, 금리/NNG;상승효과/NNG,20,2.6966219568586087,Hawkish
21,15, 이해력/NNG,36,2.032838090554951,Hawkish
18,15, 견학/NNG,33,1.742432649047101,Hawkish
9,10, 전자우편/NNG,19,1.3068244867853258,Hawkish
8,8, 최대/NNG;업체/NNG;상승/NNG,16,1.4520272075392506,Hawkish
9,9, 태웠/VV,18,1.4520272075392509,Hawkish
12,5, 지정학/NNG;긴장/NNG;완화/NNG,17,3.484865298094202,Hawkish
15,5,뒤이/VV,20,4.356081622617752,Hawkish
22,21,의외/NNG,43,1.5211713602792152,Hawkish
10,9, 가져서/VV,19,1.6133635639325008,Hawkish
11,7, 많/VA;타격/NNG,18,2.2817570404188228,Hawkish
17,15, 기다려서/VV,32,1.645630835211151,Hawkish
8,8, 패한/VV,16,1.4520272075392506,Hawkish
36,34, 자동차보험료/NNG;인상/NNG,70,1.5374405726886184,Hawkish
13,11, gdr/NNG,24,1.7160321543645694,Hawkish
23,22, 제청/NNG,45,1.5180284442455803,Hawkish
19,9, 사시/NNG,28,3.0653907714717517,Hawkish
25,27,템/NNG,52,1.3444696366104174,Hawkish
13,14, 수출/NNG;지표/NNG;개선/NNG,27,1.3483109784293044,Hawkish
70,53, ecb/NNG;금리/NNG;오르/VV,123,1.917771783542407,Hawkish
17,18,재투자/NNG,35,1.3713590293426259,Hawkish
13,8,dr/NNG,21,2.359544212251283,Hawkish
10,8, 훔쳐/VV,18,1.8150340094240636,Hawkish
11,7, 캐피털채/NNG,18,2.2817570404188228,Hawkish
23,18, 급락/NNG;과도/NNG,41,1.855368098522376,Hawkish
11,5, 경제/NNG;활동/NNG;심각/NNG,16,3.1944598565863513,Hawkish
13,12, 전업농/NNG,25,1.5730294748341882,Hawkish
12,11, 지언/NNG,23,1.58402968095191,Hawkish
17,14,관전/NNG,31,1.7631758948690905,Hawkish
24,20,울/VV,44,1.742432649047101,Hawkish
16,12, 투자/NNG;전망/NNG;밝/VA,28,1.9360362767190007,Hawkish
56,61, 조급/NNG,117,1.3330085839704597,Hawkish
9,7, gdp/NNG;예상/NNG;상회/NNG,16,1.866892123979037,Hawkish
9,10,혹/MAG,19,1.3068244867853258,Hawkish
14,11, 몽땅/MAG,25,1.8480346277772284,Hawkish
16,17,차/VA,33,1.3666138423898828,Hawkish
19,8, 하회/NNG;하향/NNG,27,3.448564617905721,Hawkish
59,64, 소비/NNG;지출/NNG;늘/VV,123,1.3385875819502469,Hawkish
17,15, 물가/NNG;상승률/NNG;예상/NNG;낮/VA,32,1.645630835211151,Hawkish
14,6, 높/VA;시장/NNG;안정/NNG,20,3.3880634842582515,Hawkish
11,6, 파시/NNG,17,2.662049880488626,Hawkish
55,52, 형자/NNG,107,1.5357980079742075,Hawkish
12,10,강행/NNG,22,1.742432649047101,Hawkish
11,7, gdp/NNG;성장률/NNG;예상/NNG;웃돌/VV,18,2.2817570404188228,Hawkish
12,7, 신건/NNG,19,2.489189498638716,Hawkish
23,17, w자형/NNG,40,1.9645073984354566,Hawkish
36,35, 공기업민영화/NNG,71,1.4935136991832296,Hawkish
15,16, 양적완화/NNG;정책/NNG;중단/NNG,31,1.3612755070680476,Hawkish
25,15, 통화/NNG;양적완화/NNG,40,2.4200453458987514,Hawkish
14,6, 조마조마/MAG,20,3.3880634842582515,Hawkish
18,12, 소비/NNG;지표/NNG;호조/NNG,30,2.1780408113088763,Hawkish
15,15,눈앞/NNG,30,1.4520272075392506,Hawkish
16,16, 스키장/NNG,32,1.4520272075392506,Hawkish
28,30, 고점/NNG;오르/VV,58,1.3552253937033008,Hawkish
9,7,활기/NNG,16,1.866892123979037,Hawkish
13,13,짓/VV,26,1.4520272075392509,Hawkish
12,7, 용두/NNG,19,2.489189498638716,Hawkish
17,16, 국고채/NNG;수익률/NNG;내리/VV,33,1.5427789080104541,Hawkish
11,7, 침체/NNG;늪/NNG,18,2.2817570404188228,Hawkish
19,12, pmi/NNG;떨어/VV,31,2.299043078603814,Hawkish
11,8, 역재/NNG,19,1.9965374103664697,Hawkish
21,11,증설/NNG,32,2.7720519416658425,Hawkish
15,14, 밑천/NNG,29,1.5557434366491973,Hawkish
9,10, gdp/NNG;양호/NNG,19,1.3068244867853258,Hawkish
12,10,은도/NNG,22,1.742432649047101,Hawkish
11,5, ff/NNG;금리선물/NNG;가격/NNG;금리/NNG;인상/NNG,16,3.1944598565863513,Hawkish
18,14, 밝아지/VV,32,1.866892123979037,Hawkish
12,9, 거머쥔/VV,21,1.9360362767190011,Hawkish
21,19, 논/VV,40,1.604872176753909,Hawkish
18,20, 지표/NNG;강하/VA,38,1.3068244867853258,Hawkish
54,60, 포상금/NNG,114,1.3068244867853256,Hawkish
14,15, 김장/NNG,29,1.3552253937033008,Hawkish
83,73,공공요금/NNG,156,1.6509350441884634,Hawkish
12,9, 지출/NNG;부진/NNG,21,1.9360362767190011,Hawkish
11,9, 대출/NNG;연체율/NNG;낮/VA,20,1.774699920325751,Hawkish
11,10,bps/NNG,21,1.5972299282931757,Hawkish
15,9, 해묵/VV,24,2.420045345898751,Hawkish
42,26,어스/NNG,68,2.3455824121787896,Hawkish
14,11, 운집/NNG,25,1.8480346277772284,Hawkish
10,7, 경제/NNG;지표/NNG;심각/NNG,17,2.07432458219893,Hawkish
10,8, 여전/NNG;부담/NNG,18,1.8150340094240636,Hawkish
21,23, 노후생활자금/NNG,44,1.325763972101055,Hawkish
13,14, 올려놨/VV,27,1.3483109784293044,Hawkish
8,8,무디스인베스터스서비스/NNG,16,1.4520272075392506,Hawkish
351,307, cd/NNG;금리/NNG;상승/NNG,658,1.6601353415188178,Hawkish
19,21,기업가치/NNG,40,1.3137389020593222,Hawkish
13,13, 세계/NNG;최대/NNG;업체/NNG;오르/VV,26,1.4520272075392509,Hawkish
12,10,유난히/MAG,22,1.742432649047101,Hawkish
13,7, 박막/NNG,20,2.6966219568586087,Hawkish
10,7, 매출/NNG;시장/NNG;예상/NNG;웃돌/VV,17,2.07432458219893,Hawkish
19,20, 현금/NNG;보유/NNG;늘/VV,39,1.3794258471622882,Hawkish
16,16, 국제/NNG;유가/NNG;내리/VV,32,1.4520272075392506,Hawkish
13,8, 인상/NNG;작/VA,21,2.359544212251283,Hawkish
10,8, 재정/NNG;적자/NNG;심각/NNG,18,1.8150340094240636,Hawkish
18,10, 상품펀드/NNG,28,2.6136489735706516,Hawkish
13,8, 지나치/VA;위험/NNG,21,2.359544212251283,Hawkish
10,7, 달러원/NNG;상승/NNG;견인/NNG,17,2.07432458219893,Hawkish
14,13, 타격/NNG;피하/VV,27,1.5637216081191931,Hawkish
18,13,중장비업체/NNG,31,2.010499210438963,Hawkish
13,9, 고용/NNG;부진/NNG;금리/NNG;인상/NNG,22,2.097372633112251,Hawkish
24,16, 아시아태평양경제협력체/NNG,40,2.1780408113088763,Hawkish
13,13,저리/MAG,26,1.4520272075392509,Hawkish
9,7, 금리/NNG;인상/NNG;확률/NNG;오르/VV,16,1.866892123979037,Hawkish
12,12, 카드이용금액/NNG,24,1.4520272075392509,Hawkish
9,7, 경기/NNG;강하/VA;회복/NNG,16,1.866892123979037,Hawkish
15,14, 외평채/NNG;스프레드/NNG;상승/NNG,29,1.5557434366491973,Hawkish
14,15,비스/NNG,29,1.3552253937033008,Hawkish
30,26, 페어/NNG,56,1.6754160086991354,Hawkish
9,7, 모기지/NNG;금리/NNG;높/VA,16,1.866892123979037,Hawkish
14,15, 인플레이션/NNG;확산/NNG,29,1.3552253937033008,Hawkish
17,14, 지닌다고/VV,31,1.7631758948690905,Hawkish
16,11, 펠트/NNG,27,2.1120395746025467,Hawkish
78,74, 전시회/NNG,152,1.5305151647035347,Hawkish
28,27,명예/NNG,55,1.5058059930036674,Hawkish
9,7, 경제/NNG;펀더멘털/NNG;회복/NNG,16,1.866892123979037,Hawkish
15,15,유보/NNG,30,1.4520272075392506,Hawkish
22,24, 소요사태/NNG,46,1.331024940244313,Hawkish
20,20, 추동/NNG,40,1.4520272075392509,Hawkish
15,8, 완화/NNG;점차/MAG;줄/VV,23,2.722551014136095,Hawkish
9,9,누차/MAG,18,1.4520272075392509,Hawkish
26,19,예대/NNG,45,1.9869845997905538,Hawkish
11,9, 역활/NNG,20,1.774699920325751,Hawkish
28,31, 임시투자세액공제/NNG,59,1.3115084455193233,Hawkish
13,11, 무도/NNG,24,1.7160321543645694,Hawkish
9,9,받아들이/VV,18,1.4520272075392509,Hawkish
10,11, 지난번/NNG;금리/NNG;인상/NNG,21,1.3200247341265916,Hawkish
29,5, cd/NNG;금리/NNG;콜/NNG;금리/NNG;인상/NNG,34,8.421757803727655,Hawkish
26,21,잔/NNG,47,1.7977479712390725,Hawkish
22,15, 플루토늄/NNG,37,2.129639904390901,Hawkish
11,7,오렌지/NNG,18,2.2817570404188228,Hawkish
13,4,작황/NNG,17,4.719088424502566,Hawkish
11,12, 금리/NNG;인상/NNG;유동성/NNG;축소/NNG,23,1.331024940244313,Hawkish
15,16,기억/NNG,31,1.3612755070680476,Hawkish
32,8, 무역/NNG;적자/NNG;급증/NNG,40,5.8081088301570025,Hawkish
22,18,노드/NNG,40,1.774699920325751,Hawkish
18,20, 자생적/VAX;성장/NNG,38,1.3068244867853258,Hawkish
14,12, 은행/NNG;자산/NNG;확대/NNG,26,1.6940317421291258,Hawkish
29,15, 로체/NNG,44,2.8072526012425514,Hawkish
23,14, 현금등가물/NNG,37,2.3854732695287693,Hawkish
10,7, 소비자/NNG;물가/NNG;안정/NNG;상승/NNG,17,2.07432458219893,Hawkish
14,8, 경제/NNG;주/VV;충격/NNG,22,2.541047613193689,Hawkish
13,7, 주택청약부금/NNG,20,2.6966219568586087,Hawkish
12,9,명칭/NNG,21,1.9360362767190011,Hawkish
10,10,인출/NNG,20,1.4520272075392509,Hawkish
11,10, 대수술/NNG,21,1.5972299282931757,Hawkish
9,9, 많/VA;경기/NNG;회복/NNG,18,1.4520272075392509,Hawkish
11,8,연이율/NNG,19,1.9965374103664697,Hawkish
62,66, 톡/NNG,128,1.364025558597478,Hawkish
12,9, 경제/NNG;회복/NNG;견고/NNG,21,1.9360362767190011,Hawkish
17,15, 마땅찮/VA,32,1.645630835211151,Hawkish
20,19,송금/NNG,39,1.5284496921465798,Hawkish
8,8, 가격/NNG;경제/NNG;성장/NNG,16,1.4520272075392506,Hawkish
9,9, 직접/NNG;타격/NNG;줄/VV,18,1.4520272075392509,Hawkish
11,10, 시혜/NNG,21,1.5972299282931757,Hawkish
10,10,경영계획/NNG,20,1.4520272075392509,Hawkish
12,13, 가질/NNG,25,1.3403328069593086,Hawkish
35,19,역모기지/NNG,54,2.674786961256515,Hawkish
13,14,근저당설정비/NNG,27,1.3483109784293044,Hawkish
10,8,약진/NNG,18,1.8150340094240636,Hawkish
28,29, 신작/NNG,57,1.4019573038310007,Hawkish
20,20, 후년/NNG,40,1.4520272075392509,Hawkish
12,12, 지켜나갈/VV,24,1.4520272075392509,Hawkish
23,24, 자조/NNG,47,1.3915260738917818,Hawkish
9,10,서양/NNG,19,1.3068244867853258,Hawkish
9,9, 소폭/MAG;오르/VV;상승/NNG,18,1.4520272075392509,Hawkish
12,13, 거행/NNG,25,1.3403328069593086,Hawkish
41,44, 공사채형/NNG,85,1.3530253524797564,Hawkish
12,11, 구세주/NNG,23,1.58402968095191,Hawkish
36,34, 뉴딜/NNG,70,1.5374405726886184,Hawkish
23,23, ff/NNG;금리/NNG;인하/NNG,46,1.4520272075392506,Hawkish
10,8, 소개서/NNG,18,1.8150340094240636,Hawkish
15,14, 강령/NNG,29,1.5557434366491973,Hawkish
13,12,보복/NNG,25,1.5730294748341882,Hawkish
20,20,들어가/VV,40,1.4520272075392509,Hawkish
33,35, 균분/NNG,68,1.3690542242512935,Hawkish
10,8, 제로베이스/NNG,18,1.8150340094240636,Hawkish
16,12, 연쇄/NNG;금리/NNG;인상/NNG,28,1.9360362767190007,Hawkish
9,8, 정동/NNG,17,1.6335306084816572,Hawkish
65,58,수능/NNG,123,1.6272718705181257,Hawkish
103,96, 원화/NNG;환율/NNG;내리/VV,199,1.557904191422321,Hawkish
12,13, 거들떠/VV,25,1.3403328069593086,Hawkish
15,9,추위/NNG,24,2.420045345898751,Hawkish
11,11, 긴축/NNG;가능성/NNG;우려/NNG,22,1.4520272075392509,Hawkish
25,24, 스며들/VV,49,1.5125283411867194,Hawkish
9,9, 가자/NNG,18,1.4520272075392509,Hawkish
19,18,한층/MAG,37,1.5326953857358758,Hawkish
11,10, 수출/NNG;호조/NNG;내수/NNG;회복/NNG,21,1.5972299282931757,Hawkish
27,4, 수요/NNG;압력/NNG;증대/NNG,31,9.801183650889943,Hawkish
9,7, u자형/NNG;회복/NNG,16,1.866892123979037,Hawkish
12,9, 비용/NNG;넘/VV,21,1.9360362767190011,Hawkish
10,9,합작법인/NNG,19,1.6133635639325008,Hawkish
13,10, 판촉전/NNG,23,1.887635369801026,Hawkish
16,12, 환경/NNG;나쁘/VA;않/VX,28,1.9360362767190007,Hawkish
11,10, 미/NNG;금리/NNG;인상/NNG;중단/NNG,21,1.5972299282931757,Hawkish
9,10, 국채/NNG;이자/NNG;부담/NNG,19,1.3068244867853258,Hawkish
16,17, 저축성/NNG;예금/NNG;증가/NNG,33,1.3666138423898828,Hawkish
14,8, 토이/NNG,22,2.541047613193689,Hawkish
33,26, 수첩/NNG,59,1.842957609569049,Hawkish
10,9,단기투자자/NNG,19,1.6133635639325008,Hawkish
19,9, 단산/NNG,28,3.0653907714717517,Hawkish
20,21, 시장주도주/NNG,41,1.3828830547992865,Hawkish
9,8, 대출/NNG;열/NNG;오르/VV,17,1.6335306084816572,Hawkish
476,466,새해/NNG,942,1.4831865896752863,Hawkish
13,11, 내수/NNG;견조/NNG,24,1.7160321543645694,Hawkish
31,31, 가입비/NNG,62,1.452027207539251,Hawkish
10,9, 금리/NNG;인상/NNG;크/VV,19,1.6133635639325008,Hawkish
29,25,동일등급/NNG,54,1.684351560745531,Hawkish
12,13, 네이처/NNG,25,1.3403328069593086,Hawkish
15,11, ecb/NNG;예금/NNG;금리/NNG;한계/NNG,26,1.9800371011898874,Hawkish
10,8, 이익기여도/NNG;높/VA,18,1.8150340094240636,Hawkish
26,23, 좋/VA;효과/NNG,49,1.6414220606965444,Hawkish
19,13, 어장/NNG,32,2.122193611018905,Hawkish
22,17, 장정/NNG,39,1.879094033286089,Hawkish
10,10, 프라이드/NNG,20,1.4520272075392509,Hawkish
12,13, 할부이/NNG,25,1.3403328069593086,Hawkish
17,13, 에어백/NNG,30,1.8988048098590204,Hawkish
17,12, 물가/NNG;상승률/NNG;높/VA;않/VX,29,2.0570385440139387,Hawkish
9,10, 수출/NNG;경쟁력/NNG;향상/NNG,19,1.3068244867853258,Hawkish
14,13, 수출/NNG;타격/NNG;줄/VV,27,1.5637216081191931,Hawkish
138,143,pce/NNG,281,1.401257025457459,Hawkish
16,17, 극찬/NNG,33,1.3666138423898828,Hawkish
42,41, 부수업무/NNG,83,1.4874425052841107,Hawkish
23,20, 신입생/NNG,43,1.6698312886701383,Hawkish
19,16,재미있/VA,35,1.7242823089528605,Hawkish
24,21,동화/NNG,45,1.6594596657591438,Hawkish
50,43, 보호예수/NNG,93,1.6884037296968033,Hawkish
28,30,기온/NNG,58,1.3552253937033008,Hawkish
21,19, 경제/NNG;fed/NNG;금리/NNG;인상/NNG,40,1.604872176753909,Hawkish
15,16,미루/VV,31,1.3612755070680476,Hawkish
9,8, 경상이전/NNG,17,1.6335306084816572,Hawkish
21,20, 합종연횡/NNG,41,1.5246285679162133,Hawkish
18,15, 미래/NNG;성장동력/NNG;확보/NNG,33,1.742432649047101,Hawkish
27,17, 리듬/NNG,44,2.3061608590329277,Hawkish
28,21,종신/NNG,49,1.9360362767190011,Hawkish
23,25, 판다는/VV,48,1.3358650309361106,Hawkish
9,7, 손보협회/NNG,16,1.866892123979037,Hawkish
43,43, 전월세/NNG;시장/NNG;안정/NNG,86,1.4520272075392506,Hawkish
23,23, 조성원가/NNG,46,1.4520272075392506,Hawkish
13,11, 주택/NNG;침체/NNG,24,1.7160321543645694,Hawkish
26,17, 금리/NNG;갭/NNG;줄/VV,43,2.22074749388356,Hawkish
14,3, 금리/NNG;인상/NNG;물가/NNG;불안/NNG,17,6.776126968516503,Hawkish
11,11,공간/NNG,22,1.4520272075392509,Hawkish
15,15, 중소기업/NNG;어렵/VA,30,1.4520272075392506,Hawkish
17,13, 교신/NNG,30,1.8988048098590204,Hawkish
31,32, 적십자사/NNG,63,1.4066513573036492,Hawkish
13,11,형사/NNG,24,1.7160321543645694,Hawkish
10,9,업태/NNG,19,1.6133635639325008,Hawkish
21,5, 콜/NNG;금리/NNG;목표/NNG;오르/VV,26,6.098514271664853,Hawkish
17,15, 글로벌인베스터스/NNG,32,1.645630835211151,Hawkish
9,8, 좋/VA;않/VX;금리/NNG;오르/VV,17,1.6335306084816572,Hawkish
30,21, 콜/NNG;금리/NNG;높/VA,51,2.07432458219893,Hawkish
52,49,콜시장/NNG,101,1.5409268324906336,Hawkish
12,11, 하단/NNG;높/VV,23,1.58402968095191,Hawkish
18,12, 기내/NNG,30,2.1780408113088763,Hawkish
57,55, 연예인/NNG,112,1.5048281969043145,Hawkish
10,8, 聯/NNG,18,1.8150340094240636,Hawkish
12,12, 짜리/VV,24,1.4520272075392509,Hawkish
19,13, 여성부/NNG,32,2.122193611018905,Hawkish
10,6, 부측/NNG,16,2.420045345898751,Hawkish
8,8, 라드/NNG,16,1.4520272075392506,Hawkish
54,48, 족집게/NNG,102,1.633530608481657,Hawkish
11,6, 피내/NNG,17,2.662049880488626,Hawkish
10,7, 경기/NNG;부양책/NNG;쓰/VV;않/VX,17,2.07432458219893,Hawkish
179,113,세제개편안/NNG,292,2.300113895128548,Hawkish
21,23, 송년회/NNG,44,1.325763972101055,Hawkish
13,11, 최저가낙찰제/NNG,24,1.7160321543645694,Hawkish
20,14, 들떠/VV,34,2.07432458219893,Hawkish
11,11, 금리/NNG;인상/NNG;우려/NNG;증폭/NNG,22,1.4520272075392509,Hawkish
29,32, 그랑프리/NNG,61,1.315899656832446,Hawkish
13,7,림/NNG,20,2.6966219568586087,Hawkish
11,7,주식배당/NNG,18,2.2817570404188228,Hawkish
13,10, 동래/NNG,23,1.887635369801026,Hawkish
11,12, 경락잔금대출/NNG,23,1.331024940244313,Hawkish
32,15, 송년/NNG,47,3.0976580427504015,Hawkish
27,22, 팔린다/VV,49,1.7820333910708988,Hawkish
17,2, 은행/NNG;콜/NNG;금리/NNG;인상/NNG,19,12.342231264083633,Hawkish
13,14,남기/VV,27,1.3483109784293044,Hawkish
14,13, 함양/NNG,27,1.5637216081191931,Hawkish
11,11,홍성/NNG,22,1.4520272075392509,Hawkish
9,7,팔린/VV,16,1.866892123979037,Hawkish
9,7, 기업사냥/NNG,16,1.866892123979037,Hawkish
13,14, 동상이몽/NNG,27,1.3483109784293044,Hawkish
96,51, 지문/NNG,147,2.733227684779766,Hawkish
35,35, 印/NNG,70,1.4520272075392509,Hawkish
23,24, 자금/NNG;조달/NNG;비용/NNG;늘/VV,47,1.3915260738917818,Hawkish
9,7, 담보인정비율/NNG;낮/VA,16,1.866892123979037,Hawkish
13,11,업종대표주/NNG,24,1.7160321543645694,Hawkish
12,10, 기와/NNG,22,1.742432649047101,Hawkish
22,21,협력기업/NNG,43,1.5211713602792152,Hawkish
18,18, 구절/NNG,36,1.4520272075392509,Hawkish
17,12, 원달러/NNG;금리/NNG;인상/NNG,29,2.0570385440139387,Hawkish
15,13, 저점/NNG;최저/NNG,28,1.6754160086991354,Hawkish
14,14, 심리/NNG;하락/NNG,28,1.4520272075392509,Hawkish
26,17, 유가증권관련이익/NNG,43,2.22074749388356,Hawkish
9,10,대변/NNG,19,1.3068244867853258,Hawkish
18,14, 일석/NNG,32,1.866892123979037,Hawkish
8,8, 중소기업/NNG;채산성/NNG;악화/NNG,16,1.4520272075392506,Hawkish
17,12, 돼선/VV,29,2.0570385440139387,Hawkish
12,10, 유괴/NNG,22,1.742432649047101,Hawkish
11,12,얼핏/MAG,23,1.331024940244313,Hawkish
21,14, 로밍/NNG,35,2.1780408113088763,Hawkish
22,8, 등원/NNG,30,3.9930748207329394,Hawkish
9,9, 통지서/NNG,18,1.4520272075392509,Hawkish
8,8, 국제/NNG;성장/NNG,16,1.4520272075392506,Hawkish
12,12, 개략/NNG,24,1.4520272075392509,Hawkish
27,13, 개인퇴직계좌/NNG,40,3.0157488156584438,Hawkish
31,24, ira/NNG,55,1.8755351430715321,Hawkish
33,36, 엷/VA,69,1.331024940244313,Hawkish
18,13, 아름/NNG,31,2.010499210438963,Hawkish
24,26, 하락/NNG;강하/VA,50,1.3403328069593086,Hawkish
11,12, 맞춤식/NNG,23,1.331024940244313,Hawkish
12,6, 호조/NNG;안정/NNG,18,2.9040544150785017,Hawkish
12,7, 세밑/NNG,19,2.489189498638716,Hawkish
53,47, 헌신/NNG,100,1.6373923829697936,Hawkish
18,15, 거둬들여야/VV,33,1.742432649047101,Hawkish
11,8, 모기지/NNG;대출/NNG;부실/NNG,19,1.9965374103664697,Hawkish
9,9, 실권/NNG,18,1.4520272075392509,Hawkish
36,35, 트림/NNG,71,1.4935136991832296,Hawkish
18,14, 앉히/VV,32,1.866892123979037,Hawkish
12,9, 통안채/NNG;내리/VV;통안채/NNG;내리/VV,21,1.9360362767190011,Hawkish
17,16, 경제/NNG;지표/NNG;부담/NNG,33,1.5427789080104541,Hawkish
13,13,폐장/NNG,26,1.4520272075392509,Hawkish
25,27,체계/NNG,52,1.3444696366104174,Hawkish
15,15,전신/NNG,30,1.4520272075392506,Hawkish
18,16,펴낸/VV,34,1.6335306084816572,Hawkish
17,15, 컨버전/NNG,32,1.645630835211151,Hawkish
21,22, 멀다하고/MAG,43,1.3860259708329212,Hawkish
29,31, 표지어음/NNG,60,1.3583480328592992,Hawkish
37,38, 개인/NNG;소득/NNG;늘/VV,75,1.4138159652355864,Hawkish
10,6,각료회의/NNG,16,2.420045345898751,Hawkish
22,11, 개장식/NNG,33,2.9040544150785017,Hawkish
13,14, 건설붐/NNG,27,1.3483109784293044,Hawkish
13,10, 전세자금/NNG;대출/NNG;확대/NNG,23,1.887635369801026,Hawkish
12,8,과매수/NNG,20,2.1780408113088763,Hawkish
9,10, 재무/NNG;건전성/NNG;좋/VA,19,1.3068244867853258,Hawkish
9,10, 기대수익률/NNG;상승/NNG,19,1.3068244867853258,Hawkish
11,6, 타오르/VV,17,2.662049880488626,Hawkish
15,8, 비관론/NNG;우세/NNG,23,2.722551014136095,Hawkish
9,8, 물러가/VV,17,1.6335306084816572,Hawkish
13,14, 일깨우/VV,27,1.3483109784293044,Hawkish
12,9, 회피성/NNG,21,1.9360362767190011,Hawkish
10,7, 입비/NNG,17,2.07432458219893,Hawkish
12,11, 뚝섬/NNG,23,1.58402968095191,Hawkish
12,11, 전세가격/NNG;내리/VV,23,1.58402968095191,Hawkish
8,8, 보건비/NNG,16,1.4520272075392506,Hawkish
10,6, 단골손님/NNG,16,2.420045345898751,Hawkish
16,11,우승/NNG,27,2.1120395746025467,Hawkish
26,16, 진취/NNG,42,2.359544212251283,Hawkish
12,8, 동천/NNG,20,2.1780408113088763,Hawkish
18,19, 유소년/NNG,37,1.375604722931922,Hawkish
12,8, 동주/NNG,20,2.1780408113088763,Hawkish
25,20, 운전사/NNG,45,1.8150340094240636,Hawkish
12,11, 사업소/NNG,23,1.58402968095191,Hawkish
8,8, 국체/NNG,16,1.4520272075392506,Hawkish
20,14,관할/NNG,34,2.07432458219893,Hawkish
15,7, 연가/NNG,22,3.1114868732983947,Hawkish
35,35, 경조사/NNG,70,1.4520272075392509,Hawkish
9,7, 원흥/NNG,16,1.866892123979037,Hawkish
12,12, 제주특별자치도/NNG,24,1.4520272075392509,Hawkish
22,16, 방황/NNG,38,1.9965374103664697,Hawkish
22,18, 가격/NNG;절상/NNG,40,1.774699920325751,Hawkish
20,14, 환거래/NNG,34,2.07432458219893,Hawkish
16,16, 공염불/NNG,32,1.4520272075392506,Hawkish
22,22,실시간/NNG,44,1.4520272075392509,Hawkish
11,5, 하락/NNG;지수/NNG;부담/NNG,16,3.1944598565863513,Hawkish
341,247, 신년/NNG,588,2.0046205577768603,Hawkish
10,10,토목/NNG,20,1.4520272075392509,Hawkish
17,16,배당락/NNG,33,1.5427789080104541,Hawkish
12,8, 단위형/NNG,20,2.1780408113088763,Hawkish
36,34,특정금전신탁/NNG,70,1.5374405726886184,Hawkish
39,34, 경제/NNG;활력/NNG;회복/NNG,73,1.66556062041267,Hawkish
10,8, 갈음/NNG,18,1.8150340094240636,Hawkish
13,13, 납부금/NNG,26,1.4520272075392509,Hawkish
14,13, 전출/NNG,27,1.5637216081191931,Hawkish
9,10,갑/NNG,19,1.3068244867853258,Hawkish
10,8,종금사/NNG,18,1.8150340094240636,Hawkish
10,10,상세/NNG,20,1.4520272075392509,Hawkish
14,4, 주택/NNG;공급/NNG;활성화/NNG,18,5.082095226387378,Hawkish
9,10,로드맵/NNG,19,1.3068244867853258,Hawkish
24,26,관세/NNG,50,1.3403328069593086,Hawkish
22,6, 남북교역/NNG,28,5.324099760977252,Hawkish
16,13, 흐릿/NNG,29,1.7871104092790777,Hawkish
10,10, 이전/NNG;성장/NNG,20,1.4520272075392509,Hawkish
10,8,일회성이익/NNG,18,1.8150340094240636,Hawkish
26,28, 금융시장/NNG;확산/NNG,54,1.3483109784293044,Hawkish
21,19, 국고채/NNG;오르/VV;상승/NNG,40,1.604872176753909,Hawkish
25,10, 파산자/NNG,35,3.630068018848127,Hawkish
23,11, 면허증/NNG,34,3.0360568884911605,Hawkish
159,101, 신년사/NNG,260,2.2858646138489194,Hawkish
17,18, 그지없/VA,35,1.3713590293426259,Hawkish
12,9, 국제/NNG;원자재/NNG;상승/NNG,21,1.9360362767190011,Hawkish
10,7, 불안/NNG;금리/NNG;인상/NNG;우려/NNG,17,2.07432458219893,Hawkish
10,11,시장조성자/NNG,21,1.3200247341265916,Hawkish
22,16, 丙/NNG,38,1.9965374103664697,Hawkish
11,5,빌/VV,16,3.1944598565863513,Hawkish
40,33,돌이켜/VV,73,1.7600329788354554,Hawkish
19,9, 난동/NNG,28,3.0653907714717517,Hawkish
10,6, 여려/VA,16,2.420045345898751,Hawkish
12,7, 경제/NNG;성장률/NNG;하회/NNG,19,2.489189498638716,Hawkish
9,9, 무안/NNG,18,1.4520272075392509,Hawkish
117,79,신년사/NNG,196,2.150470674456865,Hawkish
10,7,부랴부랴/MAG,17,2.07432458219893,Hawkish
10,7,축/NNG,17,2.07432458219893,Hawkish
12,8, 국제/NNG;압력/NNG,20,2.1780408113088763,Hawkish
12,5, 냉엄/NNG,17,3.484865298094202,Hawkish
32,35,구랍/NNG,67,1.327567732607315,Hawkish
104,78, 양적완화/NNG;정책/NNG;종료/NNG,182,1.9360362767190011,Hawkish
8,8, 경기/NNG;회복/NNG;물가/NNG;상승/NNG;압력/NNG,16,1.4520272075392506,Hawkish
10,8, 외환시장/NNG;최대/NNG,18,1.8150340094240636,Hawkish
13,11, 어부지리/NNG,24,1.7160321543645694,Hawkish
10,11, 몸무게/NNG,21,1.3200247341265916,Hawkish
18,11, 빌려올/VV,29,2.376044521427865,Hawkish
12,7, 가계/NNG;소득/NNG;늘/VV;않/VX,19,2.489189498638716,Hawkish
30,33,금융소득종합과세/NNG,63,1.3200247341265916,Hawkish
21,9, ecb/NNG;성장/NNG,30,3.3880634842582515,Hawkish
21,16, 실적/NNG;개선/NNG;모멘텀/NNG,37,1.9057857098952666,Hawkish
13,9, 페리/NNG,22,2.097372633112251,Hawkish
28,25, 후취/NNG,53,1.626270472443961,Hawkish
13,7, 거농/NNG,20,2.6966219568586087,Hawkish
10,9, 주택/NNG;판매/NNG;최저/NNG,19,1.6133635639325008,Hawkish
10,7, 미니/NNG;거품/NNG,17,2.07432458219893,Hawkish
18,20, 사자성어/NNG,38,1.3068244867853258,Hawkish
17,15,레이트/NNG,32,1.645630835211151,Hawkish
10,6, 최장기/NNG;호황/NNG,16,2.420045345898751,Hawkish
16,10, 무분규/NNG,26,2.323243532062801,Hawkish
17,13, 취항/NNG,30,1.8988048098590204,Hawkish
18,9, 가격/NNG;하락/NNG;금리/NNG;인상/NNG,27,2.9040544150785017,Hawkish
10,11, 직판/NNG,21,1.3200247341265916,Hawkish
13,13, 할부상환/NNG,26,1.4520272075392509,Hawkish
9,10, 흐를지/VV,19,1.3068244867853258,Hawkish
16,16, 유가/NNG;상승/NNG;확대/NNG,32,1.4520272075392506,Hawkish
20,22, 중기업/NNG,42,1.3200247341265916,Hawkish
10,10, 각양각색/NNG,20,1.4520272075392509,Hawkish
19,19,정/NNG,38,1.4520272075392509,Hawkish
18,14, 자금/NNG;조달/NNG;쉽/VA,32,1.866892123979037,Hawkish
9,9, 가리켜/VV,18,1.4520272075392509,Hawkish
15,15,정신/NNG,30,1.4520272075392506,Hawkish
12,12, 不/NNG,24,1.4520272075392509,Hawkish
9,8, 수출업체/NNG;채산성/NNG;악화/NNG,17,1.6335306084816572,Hawkish
9,8, 나빠진다는/VA,17,1.6335306084816572,Hawkish
15,16, 백수/NNG,31,1.3612755070680476,Hawkish
10,6, 가마/NNG,16,2.420045345898751,Hawkish
26,21,양/NNG,47,1.7977479712390725,Hawkish
36,38, 기술경쟁력/NNG,74,1.375604722931922,Hawkish
13,10,세/NNG,23,1.887635369801026,Hawkish
9,9, 부작용/NNG;경고/NNG,18,1.4520272075392509,Hawkish
11,9,알라/NNG,20,1.774699920325751,Hawkish
10,8, 허/VV,18,1.8150340094240636,Hawkish
11,5, 통안채/NNG;증가/NNG,16,3.1944598565863513,Hawkish
19,16, 원화/NNG;강세/NNG;환율/NNG;하락/NNG,35,1.7242823089528605,Hawkish
12,6, 공공법인/NNG,18,2.9040544150785017,Hawkish
13,12, 높/VA;환율/NNG;하락/NNG,25,1.5730294748341882,Hawkish
11,8, 천양지차/NNG,19,1.9965374103664697,Hawkish
9,8, 절반/NNG;금리/NNG;인상/NNG,17,1.6335306084816572,Hawkish
24,25,징/NNG,49,1.393946119237681,Hawkish
11,12, 보내온/VV,23,1.331024940244313,Hawkish
26,24, 이복/NNG,50,1.5730294748341882,Hawkish
23,15, 달러위안/NNG;하락/NNG,38,2.2264417182268508,Hawkish
8,8,대책회의/NNG,16,1.4520272075392506,Hawkish
11,10, 급여체계/NNG,21,1.5972299282931757,Hawkish
25,8, 세곡/NNG,33,4.537585023560159,Hawkish
12,12, 소비/NNG;여력/NNG;크/VV,24,1.4520272075392509,Hawkish
13,10, 납세담보/NNG,23,1.887635369801026,Hawkish
11,10, 자금/NNG;부담/NNG;완화/NNG,21,1.5972299282931757,Hawkish
11,6, 토착/NNG,17,2.662049880488626,Hawkish
16,16, 판매/NNG;대금/NNG;회수/NNG;지연/NNG,32,1.4520272075392506,Hawkish
9,10, 통제/NNG;벗어나/VV,19,1.3068244867853258,Hawkish
20,21,차/VV,41,1.3828830547992865,Hawkish
24,20,기고/NNG,44,1.742432649047101,Hawkish
9,9, 미어/NNG,18,1.4520272075392509,Hawkish
12,10, 배척/NNG,22,1.742432649047101,Hawkish
34,32, 맏형/NNG,66,1.5427789080104541,Hawkish
11,10,번번이/MAG,21,1.5972299282931757,Hawkish
28,22,돌/NNG,50,1.8480346277772284,Hawkish
8,8, 유럽연합/NNG;금리/NNG;인상/NNG,16,1.4520272075392506,Hawkish
9,8, 많/VA;경기/NNG;침체/NNG,17,1.6335306084816572,Hawkish
11,8, 부채액/NNG,19,1.9965374103664697,Hawkish
17,15, 기록부/NNG,32,1.645630835211151,Hawkish
9,8, 통화/NNG;완화/NNG;종료/NNG,17,1.6335306084816572,Hawkish
22,19, 성장/NNG;위협/NNG,41,1.6812946613612378,Hawkish
22,12, 반파/NNG,34,2.662049880488626,Hawkish
14,11, 커트라인/NNG,25,1.8480346277772284,Hawkish
26,22,장내거래/NNG,48,1.7160321543645694,Hawkish
14,7, 그럴싸/VA,21,2.9040544150785017,Hawkish
57,63,영업일/NNG,120,1.313738902059322,Hawkish
12,7,위언/NNG,19,2.489189498638716,Hawkish
37,35, 대출/NNG;강화/NNG,72,1.5350001908272082,Hawkish
16,17, 물가/NNG;상승/NNG;압력/NNG;줄/VV,33,1.3666138423898828,Hawkish
11,12,극적/VAX,23,1.331024940244313,Hawkish
15,15, 결승전/NNG,30,1.4520272075392506,Hawkish
19,17, 결제액/NNG,36,1.622853937837986,Hawkish
13,9,셰어/NNG,22,2.097372633112251,Hawkish
68,44,춘절/NNG,112,2.244042048015206,Hawkish
11,7,작전/NNG,18,2.2817570404188228,Hawkish
20,17,가속/NNG,37,1.7082673029873539,Hawkish
11,10, 월급날/NNG,21,1.5972299282931757,Hawkish
11,11, 외환시장/NNG;과도/NNG,22,1.4520272075392509,Hawkish
74,81, 원산지/NNG,155,1.3265433747889452,Hawkish
11,11, 깜짝쇼/NNG,22,1.4520272075392509,Hawkish
10,11, 금리/NNG;상한선/NNG;낮/VV,21,1.3200247341265916,Hawkish
9,10, 여신/NNG;성장/NNG,19,1.3068244867853258,Hawkish
13,14, 신통찮/VA,27,1.3483109784293044,Hawkish
9,8,다이어트/NNG,17,1.6335306084816572,Hawkish
24,26, 디자이너/NNG,50,1.3403328069593086,Hawkish
16,13, 경제/NNG;지표/NNG;불안/NNG,29,1.7871104092790777,Hawkish
10,7, 주택/NNG;판매/NNG;지표/NNG;부진/NNG,17,2.07432458219893,Hawkish
22,20, 둑/NNG,42,1.5972299282931757,Hawkish
32,22, 감점/NNG,54,2.1120395746025467,Hawkish
21,21,산생/NNG,42,1.4520272075392509,Hawkish
16,14,섬/NNG,30,1.6594596657591438,Hawkish
25,26,잇/NNG,51,1.3961800072492796,Hawkish
13,12, 군도/NNG,25,1.5730294748341882,Hawkish
9,8, 재관/NNG,17,1.6335306084816572,Hawkish
9,8, 곤두/MAG,17,1.6335306084816572,Hawkish
22,15,무보증사채/NNG,37,2.129639904390901,Hawkish
50,26, cd/NNG;금리/NNG;인상/NNG,76,2.792360014498559,Hawkish
9,8, 최대/NNG;업체/NNG;오르/VV,17,1.6335306084816572,Hawkish
10,8, 높/VA;밸류에이션/NNG;부담/NNG,18,1.8150340094240636,Hawkish
15,13,신용카드회사/NNG,28,1.6754160086991354,Hawkish
13,6, 맡겨진/VV,19,3.1460589496683764,Hawkish
15,12, 스퍼/NNG,27,1.8150340094240633,Hawkish
12,7,설정비/NNG,19,2.489189498638716,Hawkish
14,12, 추가공제/NNG,26,1.6940317421291258,Hawkish
25,25, 개회식/NNG,50,1.4520272075392509,Hawkish
9,10,과도기/NNG,19,1.3068244867853258,Hawkish
14,9,검증/NNG,23,2.258708989505501,Hawkish
15,7, 성장/NNG;훼손/NNG,22,3.1114868732983947,Hawkish
8,8, 최대/NNG;성장/NNG,16,1.4520272075392506,Hawkish
12,9,담보자산/NNG,21,1.9360362767190011,Hawkish
10,7, 본금/NNG,17,2.07432458219893,Hawkish
14,14, 대출/NNG;한도/NNG;높/VV,28,1.4520272075392509,Hawkish
14,15,사무/NNG,29,1.3552253937033008,Hawkish
17,13, 신간/NNG,30,1.8988048098590204,Hawkish
9,8, ff/NNG;금리/NNG;내리/VV,17,1.6335306084816572,Hawkish
11,10, 과하/VV,21,1.5972299282931757,Hawkish
12,5, 우주발사체/NNG,17,3.484865298094202,Hawkish
395,404, 한미fta/NNG,799,1.4196800667772378,Hawkish
26,3, 유년/NNG,29,12.584235798673506,Hawkish
11,12,공부/NNG,23,1.331024940244313,Hawkish
20,13,교사/NNG,33,2.2338880115988475,Hawkish
24,14,독/NNG,38,2.489189498638716,Hawkish
13,14, 짓눌렸/VV,27,1.3483109784293044,Hawkish
21,23,구인/NNG,44,1.325763972101055,Hawkish
28,16, 연두교서/NNG,44,2.541047613193689,Hawkish
23,20, 선서/NNG,43,1.6698312886701383,Hawkish
12,11, ecb/NNG;유지/NNG;금리/NNG;인플레이션/NNG;압력/NNG,23,1.58402968095191,Hawkish
13,12,라이벌/NNG,25,1.5730294748341882,Hawkish
10,9,사업비율/NNG,19,1.6133635639325008,Hawkish
9,7, 실물/NNG;경제/NNG;제약/NNG,16,1.866892123979037,Hawkish
19,16, 커런시/NNG,35,1.7242823089528605,Hawkish
11,11,산적/NNG,22,1.4520272075392509,Hawkish
17,15, 忠/NNG,32,1.645630835211151,Hawkish
17,11, cd/NNG;오르/VV,28,2.244042048015206,Hawkish
26,18,공모주청약/NNG,44,2.097372633112251,Hawkish
9,10, 컨센서스/NNG;상승/NNG,19,1.3068244867853258,Hawkish
21,22,주체/NNG,43,1.3860259708329212,Hawkish
12,8, 투자/NNG;비중/NNG;낮/VV,20,2.1780408113088763,Hawkish
55,42, 주니어/NNG,97,1.901464200349019,Hawkish
38,34,판관비/NNG,72,1.622853937837986,Hawkish
11,7, 경제/NNG;안정/NNG;위협/NNG,18,2.2817570404188228,Hawkish
8,8,두드러지/VV,16,1.4520272075392506,Hawkish
11,8, 겁내/VV,19,1.9965374103664697,Hawkish
22,17, 해악/NNG,39,1.879094033286089,Hawkish
39,37,경제동향보고서/NNG,76,1.5305151647035347,Hawkish
8,8, 부동산/NNG;주가/NNG;하락/NNG,16,1.4520272075392506,Hawkish
8,8, 내사/NNG,16,1.4520272075392506,Hawkish
9,10,전동차/NNG,19,1.3068244867853258,Hawkish
9,8, 투고/NNG,17,1.6335306084816572,Hawkish
9,8,제의/NNG,17,1.6335306084816572,Hawkish
20,18, 입장료/NNG,38,1.6133635639325008,Hawkish
19,12,시납/NNG,31,2.299043078603814,Hawkish
13,13, 예상/NNG;상승/NNG;웃돌/VV,26,1.4520272075392509,Hawkish
10,11, 재건축부담금/NNG,21,1.3200247341265916,Hawkish
20,16, 셀링/NNG,36,1.8150340094240636,Hawkish
24,15, 연체율/NNG;떨어/VV,39,2.3232435320628015,Hawkish
15,7,개발붐/NNG,22,3.1114868732983947,Hawkish
14,9, 유가/NNG;상품/NNG;가격/NNG;급등/NNG,23,2.258708989505501,Hawkish
14,10, 금리/NNG;cd/NNG;금리/NNG;상승/NNG,24,2.032838090554951,Hawkish
12,12, 부채/NNG;부실/NNG,24,1.4520272075392509,Hawkish
116,120, ebitda/NNG,236,1.4036263006212757,Hawkish
34,31,테스트/NNG,65,1.5925459695591786,Hawkish
14,13, 지수/NNG;상승/NNG;발목/NNG;잡/VV,27,1.5637216081191931,Hawkish
20,19, 건전성/NNG;저해/NNG,39,1.5284496921465798,Hawkish
17,10, 대출/NNG;비용/NNG;증가/NNG,27,2.4684462528167264,Hawkish
12,13, 상장계획/NNG,25,1.3403328069593086,Hawkish
26,23, 무역업/NNG,49,1.6414220606965444,Hawkish
19,17, 건의문/NNG,36,1.622853937837986,Hawkish
26,27,아래쪽/NNG,53,1.3982484220748341,Hawkish
24,17,코스/NNG,41,2.0499207635848244,Hawkish
10,9, 샤프지수/NNG,19,1.6133635639325008,Hawkish
28,23,육류/NNG,51,1.76768529613474,Hawkish
13,3, 취도/NNG,16,6.292117899336753,Hawkish
19,7, 인플레이션/NNG;매파/NNG,26,3.941216706177967,Hawkish
45,32, 배출권/NNG,77,2.0419132606020716,Hawkish
16,6, 캐파/NNG,22,3.8720725534380014,Hawkish
11,8,만기보유/NNG,19,1.9965374103664697,Hawkish
12,11, 외로운/VA,23,1.58402968095191,Hawkish
10,11,증여/NNG,21,1.3200247341265916,Hawkish
14,9,상속/NNG,23,2.258708989505501,Hawkish
40,36, 도용/NNG,76,1.6133635639325008,Hawkish
20,13, 살표/NNG,33,2.2338880115988475,Hawkish
8,8, 송사/NNG,16,1.4520272075392506,Hawkish
10,11, 시연/NNG,21,1.3200247341265916,Hawkish
12,9, 인터랙티브/NNG,21,1.9360362767190011,Hawkish
17,18, 부동산/NNG;급락/NNG,35,1.3713590293426259,Hawkish
12,12,대주/NNG,24,1.4520272075392509,Hawkish
14,13, 표면상/NNG,27,1.5637216081191931,Hawkish
33,20, 급액/NNG,53,2.3958448924397633,Hawkish
9,9, 수료율/NNG,18,1.4520272075392509,Hawkish
15,10,출혈/NNG,25,2.178040811308876,Hawkish
16,16,오늘날/NNG,32,1.4520272075392506,Hawkish
36,36,크로스/NNG,72,1.4520272075392509,Hawkish
18,17,방학/NNG,35,1.5374405726886184,Hawkish
10,6, 소비/NNG;심리/NNG;냉각/NNG,16,2.420045345898751,Hawkish
43,47, 점포수/NNG,90,1.328450423918889,Hawkish
12,8, 최대/NNG;업체/NNG;하락/NNG,20,2.1780408113088763,Hawkish
19,18, 경제/NNG;성장/NNG;위험/NNG,37,1.5326953857358758,Hawkish
11,7,근저당설정/NNG,18,2.2817570404188228,Hawkish
19,17, 냉장/NNG,36,1.622853937837986,Hawkish
10,8,헌혈/NNG,18,1.8150340094240636,Hawkish
42,36,스프린트/NNG,78,1.6940317421291258,Hawkish
12,8,댈/VV,20,2.1780408113088763,Hawkish
23,24, 대나/NNG,47,1.3915260738917818,Hawkish
8,8, 소득분배/NNG;개선/NNG,16,1.4520272075392506,Hawkish
29,29, 숨져/VV,58,1.4520272075392509,Hawkish
24,24, 소국/NNG,48,1.4520272075392509,Hawkish
10,10, 은행/NNG;예대마진/NNG;확대/NNG,20,1.4520272075392509,Hawkish
8,8, 중소기업/NNG;대출/NNG;금리/NNG;상승/NNG,16,1.4520272075392506,Hawkish
12,5, 호브/NNG,17,3.484865298094202,Hawkish
24,15,되돌/VV,39,2.3232435320628015,Hawkish
12,7,행간/NNG,19,2.489189498638716,Hawkish
10,8,심지/NNG,18,1.8150340094240636,Hawkish
10,7, 밀폐/NNG,17,2.07432458219893,Hawkish
16,16,탕/MAG,32,1.4520272075392506,Hawkish
15,16, 유니폼/NNG,31,1.3612755070680476,Hawkish
10,11, 미수거래/NNG,21,1.3200247341265916,Hawkish
10,7, 내수소/NNG,17,2.07432458219893,Hawkish
15,12,해초/NNG,27,1.8150340094240633,Hawkish
17,12, 서약서/NNG,29,2.0570385440139387,Hawkish
21,9, 배낭/NNG,30,3.3880634842582515,Hawkish
27,21,돼지/NNG,48,1.8668921239790368,Hawkish
47,22, 주거래통장/NNG,69,3.10205812519749,Hawkish
11,10, 유가/NNG;주가/NNG;하락/NNG,21,1.5972299282931757,Hawkish
11,8, 대외변수/NNG;불안/NNG,19,1.9965374103664697,Hawkish
16,14, 돈독/NNG,30,1.6594596657591438,Hawkish
11,6, 폰지게임/NNG,17,2.662049880488626,Hawkish
20,12, 조부모/NNG,32,2.420045345898751,Hawkish
9,7, 자본시장/NNG;불안/NNG,16,1.866892123979037,Hawkish
11,7, 잡자/NNG,18,2.2817570404188228,Hawkish
14,12, 컨슈머리포트/NNG,26,1.6940317421291258,Hawkish
23,21, 고와/NNG,44,1.5903155130191793,Hawkish
9,10, 공급규제/NNG,19,1.3068244867853258,Hawkish
10,9, 좋/VA;우려/NNG,19,1.6133635639325008,Hawkish
11,11, 지수/NNG;낙폭/NNG;크/VV,22,1.4520272075392509,Hawkish
14,13, 국채선물/NNG;지지/NNG,27,1.5637216081191931,Hawkish
15,14, 캐리/NNG;자금/NNG;이탈/NNG,29,1.5557434366491973,Hawkish
33,30, 승장/NNG,63,1.5972299282931757,Hawkish
9,8, 따분/NNG,17,1.6335306084816572,Hawkish
9,8, 돋친/VV,17,1.6335306084816572,Hawkish
16,9, 한도거래/NNG,25,2.5813817022920014,Hawkish
8,8, 하락/NNG;많/VA,16,1.4520272075392506,Hawkish
18,8, 신흥시장/NNG;불확실성/NNG,26,3.2670612169633144,Hawkish
17,18, 동사무소/NNG,35,1.3713590293426259,Hawkish
13,9, 호되/VA,22,2.097372633112251,Hawkish
8,8, evebitda/NNG,16,1.4520272075392506,Hawkish
10,10, 마진/NNG;안정/NNG,20,1.4520272075392509,Hawkish
8,8,허문/NNG,16,1.4520272075392506,Hawkish
14,14, 금리/NNG;인상/NNG;가능성/NNG;경기/NNG;둔화/NNG,28,1.4520272075392509,Hawkish
10,11,강철/NNG,21,1.3200247341265916,Hawkish
12,10, 실적/NNG;견인/NNG,22,1.742432649047101,Hawkish
35,31, 유공/NNG,66,1.6393855568991544,Hawkish
13,11, 장려상/NNG,24,1.7160321543645694,Hawkish
11,10, 스태그플레이션/NNG;경기/NNG;침체/NNG,21,1.5972299282931757,Hawkish
12,12,세전이익/NNG,24,1.4520272075392509,Hawkish
10,6, 짠돌이/NNG,16,2.420045345898751,Hawkish
14,15, 기업/NNG;이익/NNG;줄/VV,29,1.3552253937033008,Hawkish
17,11, 세고/NNG,28,2.244042048015206,Hawkish
9,9, 소매/NNG;금융/NNG;확대/NNG,18,1.4520272075392509,Hawkish
24,22,실사/NNG,46,1.58402968095191,Hawkish
27,27, 현장실사/NNG,54,1.4520272075392506,Hawkish
18,18,들여/VV,36,1.4520272075392509,Hawkish
12,10,신용정보회사/NNG,22,1.742432649047101,Hawkish
10,10, 경제/NNG;심각/NNG;침체/NNG,20,1.4520272075392509,Hawkish
9,7,마찰/NNG,16,1.866892123979037,Hawkish
10,10, 금리/NNG;오르/VV;성장/NNG,20,1.4520272075392509,Hawkish
19,17,기준율/NNG,36,1.622853937837986,Hawkish
10,8,싱에/NNG,18,1.8150340094240636,Hawkish
15,13, 빼냈/VV,28,1.6754160086991354,Hawkish
17,15, 출자총액제한제/NNG,32,1.645630835211151,Hawkish
9,8, 일자리/NNG;구하/VV;어렵/VA,17,1.6335306084816572,Hawkish
13,14, 원화/NNG;대출/NNG;늘/VV,27,1.3483109784293044,Hawkish
13,11, 정책/NNG;투명/NNG;높/VV,24,1.7160321543645694,Hawkish
25,21, 지표물/NNG;내리/VV,46,1.7286038184991082,Hawkish
14,9,테마섹/NNG,23,2.258708989505501,Hawkish
12,12, 과잉/NNG;긴축/NNG;우려/NNG,24,1.4520272075392509,Hawkish
8,8, 하락/NNG;심각/NNG,16,1.4520272075392506,Hawkish
15,11,기업사냥꾼/NNG,26,1.9800371011898874,Hawkish
10,7, 영감/NNG,17,2.07432458219893,Hawkish
16,6, 포커/NNG,22,3.8720725534380014,Hawkish
11,6,투자이익/NNG,17,2.662049880488626,Hawkish
16,14, 써냈/VV,30,1.6594596657591438,Hawkish
16,6, 포유/NNG,22,3.8720725534380014,Hawkish
8,8, 거래통장/NNG,16,1.4520272075392506,Hawkish
10,7, 전방/NNG;산업/NNG;호조/NNG,17,2.07432458219893,Hawkish
15,12, 투자/NNG;경제/NNG;성장/NNG,27,1.8150340094240633,Hawkish
8,8, 주책/NNG,16,1.4520272075392506,Hawkish
9,8, 지수/NNG;하방/NNG,17,1.6335306084816572,Hawkish
39,34, 코치/NNG,73,1.66556062041267,Hawkish
10,6, 징검다리/NNG;금리/NNG;인상/NNG,16,2.420045345898751,Hawkish
17,15, 대형차/NNG,32,1.645630835211151,Hawkish
11,11, 받자/NNG,22,1.4520272075392509,Hawkish
11,10, 어울려/VV,21,1.5972299282931757,Hawkish
30,29, 청렴/NNG,59,1.5020971112475008,Hawkish
11,11,난민/NNG,22,1.4520272075392509,Hawkish
20,15, 입항/NNG,35,1.936036276719001,Hawkish
16,17, 치러졌/VV,33,1.3666138423898828,Hawkish
58,63, 획정/NNG,121,1.3367869529726435,Hawkish
8,8,신생/NNG,16,1.4520272075392506,Hawkish
12,10, 회분/NNG,22,1.742432649047101,Hawkish
14,12,손잡/VV,26,1.6940317421291258,Hawkish
25,25, 공장/NNG;가동/NNG;중단/NNG,50,1.4520272075392509,Hawkish
21,15, 입원비/NNG,36,2.032838090554951,Hawkish
8,8, 위험/NNG;악재/NNG,16,1.4520272075392506,Hawkish
33,34, 안전진단/NNG,67,1.4093205249645666,Hawkish
10,11,명문/NNG,21,1.3200247341265916,Hawkish
12,7, 방공/NNG,19,2.489189498638716,Hawkish
20,17,발주/NNG,37,1.7082673029873539,Hawkish
11,6, 에로/NNG,17,2.662049880488626,Hawkish
23,24,제작/NNG,47,1.3915260738917818,Hawkish
11,7, 뒷거래/NNG,18,2.2817570404188228,Hawkish
16,8, 긴축/NNG;악재/NNG,24,2.9040544150785013,Hawkish
20,20, 소비/NNG;지출/NNG;약화/NNG,40,1.4520272075392509,Hawkish
12,4,순환변동치/NNG,16,4.356081622617753,Hawkish
9,7, 지급여력비율/NNG;오르/VV,16,1.866892123979037,Hawkish
23,20, 달러원/NNG;하향/NNG,43,1.6698312886701383,Hawkish
25,21, 연인/NNG,46,1.7286038184991082,Hawkish
9,10,실명/NNG,19,1.3068244867853258,Hawkish
54,56,전선/NNG,110,1.4001690929842776,Hawkish
50,40, 소상공인지원센터/NNG,90,1.8150340094240636,Hawkish
15,13, 가격/NNG;상승/NNG;억제/NNG,28,1.6754160086991354,Hawkish
14,13, 이익/NNG;모멘텀/NNG;둔화/NNG,27,1.5637216081191931,Hawkish
9,8, 악화/NNG;우려/NNG;완화/NNG,17,1.6335306084816572,Hawkish
18,14, 상승률/NNG;마이너스/NNG,32,1.866892123979037,Hawkish
54,58,취임식/NNG,112,1.3518874001227508,Hawkish
9,9, 칩니다/VV,18,1.4520272075392509,Hawkish
12,12, 자산/NNG;크/VV,24,1.4520272075392509,Hawkish
32,31, 지수/NNG;금리/NNG;인상/NNG;우려/NNG,63,1.4988667948792267,Hawkish
10,8,조회/NNG,18,1.8150340094240636,Hawkish
48,49, 수영/NNG,97,1.4223939992221233,Hawkish
18,16, 예규/NNG,34,1.6335306084816572,Hawkish
10,9, 펴내/VV,19,1.6133635639325008,Hawkish
11,10,최대경제국/NNG,21,1.5972299282931757,Hawkish
13,4,란/NNG,17,4.719088424502566,Hawkish
11,12, 길/VA;침체/NNG,23,1.331024940244313,Hawkish
11,9, 이권/NNG,20,1.774699920325751,Hawkish
13,12, 무협/NNG,25,1.5730294748341882,Hawkish
18,16, 몰라라/VV,34,1.6335306084816572,Hawkish
18,17, 금리/NNG;인상/NNG;성장/NNG,35,1.5374405726886184,Hawkish
14,13,홍콩h주/NNG,27,1.5637216081191931,Hawkish
11,10, 비췄/VV,21,1.5972299282931757,Hawkish
13,14, 동일점/NNG;매출/NNG;감소/NNG,27,1.3483109784293044,Hawkish
38,23, 지준율/NNG;높/VV,61,2.399001473325719,Hawkish
15,16,눈여겨볼/VV,31,1.3612755070680476,Hawkish
17,18,모션/NNG,35,1.3713590293426259,Hawkish
13,12,하회/NNG,25,1.5730294748341882,Hawkish
15,9,미혼/NNG,24,2.420045345898751,Hawkish
46,41,아태/NNG,87,1.6291036962635497,Hawkish
19,17, 최대손실/NNG,36,1.622853937837986,Hawkish
9,9, 수익/NNG;그치/VV,18,1.4520272075392509,Hawkish
28,29, 억눌려/VV,57,1.4019573038310007,Hawkish
21,20,지시/NNG,41,1.5246285679162133,Hawkish
13,14, 경제/NNG;성장/NNG;호조/NNG,27,1.3483109784293044,Hawkish
10,6, 근월/NNG,16,2.420045345898751,Hawkish
23,20, 파생상품이익/NNG,43,1.6698312886701383,Hawkish
8,8, 불안/NNG;요소/NNG;많/VA,16,1.4520272075392506,Hawkish
27,19, 올라갈지/VV,46,2.0634070843978827,Hawkish
10,8, 수요자/NNG;부담/NNG,18,1.8150340094240636,Hawkish
19,17, 야근/NNG,36,1.622853937837986,Hawkish
28,28,나선다/VV,56,1.4520272075392509,Hawkish
12,12,주력상품/NNG,24,1.4520272075392509,Hawkish
10,9, 악화/NNG;우려/NNG;크/VV,19,1.6133635639325008,Hawkish
10,9, 쉽/VA;않/VX;금리/NNG;인상/NNG,19,1.6133635639325008,Hawkish
12,11, 주택/NNG;경기/NNG;확장/NNG,23,1.58402968095191,Hawkish
20,18, 일촉즉발/NNG,38,1.6133635639325008,Hawkish
11,9, 동업자/NNG,20,1.774699920325751,Hawkish
13,7, 유가/NNG;상승/NNG;일시적/VAX,20,2.6966219568586087,Hawkish
26,22,강문/NNG,48,1.7160321543645694,Hawkish
11,11, 기업/NNG;실적/NNG;호조/NNG;힘입/VV;상승/NNG,22,1.4520272075392509,Hawkish
13,14,연달/VV,27,1.3483109784293044,Hawkish
9,7, 불빛/NNG,16,1.866892123979037,Hawkish
11,6, 긴축/NNG;가능성/NNG;높/VA,17,2.662049880488626,Hawkish
13,10, 선구자/NNG,23,1.887635369801026,Hawkish
20,19, 옥외/NNG,39,1.5284496921465798,Hawkish
15,12, 외평채/NNG;스프레드/NNG;오르/VV,27,1.8150340094240633,Hawkish
18,14, 저금통/NNG,32,1.866892123979037,Hawkish
9,7, 젠더/NNG,16,1.866892123979037,Hawkish
12,9, 경원/NNG,21,1.9360362767190011,Hawkish
8,8, 불안/NNG;가능성/NNG;높/VA,16,1.4520272075392506,Hawkish
11,8, 애프터/NNG,19,1.9965374103664697,Hawkish
21,14, 높/VA;양적완화/NNG,35,2.1780408113088763,Hawkish
17,13, 퀀텀펀드/NNG,30,1.8988048098590204,Hawkish
19,12, 경제/NNG;회복/NNG;찬물/NNG,31,2.299043078603814,Hawkish
14,14, 금리/NNG;대출/NNG;금리/NNG;상향/NNG,28,1.4520272075392509,Hawkish
11,11, 리서/NNG,22,1.4520272075392509,Hawkish
23,19,고위급/NNG,42,1.7577171459685668,Hawkish
14,14, 납북/NNG,28,1.4520272075392509,Hawkish
14,14, 만지/VV,28,1.4520272075392509,Hawkish
14,11, 가격/NNG;타격/NNG,25,1.8480346277772284,Hawkish
11,9,차이점/NNG,20,1.774699920325751,Hawkish
19,18, 전미경제학회/NNG,37,1.5326953857358758,Hawkish
13,8, 억제력/NNG,21,2.359544212251283,Hawkish
17,14,중복/NNG,31,1.7631758948690905,Hawkish
9,10, 해외/NNG;수주/NNG;모멘텀/NNG,19,1.3068244867853258,Hawkish
275,272,중국발/NNG,547,1.468042213504757,Hawkish
19,17, 판매/NNG;실적/NNG;오르/VV,36,1.622853937837986,Hawkish
10,7,高/NNG,17,2.07432458219893,Hawkish
8,8, 경제정책/NNG;금리/NNG;인상/NNG,16,1.4520272075392506,Hawkish
11,9, 房/NNG,20,1.774699920325751,Hawkish
19,12, 사채업/NNG,31,2.299043078603814,Hawkish
8,8, 인수/NNG;위험/NNG,16,1.4520272075392506,Hawkish
16,12, 소비자/NNG;선호/NNG,28,1.9360362767190007,Hawkish
166,185,앵커/NNG,351,1.3029000889271116,Hawkish
18,16, 경제/NNG;지표/NNG;약하/VA,34,1.6335306084816572,Hawkish
13,12, 배꼽/NNG,25,1.5730294748341882,Hawkish
9,9, 내로/NNG,18,1.4520272075392509,Hawkish
23,14,위성/NNG,37,2.3854732695287693,Hawkish
33,25, 황금연휴/NNG,58,1.916675913951811,Hawkish
19,16, 지표/NNG;시장/NNG;예상/NNG;웃돌/VV,35,1.7242823089528605,Hawkish
20,6, 노동/NNG;비용/NNG;하락/NNG,26,4.840090691797502,Hawkish
13,7,공공분양/NNG,20,2.6966219568586087,Hawkish
9,8, 쏜다/VV,17,1.6335306084816572,Hawkish
11,12, 즉석/NNG,23,1.331024940244313,Hawkish
48,43, 사립대/NNG,91,1.6208675805089312,Hawkish
35,34,청약통장/NNG,69,1.4947338901139346,Hawkish
18,10, 타가/XSV,28,2.6136489735706516,Hawkish
11,6, 외환시장/NNG;오르/VV,17,2.662049880488626,Hawkish
21,16, 인플레이션/NNG;최저/NNG,37,1.9057857098952666,Hawkish
9,8,출하량/NNG,17,1.6335306084816572,Hawkish
18,11, 과잉/NNG;유동성/NNG;억제/NNG,29,2.376044521427865,Hawkish
16,9, 바쿠/NNG,25,2.5813817022920014,Hawkish
98,54, 석방/NNG,152,2.6351604877564183,Hawkish
10,6, 인플레이션/NNG;우려/NNG;점증/NNG,16,2.420045345898751,Hawkish
22,15, 견실/NNG;증가/NNG,37,2.129639904390901,Hawkish
22,21, 지수/NNG;fed/NNG;금리/NNG;인상/NNG,43,1.5211713602792152,Hawkish
17,18,발목/NNG,35,1.3713590293426259,Hawkish
30,10,감세안/NNG,40,4.356081622617752,Hawkish
45,49, 세관/NNG,94,1.3334943742707404,Hawkish
19,13, 자금사정/NNG;나쁘/VA,32,2.122193611018905,Hawkish
11,8, 외국인/NNG;매도/NNG;부담/NNG,19,1.9965374103664697,Hawkish
32,32,종합자산관리계좌/NNG,64,1.4520272075392506,Hawkish
9,8,여우/NNG,17,1.6335306084816572,Hawkish
11,6,공감/NNG,17,2.662049880488626,Hawkish
13,8, 가격/NNG;오르/VV;최대/NNG,21,2.359544212251283,Hawkish
11,11, 떨어뜨려야/VV,22,1.4520272075392509,Hawkish
20,18, 원화/NNG;환율/NNG;떨어/VV,38,1.6133635639325008,Hawkish
11,12, 소비/NNG;악화/NNG,23,1.331024940244313,Hawkish
11,11, 원자재/NNG;가격/NNG;상승/NNG;인플레이션/NNG;압력/NNG,22,1.4520272075392509,Hawkish
35,38, 버블세븐/NNG,73,1.3373934806282575,Hawkish
37,33, 금리/NNG;인상/NNG;성장/NNG;둔화/NNG,70,1.6280305054227964,Hawkish
15,9,갭상승/NNG,24,2.420045345898751,Hawkish
22,18, 기공식/NNG,40,1.774699920325751,Hawkish
17,7, 우면/NNG,24,3.526351789738181,Hawkish
11,6,지폐/NNG,17,2.662049880488626,Hawkish
11,10, 유가/NNG;내림/NNG,21,1.5972299282931757,Hawkish
10,7, 금리/NNG;인상/NNG;우려/NNG;경기/NNG;둔화/NNG,17,2.07432458219893,Hawkish
15,11, 불러들이/VV,26,1.9800371011898874,Hawkish
8,8, 가계/NNG;부실/NNG;우려/NNG,16,1.4520272075392506,Hawkish
24,20, 탁론/NNG,44,1.742432649047101,Hawkish
9,8, 무수히/MAG,17,1.6335306084816572,Hawkish
12,12,큐/NNG,24,1.4520272075392509,Hawkish
52,39, 지준율/NNG;상향/NNG,91,1.9360362767190011,Hawkish
13,10, 긴축/NNG;충격/NNG,23,1.887635369801026,Hawkish
17,12, 국제중재/NNG,29,2.0570385440139387,Hawkish
9,8, 지표/NNG;최악/NNG,17,1.6335306084816572,Hawkish
10,11, 미리/MAG;자금/NNG;확보/NNG,21,1.3200247341265916,Hawkish
13,9, cd/NNG;상승/NNG,22,2.097372633112251,Hawkish
11,5, 인플레이션/NNG;가능성/NNG;높/VA,16,3.1944598565863513,Hawkish
13,11, 물가/NNG;상승/NNG;잡/VV,24,1.7160321543645694,Hawkish
92,49, 인플루엔자/NNG,141,2.726255165175736,Hawkish
23,22, 채권/NNG;가격/NNG;소폭/MAG;하락/NNG,45,1.5180284442455803,Hawkish
9,10, 부동산/NNG;경기/NNG;꺾/VV,19,1.3068244867853258,Hawkish
42,46, 럭셔리/NNG,88,1.325763972101055,Hawkish
10,9, 둔화/NNG;아니/VCN,19,1.6133635639325008,Hawkish
16,9, 경제/NNG;힘들/VA,25,2.5813817022920014,Hawkish
9,7, 손익/NNG;악화/NNG,16,1.866892123979037,Hawkish
14,11, 트릭/NNG,25,1.8480346277772284,Hawkish
10,7, 수출기업/NNG;실적/NNG;악화/NNG,17,2.07432458219893,Hawkish
10,10,재학/NNG,20,1.4520272075392509,Hawkish
10,9, 휴장기간/NNG,19,1.6133635639325008,Hawkish
9,10,지능/NNG,19,1.3068244867853258,Hawkish
22,24, 정책/NNG;경제/NNG;성장/NNG,46,1.331024940244313,Hawkish
11,7, 물가/NNG;상승/NNG;압력/NNG;점차/MAG;크/VV,18,2.2817570404188228,Hawkish
11,8, 바닥/NNG;알/VV;없/VA,19,1.9965374103664697,Hawkish
36,38, 미르/NNG,74,1.375604722931922,Hawkish
21,13, 참을성/NNG,34,2.3455824121787896,Hawkish
10,9, 당분간/MAG;인플레이션/NNG;압력/NNG,19,1.6133635639325008,Hawkish
10,6, 금리/NNG;인상/NNG;경기/NNG;하락/NNG,16,2.420045345898751,Hawkish
12,8, 예상/NNG;심각/NNG;않/VX,20,2.1780408113088763,Hawkish
16,16, 잔해/NNG,32,1.4520272075392506,Hawkish
17,18, 대장정/NNG,35,1.3713590293426259,Hawkish
29,29, 도시계획/NNG,58,1.4520272075392509,Hawkish
11,6, 굴러갈/VV,17,2.662049880488626,Hawkish
12,12, 풍랑/NNG,24,1.4520272075392509,Hawkish
9,8, 부도/NNG;처리/NNG;유예/NNG,17,1.6335306084816572,Hawkish
9,7, 담보대출/NNG;금리/NNG;오르/VV,16,1.866892123979037,Hawkish
48,46, 개막식/NNG,94,1.5151588252583488,Hawkish
23,16,재개발재건축/NNG,39,2.087289110837673,Hawkish
17,17, 대손비용/NNG;늘/VV,34,1.4520272075392509,Hawkish
38,20, 미술품/NNG,58,2.7588516943245764,Hawkish
11,9,佛/NNG,20,1.774699920325751,Hawkish
16,14, 디지털화/NNG,30,1.6594596657591438,Hawkish
10,9, 졸업식/NNG,19,1.6133635639325008,Hawkish
17,17, 설정원본액/NNG,34,1.4520272075392509,Hawkish
25,3, 익일입금제/NNG,28,12.100226729493755,Hawkish
19,10, 재정부채/NNG,29,2.7588516943245764,Hawkish
20,15, 홈경기/NNG,35,1.936036276719001,Hawkish
67,59,복/NNG,126,1.6489122526293187,Hawkish
12,12,호국/NNG,24,1.4520272075392509,Hawkish
10,10, 어닝쇼크/NNG;우려/NNG,20,1.4520272075392509,Hawkish
11,9,방배/NNG,20,1.774699920325751,Hawkish
11,10, 시중/NNG;유동성/NNG;억제/NNG,21,1.5972299282931757,Hawkish
9,7,주식자산/NNG,16,1.866892123979037,Hawkish
22,6, 콜/NNG;금리/NNG;급등/NNG,28,5.324099760977252,Hawkish
10,10, 보내오/VV,20,1.4520272075392509,Hawkish
12,12,저인플레이션/NNG,24,1.4520272075392509,Hawkish
12,11,의욕/NNG,23,1.58402968095191,Hawkish
13,13, 전망/NNG;그리/MAG;좋/VA;않/VX,26,1.4520272075392509,Hawkish
12,6, 인상/NNG;확산/NNG,18,2.9040544150785017,Hawkish
18,20, 지표/NNG;견고/NNG,38,1.3068244867853258,Hawkish
17,11, 관리지역/NNG,28,2.244042048015206,Hawkish
21,7, 양허안/NNG,28,4.356081622617753,Hawkish
14,11,생산설비/NNG,25,1.8480346277772284,Hawkish
14,8, 정기보수/NNG,22,2.541047613193689,Hawkish
13,12, 준비은행/NNG,25,1.5730294748341882,Hawkish
11,10, 경제/NNG;경착륙/NNG;위험/NNG,21,1.5972299282931757,Hawkish
14,8, 자산/NNG;질/NNG;개선/NNG,22,2.541047613193689,Hawkish
11,9, 가격/NNG;상승률/NNG;둔화/NNG,20,1.774699920325751,Hawkish
16,12, 범했/VV,28,1.9360362767190007,Hawkish
11,5, 펀더멘털/NNG;견실/NNG,16,3.1944598565863513,Hawkish
9,9, 대포동2호/NNG,18,1.4520272075392509,Hawkish
15,15, 士/NNG,30,1.4520272075392506,Hawkish
12,6,남북협력기금/NNG,18,2.9040544150785017,Hawkish
15,10, 예고안/NNG,25,2.178040811308876,Hawkish
13,8, 금리/NNG;인상/NNG;지준율/NNG;상향/NNG,21,2.359544212251283,Hawkish
11,8,의석/NNG,19,1.9965374103664697,Hawkish
17,7, 과도/NNG;성장/NNG,24,3.526351789738181,Hawkish
42,33, 차입매수/NNG,75,1.8480346277772282,Hawkish
23,22,대륙/NNG,45,1.5180284442455803,Hawkish
30,33, 가격/NNG;빠지/VV,63,1.3200247341265916,Hawkish
11,10, 개척단/NNG,21,1.5972299282931757,Hawkish
24,26, 모기지/NNG;상환/NNG;부담/NNG,50,1.3403328069593086,Hawkish
38,40, 향토/NNG,78,1.3794258471622882,Hawkish
36,38, 공영주차장/NNG,74,1.375604722931922,Hawkish
20,21, 이자/NNG;낮/VV,41,1.3828830547992865,Hawkish
23,20,인수금액/NNG,43,1.6698312886701383,Hawkish
12,12, 국민부담률/NNG,24,1.4520272075392509,Hawkish
17,8, 트랙터/NNG,25,3.0855578160209083,Hawkish
11,10, 주택담보대출/NNG;중단/NNG,21,1.5972299282931757,Hawkish
17,6, 단기물/NNG;시장/NNG;불안/NNG,23,4.114077088027877,Hawkish
11,8, 우려/NNG;투자심리/NNG;악화/NNG,19,1.9965374103664697,Hawkish
14,9, 이익/NNG;추정/NNG;상향/NNG,23,2.258708989505501,Hawkish
12,9, 국채선물/NNG;갭하락/NNG,21,1.9360362767190011,Hawkish
8,8,살림살이/NNG,16,1.4520272075392506,Hawkish
11,10, 신흥시장/NNG;통화/NNG;약세/NNG,21,1.5972299282931757,Hawkish
8,8, 외환시장/NNG;안전자산/NNG;선호/NNG,16,1.4520272075392506,Hawkish
10,10,빅스/NNG,20,1.4520272075392509,Hawkish
10,6, 금리/NNG;인상/NNG;대출/NNG;금리/NNG;상승/NNG,16,2.420045345898751,Hawkish
19,5, 의뢰인/NNG,24,5.517703388649153,Hawkish
18,12, 달아난/VV,30,2.1780408113088763,Hawkish
11,7,기준일/NNG,18,2.2817570404188228,Hawkish
23,12,상회/NNG,35,2.7830521477835637,Hawkish
10,7, 대출/NNG;수요/NNG;많/VA;않/VX,17,2.07432458219893,Hawkish
19,20, 집값/NNG;약세/NNG,39,1.3794258471622882,Hawkish
26,11, 알박기/NNG,37,3.4320643087291387,Hawkish
16,15, 훈령/NNG,31,1.5488290213752007,Hawkish
15,10, 파마/NNG,25,2.178040811308876,Hawkish
12,10, 미등기/NNG,22,1.742432649047101,Hawkish
15,13, 위험/NNG;강화/NNG,28,1.6754160086991354,Hawkish
10,9, 국제/NNG;유가/NNG;원자재/NNG;가격/NNG;급등/NNG,19,1.6133635639325008,Hawkish
14,5, 돈거래/NNG,19,4.065676181109902,Hawkish
9,7,급여통장/NNG,16,1.866892123979037,Hawkish
13,14, 낮/VA;기저효과/NNG,27,1.3483109784293044,Hawkish
18,11, 공공요금/NNG;오르/VV,29,2.376044521427865,Hawkish
11,7, 경기/NNG;지표/NNG;하락/NNG,18,2.2817570404188228,Hawkish
17,16, 머신/NNG,33,1.5427789080104541,Hawkish
17,18, 가격/NNG;하락/NNG;크/VV,35,1.3713590293426259,Hawkish
9,8, 잦아질/VV,17,1.6335306084816572,Hawkish
10,11,브리지/NNG,21,1.3200247341265916,Hawkish
10,11, 대출/NNG;받/VV;쉽/VA;않/VX,21,1.3200247341265916,Hawkish
10,11, 지수/NNG;증시/NNG;하락/NNG,21,1.3200247341265916,Hawkish
17,8, 금리/NNG;목표/NNG;인상/NNG,25,3.0855578160209083,Hawkish
12,13,주택저당채권/NNG,25,1.3403328069593086,Hawkish
14,15, 워킹/NNG,29,1.3552253937033008,Hawkish
27,12, 전산장애/NNG,39,3.267061216963314,Hawkish
11,8, 경제/NNG;과열/NNG;우려/NNG,19,1.9965374103664697,Hawkish
9,7, 만일/NNG;금리/NNG;인상/NNG,16,1.866892123979037,Hawkish
14,9, 손안/NNG,23,2.258708989505501,Hawkish
26,12, 자본/NNG;넘/VV,38,3.1460589496683764,Hawkish
11,7,호우/NNG,18,2.2817570404188228,Hawkish
17,17, 유골/NNG,34,1.4520272075392509,Hawkish
27,26, 시험장/NNG,53,1.5078744078292219,Hawkish
30,31, 취업자/NNG;늘/VV,61,1.405187620199275,Hawkish
10,8, 불안/NNG;인상/NNG,18,1.8150340094240636,Hawkish
11,11, 소수지분/NNG,22,1.4520272075392509,Hawkish
12,9, 인하/NNG;내리/VV,21,1.9360362767190011,Hawkish
10,6, 떨쳐냈/VV,16,2.420045345898751,Hawkish
21,22, 텐/NNG,43,1.3860259708329212,Hawkish
9,10, 주택/NNG;경기/NNG;우려/NNG,19,1.3068244867853258,Hawkish
9,9, 리빙/NNG,18,1.4520272075392509,Hawkish
11,8, 글로벌/NNG;경기/NNG;연착륙/NNG,19,1.9965374103664697,Hawkish
9,7, 빠트리/VV,16,1.866892123979037,Hawkish
142,155,임일/NNG,297,1.3302442804553138,Hawkish
15,13,대형화/NNG,28,1.6754160086991354,Hawkish
13,13, 불안정성/NNG;크/VV,26,1.4520272075392509,Hawkish
35,28, 인플레이션/NNG;상승/NNG;우려/NNG,63,1.8150340094240638,Hawkish
14,4, 채권시장/NNG;일드커브/NNG;플래트닝/NNG,18,5.082095226387378,Hawkish
15,15, 찾아간/VV,30,1.4520272075392506,Hawkish
8,8, 경기/NNG;지표/NNG;긍정적/VAX,16,1.4520272075392506,Hawkish
18,11, 동해/NNG,29,2.376044521427865,Hawkish
12,6, 자판기/NNG,18,2.9040544150785017,Hawkish
11,9, 읽혀/VV,20,1.774699920325751,Hawkish
20,18,지표채권/NNG,38,1.6133635639325008,Hawkish
14,2, 포식자/NNG,16,10.164190452774756,Hawkish
13,7, 금리/NNG;인상/NNG;모멘텀/NNG,20,2.6966219568586087,Hawkish
12,10, 드나들/VV,22,1.742432649047101,Hawkish
9,7, 와이어/NNG,16,1.866892123979037,Hawkish
13,9,체질/NNG,22,2.097372633112251,Hawkish
13,10, 영상물/NNG,23,1.887635369801026,Hawkish
24,24, 현수막/NNG,48,1.4520272075392509,Hawkish
19,7, 간주임대료/NNG,26,3.941216706177967,Hawkish
14,9,전화회의/NNG,23,2.258708989505501,Hawkish
9,9, 은행/NNG;순이자마진/NNG;상승/NNG,18,1.4520272075392509,Hawkish
12,10, 패혈증/NNG,22,1.742432649047101,Hawkish
15,11, 자체브랜드/NNG,26,1.9800371011898874,Hawkish
13,13,지불/NNG,26,1.4520272075392509,Hawkish
11,11, 체감/NNG;경기/NNG;좋/VA;않/VX,22,1.4520272075392509,Hawkish
14,14,진흥원/NNG,28,1.4520272075392509,Hawkish
18,11, 국민운동/NNG,29,2.376044521427865,Hawkish
8,8, 대작/NNG,16,1.4520272075392506,Hawkish
9,8, 민간/NNG;소비/NNG;줄/VV,17,1.6335306084816572,Hawkish
11,7, 인상/NNG;가능성/NNG;없/VA,18,2.2817570404188228,Hawkish
27,28, 결제시장/NNG,55,1.4001690929842776,Hawkish
13,7, 고정자산/NNG;투자/NNG;늘/VV,20,2.6966219568586087,Hawkish
12,7, 고유동성/NNG;흡수/NNG,19,2.489189498638716,Hawkish
12,7, 조간신문/NNG,19,2.489189498638716,Hawkish
140,109,재할인율/NNG,249,1.8649890739036252,Hawkish
11,11, 법조인/NNG,22,1.4520272075392509,Hawkish
17,15, 영천/NNG,32,1.645630835211151,Hawkish
14,13, 달러원/NNG;밀리/VV,27,1.5637216081191931,Hawkish
9,9, 자금/NNG;빌리/VV;고금리/NNG,18,1.4520272075392509,Hawkish
12,11, 경제/NNG;성장률/NNG;플러스/NNG,23,1.58402968095191,Hawkish
11,6, 헤즈볼라/NNG,17,2.662049880488626,Hawkish
21,23, 전운/NNG,44,1.325763972101055,Hawkish
12,11, 금리/NNG;위험/NNG;줄/VV,23,1.58402968095191,Hawkish
13,8, 그닥/MAG,21,2.359544212251283,Hawkish
23,13, 인제/MAG,36,2.568971213338674,Hawkish
14,12, 홍천/NNG,26,1.6940317421291258,Hawkish
28,19,폭우/NNG,47,2.1398295690052116,Hawkish
18,10,보험감독/NNG,28,2.6136489735706516,Hawkish
9,9, 소비자/NNG;편익/NNG;증대/NNG,18,1.4520272075392509,Hawkish
11,10, 속살/NNG,21,1.5972299282931757,Hawkish
9,10,내건/VV,19,1.3068244867853258,Hawkish
11,7, gdp/NNG;성장률/NNG;예상/NNG;높/VA,18,2.2817570404188228,Hawkish
25,20, 쿨/NNG,45,1.8150340094240636,Hawkish
8,8, 캐쉬/NNG,16,1.4520272075392506,Hawkish
9,8, 자상/NNG,17,1.6335306084816572,Hawkish
20,22, 수산업자/NNG,42,1.3200247341265916,Hawkish
11,11, 수출/NNG;긍정적/VAX;영향/NNG;줄/VV,22,1.4520272075392509,Hawkish
16,13,달인/NNG,29,1.7871104092790777,Hawkish
21,23, 앞장설/VV,44,1.325763972101055,Hawkish
15,11, 인플레이션/NNG;기대/NNG;잡/VV,26,1.9800371011898874,Hawkish
9,8, 작통/NNG,17,1.6335306084816572,Hawkish
17,14, 수출/NNG;활력/NNG,31,1.7631758948690905,Hawkish
22,22,홍수/NNG,44,1.4520272075392509,Hawkish
8,8,색깔/NNG,16,1.4520272075392506,Hawkish
30,30,벤/NNG,60,1.4520272075392506,Hawkish
32,17, 외지인/NNG,49,2.7332276847797656,Hawkish
11,9,지갑/NNG,20,1.774699920325751,Hawkish
20,16, 경제/NNG;성장률/NNG;전망/NNG;높/VV,36,1.8150340094240636,Hawkish
8,8, 지준율/NNG;인상/NNG;위안/NNG;절상/NNG,16,1.4520272075392506,Hawkish
53,53,설정원본액/NNG,106,1.4520272075392509,Hawkish
9,10, 노동/NNG;줄/VV,19,1.3068244867853258,Hawkish
10,11, 신용/NNG;대출/NNG;금리/NNG;높/VA,21,1.3200247341265916,Hawkish
17,11, ecb/NNG;통화/NNG;긴축/NNG,28,2.244042048015206,Hawkish
10,7, 이데아/NNG,17,2.07432458219893,Hawkish
14,10, 고정/NNG;금리/NNG;대출/NNG;활성화/NNG,24,2.032838090554951,Hawkish
11,6, 멜/NNG,17,2.662049880488626,Hawkish
18,19,eb/NNG,37,1.375604722931922,Hawkish
15,8, gdp/NNG;예상/NNG;하회/NNG,23,2.722551014136095,Hawkish
9,7, 지표/NNG;우호적/VAX,16,1.866892123979037,Hawkish
17,15, 꾸린/VV,32,1.645630835211151,Hawkish
12,8, 기업/NNG;대출/NNG;금리/NNG;오르/VV,20,2.1780408113088763,Hawkish
12,5, 무역손실/NNG,17,3.484865298094202,Hawkish
12,9, 모르/NNG,21,1.9360362767190011,Hawkish
11,12, 숄/NNG,23,1.331024940244313,Hawkish
10,9, 이익/NNG;모멘텀/NNG;개선/NNG,19,1.6133635639325008,Hawkish
14,13, 걸으면서/VV,27,1.5637216081191931,Hawkish
18,10, 비저/NNG,28,2.6136489735706516,Hawkish
9,8,장기보유/NNG,17,1.6335306084816572,Hawkish
9,8,당과/NNG,17,1.6335306084816572,Hawkish
14,10, 자본/NNG;제한/NNG,24,2.032838090554951,Hawkish
9,7, 시외/NNG,16,1.866892123979037,Hawkish
20,21, 근로기준법/NNG,41,1.3828830547992865,Hawkish
9,7,보유현금/NNG,16,1.866892123979037,Hawkish
10,7, 버림/VV,17,2.07432458219893,Hawkish
13,13, 수익/NNG;타격/NNG,26,1.4520272075392509,Hawkish
52,27, 근원/NNG;pce/NNG;물가/NNG;상승/NNG,79,2.7964968441496683,Hawkish
11,11, 산정기/NNG,22,1.4520272075392509,Hawkish
11,8, 피해/NNG;늘/VV,19,1.9965374103664697,Hawkish
14,7,열대성/NNG,21,2.9040544150785017,Hawkish
19,7,표명/NNG,26,3.941216706177967,Hawkish
14,5, 재무계획/NNG,19,4.065676181109902,Hawkish
17,17, 地/NNG,34,1.4520272075392509,Hawkish
11,8,준비은행/NNG,19,1.9965374103664697,Hawkish
9,9, rbc비율/NNG;상승/NNG,18,1.4520272075392509,Hawkish
10,8, 신흥시장/NNG;금융/NNG;불안/NNG,18,1.8150340094240636,Hawkish
11,7, 경제/NNG;통제/NNG,18,2.2817570404188228,Hawkish
9,10, 접속자/NNG,19,1.3068244867853258,Hawkish
11,10, 내수/NNG;회복/NNG;둔화/NNG,21,1.5972299282931757,Hawkish
10,11, 소매/NNG;업체/NNG;실적/NNG;부진/NNG,21,1.3200247341265916,Hawkish
19,10, 영속/NNG,29,2.7588516943245764,Hawkish
10,10, 인플레이션/NNG;지표/NNG;상승/NNG,20,1.4520272075392509,Hawkish
11,10, 지급준비일/NNG,21,1.5972299282931757,Hawkish
20,16, 수확기/NNG,36,1.8150340094240636,Hawkish
15,14,객실/NNG,29,1.5557434366491973,Hawkish
25,11, 한자/NNG,36,3.3000618353164795,Hawkish
10,11, 투자/NNG;오르/VV,21,1.3200247341265916,Hawkish
12,8, 두드린다/VV,20,2.1780408113088763,Hawkish
13,6, 법무관/NNG,19,3.1460589496683764,Hawkish
16,9, 주택/NNG;지표/NNG;악화/NNG,25,2.5813817022920014,Hawkish
8,8,탁월/NNG,16,1.4520272075392506,Hawkish
28,30, 단기물/NNG;내리/VV,58,1.3552253937033008,Hawkish
24,23,플래트닝/NNG,47,1.5151588252583488,Hawkish
20,17, 지켜왔/VV,37,1.7082673029873539,Hawkish
26,20, 공개경쟁/NNG,46,1.887635369801026,Hawkish
11,8, 외롭/VA,19,1.9965374103664697,Hawkish
9,10, 예상/NNG;많이/MAG;증가/NNG,19,1.3068244867853258,Hawkish
8,8, 하락/NNG;원화/NNG;약세/NNG,16,1.4520272075392506,Hawkish
20,17, 명태/NNG,37,1.7082673029873539,Hawkish
23,17, 도맡/VV,40,1.9645073984354566,Hawkish
21,10, 주택담보대출/NNG;스프레드/NNG;인상/NNG,31,3.0492571358324265,Hawkish
18,17,그래서인지/VA,35,1.5374405726886184,Hawkish
14,6, 경기/NNG;내리/VV,20,3.3880634842582515,Hawkish
11,8, 총상/NNG,19,1.9965374103664697,Hawkish
16,9, 사격장/NNG,25,2.5813817022920014,Hawkish
11,8, 순이자마진/NNG;긍정적/VAX,19,1.9965374103664697,Hawkish
10,7, 어깨동무/NNG,17,2.07432458219893,Hawkish
10,9, 소비자/NNG;물가/NNG;상승률/NNG;예상/NNG;낮/VA,19,1.6133635639325008,Hawkish
11,7, 주택시장/NNG;최악/NNG,18,2.2817570404188228,Hawkish
12,4, 직장폐쇄/NNG,16,4.356081622617753,Hawkish
17,17,코퍼레이션/NNG,34,1.4520272075392509,Hawkish
10,8, 경기/NNG;둔화/NNG;우려/NNG;약세/NNG,18,1.8150340094240636,Hawkish
12,10, 옐로/NNG,22,1.742432649047101,Hawkish
70,76, 주주환원정책/NNG,146,1.3373934806282575,Hawkish
10,10, 예상/NNG;소폭/MAG;넘/VV,20,1.4520272075392509,Hawkish
27,3, 독서/NNG,30,13.068244867853256,Hawkish
11,6, 재정정책/NNG;금리/NNG;인상/NNG,17,2.662049880488626,Hawkish
22,12,송유관/NNG,34,2.662049880488626,Hawkish
17,10,종교/NNG,27,2.4684462528167264,Hawkish
10,6, 순이익/NNG;예상/NNG;넘/VV,16,2.420045345898751,Hawkish
9,9, 체감/NNG;경기/NNG;최저/NNG,18,1.4520272075392509,Hawkish
9,7, 역외/NNG;매수/NNG;강하/VA,16,1.866892123979037,Hawkish
30,31, 수출/NNG;주가/NNG;강세/NNG,61,1.405187620199275,Hawkish
13,14, 기대/NNG;견조/NNG,27,1.3483109784293044,Hawkish
12,4, 개나리/NNG,16,4.356081622617753,Hawkish
12,11, 제안가격/NNG,23,1.58402968095191,Hawkish
8,8, 고이/VV,16,1.4520272075392506,Hawkish
27,28, 수익자/NNG,55,1.4001690929842776,Hawkish
17,10, 감응/NNG,27,2.4684462528167264,Hawkish
19,21, 급식비/NNG,40,1.3137389020593222,Hawkish
16,14,시장조성/NNG,30,1.6594596657591438,Hawkish
12,9, 금리/NNG;인상/NNG;타격/NNG,21,1.9360362767190011,Hawkish
25,27, 현지화/NNG,52,1.3444696366104174,Hawkish
15,12,학년도/NNG,27,1.8150340094240633,Hawkish
10,10, 양호/NNG;실적/NNG;오르/VV,20,1.4520272075392509,Hawkish
12,9,陳/NNG,21,1.9360362767190011,Hawkish
8,8, 각성/NNG,16,1.4520272075392506,Hawkish
8,8, 실업률/NNG;줄/VV,16,1.4520272075392506,Hawkish
10,10, 거시정책/NNG;안정/NNG,20,1.4520272075392509,Hawkish
9,9, 이자율/NNG;최저/NNG,18,1.4520272075392509,Hawkish
10,10, 심각/NNG;부담/NNG,20,1.4520272075392509,Hawkish
25,5, 쿠키/NNG,30,7.260136037696254,Hawkish
17,17,모로/NNG,34,1.4520272075392509,Hawkish
10,6, 파리/VV,16,2.420045345898751,Hawkish
9,8,나주/NNG,17,1.6335306084816572,Hawkish
14,10, 원두/NNG,24,2.032838090554951,Hawkish
28,31, 무력시위/NNG,59,1.3115084455193233,Hawkish
16,14, 휴먼/NNG,30,1.6594596657591438,Hawkish
10,11, 경제/NNG;우려/NNG;확산/NNG,21,1.3200247341265916,Hawkish
13,5, 세계/NNG;경제/NNG;경기/NNG;둔화/NNG,18,3.775270739602052,Hawkish
13,8, 던져준/VV,21,2.359544212251283,Hawkish
9,7, 이자율/NNG;최대/NNG,16,1.866892123979037,Hawkish
11,8, 요양병원/NNG,19,1.9965374103664697,Hawkish
8,8, 제어장치/NNG,16,1.4520272075392506,Hawkish
12,12, 구조적/VAX;둔화/NNG,24,1.4520272075392509,Hawkish
53,52, 석간/NNG,105,1.4799508076842365,Hawkish
12,13,봐서/VV,25,1.3403328069593086,Hawkish
10,9, 세워서/VV,19,1.6133635639325008,Hawkish
13,10,국군/NNG,23,1.887635369801026,Hawkish
20,20, 로그인/NNG,40,1.4520272075392509,Hawkish
16,5, 다카/NNG,21,4.646487064125602,Hawkish
14,8, 연차휴가/NNG,22,2.541047613193689,Hawkish
14,4, 매장/NNG;매출/NNG;증가/NNG,18,5.082095226387378,Hawkish
16,15, 건설/NNG;지출/NNG;줄/VV,31,1.5488290213752007,Hawkish
17,12,장수/NNG,29,2.0570385440139387,Hawkish
13,10,신시가지/NNG,23,1.887635369801026,Hawkish
10,9, 소비자/NNG;피해/NNG;우려/NNG,19,1.6133635639325008,Hawkish
10,9, 현진/NNG,19,1.6133635639325008,Hawkish
13,11, 악덕/NNG,24,1.7160321543645694,Hawkish
10,11,교통사고/NNG,21,1.3200247341265916,Hawkish
12,7, 상한/NNG;금리/NNG;인하/NNG,19,2.489189498638716,Hawkish
14,14, 스팟시장/NNG,28,1.4520272075392509,Hawkish
13,12, 오크/NNG,25,1.5730294748341882,Hawkish
12,12,무위험/NNG,24,1.4520272075392509,Hawkish
14,11, 전용주택/NNG,25,1.8480346277772284,Hawkish
17,7, 물가/NNG;지표/NNG;둔화/NNG,24,3.526351789738181,Hawkish
29,31, 환경/NNG;좋/VA;않/VX,60,1.3583480328592992,Hawkish
11,12, 세계/NNG;경제/NNG;흔들/VV,23,1.331024940244313,Hawkish
11,12,태양/NNG,23,1.331024940244313,Hawkish
10,7,건실/NNG,17,2.07432458219893,Hawkish
9,10, 인플레이션/NNG;우려/NNG;하락/NNG,19,1.3068244867853258,Hawkish
26,27,스트레티지스트/NNG,53,1.3982484220748341,Hawkish
8,8, 전달식/NNG,16,1.4520272075392506,Hawkish
13,12, 물가/NNG;상승/NNG;부작용/NNG,25,1.5730294748341882,Hawkish
62,68, 롱스톱/NNG,130,1.3239071598151992,Hawkish
12,12, 안정/NNG;노력/NNG;강화/NNG,24,1.4520272075392509,Hawkish
20,20, 금융시장/NNG;악영향/NNG,40,1.4520272075392509,Hawkish
17,16, 주택시장/NNG;우려/NNG,33,1.5427789080104541,Hawkish
28,10,성명문/NNG,38,4.065676181109902,Hawkish
19,18, 발열/NNG,37,1.5326953857358758,Hawkish
14,11, 살인범/NNG,25,1.8480346277772284,Hawkish
13,8, 名品/NNG,21,2.359544212251283,Hawkish
16,6, 경비함/NNG,22,3.8720725534380014,Hawkish
16,8, fed/NNG;금리/NNG;인하/NNG;가능성/NNG;높/VV,24,2.9040544150785013,Hawkish
8,8, 적자/NNG;해소/NNG,16,1.4520272075392506,Hawkish
29,27, 연체율/NNG;오르/VV,56,1.559584778468084,Hawkish
10,11, 주택난/NNG,21,1.3200247341265916,Hawkish
13,11, 알찬/VA,24,1.7160321543645694,Hawkish
43,31, 제회/NNG,74,2.014102255618961,Hawkish
13,13,무력/NNG,26,1.4520272075392509,Hawkish
11,12, 유가/NNG;원자재/NNG;상승/NNG,23,1.331024940244313,Hawkish
11,5, 기업/NNG;불확실성/NNG,16,3.1944598565863513,Hawkish
18,12, 장기물/NNG;늘/VV,30,2.1780408113088763,Hawkish
14,6, fed/NNG;주택/NNG;경기/NNG;침체/NNG,20,3.3880634842582515,Hawkish
15,12,너스/NNG,27,1.8150340094240633,Hawkish
21,14,오미/NNG,35,2.1780408113088763,Hawkish
12,13, 선양/NNG,25,1.3403328069593086,Hawkish
21,12, 산사태/NNG,33,2.5410476131936885,Hawkish
9,7, 디펜스/NNG,16,1.866892123979037,Hawkish
17,18, 慧/NNG,35,1.3713590293426259,Hawkish
16,7,수학/NNG,23,3.3189193315182877,Hawkish
12,8,세무사/NNG,20,2.1780408113088763,Hawkish
12,8,중학교/NNG,20,2.1780408113088763,Hawkish
11,9,징후/NNG,20,1.774699920325751,Hawkish
11,7, 아비트리지/NNG,18,2.2817570404188228,Hawkish
10,8,국가재정운용계획/NNG,18,1.8150340094240636,Hawkish
13,8, 레드칩/NNG,21,2.359544212251283,Hawkish
9,10,아프/VA,19,1.3068244867853258,Hawkish
15,14, 돌아간다고/VV,29,1.5557434366491973,Hawkish
9,8,대부업시장/NNG,17,1.6335306084816572,Hawkish
10,9, fed/NNG;금리/NNG;인하/NNG;가능성/NNG;낮/VV,19,1.6133635639325008,Hawkish
8,8, 부도/NNG;늘/VV,16,1.4520272075392506,Hawkish
9,9, 금리/NNG;인하/NNG;서둘/VV;않/VX,18,1.4520272075392509,Hawkish
12,5, 통화/NNG;잡/VV,17,3.484865298094202,Hawkish
69,67, 역도/NNG,136,1.4953713032866913,Hawkish
9,9, 달리/MAG;물가/NNG;상승/NNG,18,1.4520272075392509,Hawkish
41,45,국유기업/NNG,86,1.3229581224246507,Hawkish
10,7, 과대광고/NNG,17,2.07432458219893,Hawkish
12,13, 俊/NNG,25,1.3403328069593086,Hawkish
42,25, 방사성/NNG,67,2.4394057086659413,Hawkish
26,16, 오미/NNG,42,2.359544212251283,Hawkish
16,11, 대출/NNG;통제/NNG,27,2.1120395746025467,Hawkish
9,7, 모기지/NNG;신청/NNG;늘/VV,16,1.866892123979037,Hawkish
35,12,팔라듐/NNG,47,4.2350793553228145,Hawkish
18,11, 단기/NNG;금리/NNG;낮/VV,29,2.376044521427865,Hawkish
9,9,사령관/NNG,18,1.4520272075392509,Hawkish
11,8, 예상밖/NNG;위축/NNG,19,1.9965374103664697,Hawkish
23,20, 부채/NNG;상환/NNG;부담/NNG;크/VV,43,1.6698312886701383,Hawkish
14,11, fed/NNG;금리/NNG;ff/NNG;금리/NNG;인상/NNG,25,1.8480346277772284,Hawkish
19,7,자문사/NNG,26,3.941216706177967,Hawkish
17,12,기해/VV,29,2.0570385440139387,Hawkish
9,7, 거시/NNG;건전성/NNG;감독/NNG;강화/NNG,16,1.866892123979037,Hawkish
19,9, 최선책/NNG,28,3.0653907714717517,Hawkish
12,12, 탁사/NNG,24,1.4520272075392509,Hawkish
36,34, 압수/NNG,70,1.5374405726886184,Hawkish
25,11, 무사고/NNG,36,3.3000618353164795,Hawkish
9,8, 마일/NNG,17,1.6335306084816572,Hawkish
12,7,오산/NNG,19,2.489189498638716,Hawkish
15,14, 챈/VV,29,1.5557434366491973,Hawkish
14,9, 총부채/NNG;상환/NNG;비율/NNG;확대/NNG,23,2.258708989505501,Hawkish
15,16, 야/NNG,31,1.3612755070680476,Hawkish
12,12, rp/NNG;금리/NNG;인상/NNG,24,1.4520272075392509,Hawkish
9,7,과일/NNG,16,1.866892123979037,Hawkish
11,9,재향/NNG,20,1.774699920325751,Hawkish
30,30, 높/VA;비판/NNG,60,1.4520272075392506,Hawkish
9,10,평년/NNG,19,1.3068244867853258,Hawkish
18,13, 태강/NNG,31,2.010499210438963,Hawkish
12,9,공언/NNG,21,1.9360362767190011,Hawkish
12,13, 沈/NNG,25,1.3403328069593086,Hawkish
62,45, 지복/NNG,107,2.000570819276301,Hawkish
11,11, 재창/NNG,22,1.4520272075392509,Hawkish
12,11, 정할지/VV,23,1.58402968095191,Hawkish
21,18,랩어카운트/NNG,39,1.6940317421291258,Hawkish
10,9, 더디/VA;경제/NNG;성장/NNG,19,1.6133635639325008,Hawkish
9,9, 글로벌/NNG;경제/NNG;안정/NNG,18,1.4520272075392509,Hawkish
8,8, 식탐/NNG,16,1.4520272075392506,Hawkish
12,13, 금융시스템/NNG;위협/NNG,25,1.3403328069593086,Hawkish
11,9, 후행/NNG;지수/NNG;오르/VV,20,1.774699920325751,Hawkish
12,11, 저점/NNG;매수/NNG;고점/NNG,23,1.58402968095191,Hawkish
18,12, 근로자재산형성/NNG,30,2.1780408113088763,Hawkish
20,20, 부지사/NNG,40,1.4520272075392509,Hawkish
20,21, 끊겨/VV,41,1.3828830547992865,Hawkish
16,9, 야성/NNG,25,2.5813817022920014,Hawkish
10,11,관내/NNG,21,1.3200247341265916,Hawkish
9,8, 아나운서/NNG,17,1.6335306084816572,Hawkish
16,7,감당/NNG,23,3.3189193315182877,Hawkish
11,12, 모레/MAG,23,1.331024940244313,Hawkish
16,6, 공병/NNG,22,3.8720725534380014,Hawkish
18,17,매매계약/NNG,35,1.5374405726886184,Hawkish
12,13, 가격/NNG;상승/NNG;멈추/VV,25,1.3403328069593086,Hawkish
21,17, 키포인트/NNG,38,1.7936806681367214,Hawkish
27,18,여소/NNG,45,2.1780408113088763,Hawkish
23,24, 과속/NNG,47,1.3915260738917818,Hawkish
15,14, 물가/NNG;부진/NNG;금리/NNG;인상/NNG,29,1.5557434366491973,Hawkish
12,10, 주택/NNG;건설/NNG;부진/NNG,22,1.742432649047101,Hawkish
13,12, fed/NNG;금리/NNG;인하/NNG;가능성/NNG;높/VA,25,1.5730294748341882,Hawkish
15,16, 불안/NNG;살/VV,31,1.3612755070680476,Hawkish
11,10, 셔터/NNG,21,1.5972299282931757,Hawkish
9,10,예금자보호법/NNG,19,1.3068244867853258,Hawkish
9,10, 협찬/NNG,19,1.3068244867853258,Hawkish
11,5, 스왑션/NNG,16,3.1944598565863513,Hawkish
8,8, 세계/NNG;수요/NNG;둔화/NNG,16,1.4520272075392506,Hawkish
10,11, 하락/NNG;채권/NNG;금리/NNG;상승/NNG,21,1.3200247341265916,Hawkish
13,8, 평안/NNG,21,2.359544212251283,Hawkish
21,5, 경제/NNG;직면/NNG;위험/NNG,26,6.098514271664853,Hawkish
10,11, 외화예금/NNG;지준율/NNG;인상/NNG,21,1.3200247341265916,Hawkish
12,7, 삼각주/NNG,19,2.489189498638716,Hawkish
13,14, 금리/NNG;상승/NNG;영향/NNG;약세/NNG,27,1.3483109784293044,Hawkish
9,7, 대출/NNG;증가율/NNG;높/VA,16,1.866892123979037,Hawkish
15,10, 자유형/NNG,25,2.178040811308876,Hawkish
26,27, 조문/NNG,53,1.3982484220748341,Hawkish
21,18, 이적/NNG,39,1.6940317421291258,Hawkish
15,13, 조성물/NNG,28,1.6754160086991354,Hawkish
18,17,자원부국/NNG,35,1.5374405726886184,Hawkish
20,17,평가단/NNG,37,1.7082673029873539,Hawkish
10,11, 대손충당금/NNG;적립/NNG;상향/NNG,21,1.3200247341265916,Hawkish
18,16, 剛/NNG,34,1.6335306084816572,Hawkish
19,21, 구타/NNG,40,1.3137389020593222,Hawkish
12,7, 인건비/NNG;인상/NNG,19,2.489189498638716,Hawkish
18,15, 배상액/NNG,33,1.742432649047101,Hawkish
15,11, 스킨/NNG,26,1.9800371011898874,Hawkish
16,13, 카타/NNG,29,1.7871104092790777,Hawkish
8,8,중장비/NNG,16,1.4520272075392506,Hawkish
13,13, 장산/NNG,26,1.4520272075392509,Hawkish
12,9,소비시장/NNG,21,1.9360362767190011,Hawkish
10,9,펀드설정액/NNG,19,1.6133635639325008,Hawkish
70,37, 권운/NNG,107,2.747078500749934,Hawkish
9,7, 대출/NNG;이자/NNG;늘/VV,16,1.866892123979037,Hawkish
9,10, 조직폭력배/NNG,19,1.3068244867853258,Hawkish
10,11, 의경/NNG,21,1.3200247341265916,Hawkish
35,6, 영결식/NNG,41,8.470158710645629,Hawkish
15,14, 나포/NNG,29,1.5557434366491973,Hawkish
14,15, 습격/NNG,29,1.3552253937033008,Hawkish
14,10, 서기관/NNG,24,2.032838090554951,Hawkish
17,12, 여동생/NNG,29,2.0570385440139387,Hawkish
10,10, 향년/NNG,20,1.4520272075392509,Hawkish
12,10, 담임/NNG,22,1.742432649047101,Hawkish
13,9, 해적/NNG,22,2.097372633112251,Hawkish
15,6,국어/NNG,21,3.6300680188481267,Hawkish
9,9, 전군/NNG,18,1.4520272075392509,Hawkish
37,39,재정거래/NNG,76,1.3775642738192893,Hawkish
16,12, 흡수/NNG;효과/NNG,28,1.9360362767190007,Hawkish
9,9, 금융상품/NNG;위험/NNG,18,1.4520272075392509,Hawkish
10,11, 끼/NNG,21,1.3200247341265916,Hawkish
23,19, 여래/NNG,42,1.7577171459685668,Hawkish
14,10, 선진화/NNG,24,2.032838090554951,Hawkish
30,31, 전망/NNG;소폭/MAG;상승/NNG,61,1.405187620199275,Hawkish
11,7, 텝/NNG,18,2.2817570404188228,Hawkish
12,5, 자수성가/NNG,17,3.484865298094202,Hawkish
8,8, 집주인/NNG;전세가격/NNG;오르/VV,16,1.4520272075392506,Hawkish
8,8,이기/VV,16,1.4520272075392506,Hawkish
18,14, 회식/NNG,32,1.866892123979037,Hawkish
154,92,권운/NNG,246,2.4305672821852675,Hawkish
8,8, 경제/NNG;적잖/VA,16,1.4520272075392506,Hawkish
23,6, 주택건설자금/NNG,29,5.566104295567127,Hawkish
13,4, 휴면보험금/NNG,17,4.719088424502566,Hawkish
21,12, 은행/NNG;지준율/NNG;오르/VV,33,2.5410476131936885,Hawkish
22,24, 승합차/NNG,46,1.331024940244313,Hawkish
17,18, 대출/NNG;스프레드/NNG;인상/NNG,35,1.3713590293426259,Hawkish
9,8, 주택/NNG;지표/NNG;좋/VA,17,1.6335306084816572,Hawkish
13,11,역성장/NNG,24,1.7160321543645694,Hawkish
31,17, 희망찬/VA,48,2.6478143196303985,Hawkish
16,17, 봤었/VV,33,1.3666138423898828,Hawkish
9,7, 데이론/NNG,16,1.866892123979037,Hawkish
13,13, 높/VA;성과/NNG;오르/VV,26,1.4520272075392509,Hawkish
17,6, 델타헤지/NNG,23,4.114077088027877,Hawkish
9,8,못지않/VA,17,1.6335306084816572,Hawkish
10,6,에탄올/NNG,16,2.420045345898751,Hawkish
9,10,음성/NNG,19,1.3068244867853258,Hawkish
14,7, 삼계탕/NNG,21,2.9040544150785017,Hawkish
14,6, 총부채/NNG;상환/NNG;비율/NNG;규제/NNG;확대/NNG,20,3.3880634842582515,Hawkish
11,6, 달러엔/NNG;약세/NNG,17,2.662049880488626,Hawkish
11,7, 쫓겨나/VV,18,2.2817570404188228,Hawkish
8,8, 주택/NNG;판매/NNG;상승/NNG,16,1.4520272075392506,Hawkish
33,33,보베스파/NNG,66,1.4520272075392506,Hawkish
19,16, 모기지/NNG;고정/NNG;금리/NNG;오르/VV,35,1.7242823089528605,Hawkish
15,15, 환경/NNG;위축/NNG,30,1.4520272075392506,Hawkish
10,10,담보물/NNG,20,1.4520272075392509,Hawkish
11,8, 둔화/NNG;환율/NNG;하락/NNG,19,1.9965374103664697,Hawkish
14,5, 기필코/MAG,19,4.065676181109902,Hawkish
13,9,개인택시/NNG,22,2.097372633112251,Hawkish
15,15, 지표/NNG;위험/NNG,30,1.4520272075392506,Hawkish
10,6, 급작스레/MAG,16,2.420045345898751,Hawkish
13,13, 로라/NNG,26,1.4520272075392509,Hawkish
47,43, 상호금융회사/NNG,90,1.5870995059149948,Hawkish
9,7, 비판/NNG;끊이/VV;않/VX,16,1.866892123979037,Hawkish
21,19, 방통/NNG,40,1.604872176753909,Hawkish
13,14, 가계/NNG;대출/NNG;관리/NNG;강화/NNG,27,1.3483109784293044,Hawkish
18,19, 대출/NNG;규제/NNG;강화/NNG;금리/NNG;인상/NNG,37,1.375604722931922,Hawkish
8,8, 연체율/NNG;늘/VV,16,1.4520272075392506,Hawkish
15,13, 찾아낼/VV,28,1.6754160086991354,Hawkish
11,11, 초년병/NNG,22,1.4520272075392509,Hawkish
22,23,콜차입/NNG,45,1.388895589820153,Hawkish
11,7, 지준율/NNG;높/VA,18,2.2817570404188228,Hawkish
10,11, 한모/NNG,21,1.3200247341265916,Hawkish
18,7, 어류/NNG,25,3.733784247958074,Hawkish
8,8,리퍼/NNG,16,1.4520272075392506,Hawkish
12,5, 최우선변제/NNG,17,3.484865298094202,Hawkish
10,10, 막혀서/VV,20,1.4520272075392509,Hawkish
10,9, 금융시장/NNG;인상/NNG,19,1.6133635639325008,Hawkish
14,4, 대란설/NNG,18,5.082095226387378,Hawkish
10,8, 금융시장/NNG;예상/NNG;깨/VV,18,1.8150340094240636,Hawkish
15,9, 경제/NNG;지표/NNG;기업/NNG;실적/NNG;호조/NNG,24,2.420045345898751,Hawkish
48,23, 지준율/NNG;금리/NNG;인상/NNG,71,3.0303176505166975,Hawkish
12,12, 침체/NNG;탈출/NNG,24,1.4520272075392509,Hawkish
10,7, 불안/NNG;사라지/VV;않/VX,17,2.07432458219893,Hawkish
29,26, 범여/NNG,55,1.6195688084091644,Hawkish
36,30,선출/NNG,66,1.742432649047101,Hawkish
20,17, 과세특례/NNG,37,1.7082673029873539,Hawkish
16,14, 경제/NNG;침체/NNG;위험/NNG,30,1.6594596657591438,Hawkish
11,7, 고사성어/NNG,18,2.2817570404188228,Hawkish
12,12, 산업/NNG;생산/NNG;예상/NNG;웃돌/VV,24,1.4520272075392509,Hawkish
20,18, 청구서/NNG,38,1.6133635639325008,Hawkish
20,20, 위부/NNG,40,1.4520272075392509,Hawkish
42,25, 석면/NNG,67,2.4394057086659413,Hawkish
33,26, 성희롱/NNG,59,1.842957609569049,Hawkish
13,9, 험악/NNG,22,2.097372633112251,Hawkish
9,8, 본명/NNG,17,1.6335306084816572,Hawkish
9,9, 실수요/NNG;많/VA;않/VX,18,1.4520272075392509,Hawkish
9,8, 상수원/NNG,17,1.6335306084816572,Hawkish
10,9, 캐리/NNG;자금/NNG;청산/NNG;우려/NNG,19,1.6133635639325008,Hawkish
21,21,밍/NNG,42,1.4520272075392509,Hawkish
23,16, 경기/NNG;나쁘/VA;않/VX,39,2.087289110837673,Hawkish
9,9,설날/NNG,18,1.4520272075392509,Hawkish
16,10, 상환가격/NNG,26,2.323243532062801,Hawkish
11,8, 세교/NNG,19,1.9965374103664697,Hawkish
26,26,갑작/NNG,52,1.4520272075392509,Hawkish
9,8, 통안채/NNG;보합/NNG;하락/NNG,17,1.6335306084816572,Hawkish
24,12,규제안/NNG,36,2.9040544150785017,Hawkish
8,8, 비축용임대주택/NNG,16,1.4520272075392506,Hawkish
31,20, gdp/NNG;개선/NNG,51,2.250642171685839,Hawkish
10,10,캠프/NNG,20,1.4520272075392509,Hawkish
9,7, 인플레이션/NNG;넘/VV;않/VX,16,1.866892123979037,Hawkish
8,8,측정/NNG,16,1.4520272075392506,Hawkish
9,9, 경제/NNG;안정/NNG;회복/NNG,18,1.4520272075392509,Hawkish
20,22, 현호/NNG,42,1.3200247341265916,Hawkish
13,14, 신용/NNG;부실/NNG,27,1.3483109784293044,Hawkish
14,12, 인턴십/NNG,26,1.6940317421291258,Hawkish
37,28, 깜짝/MAG;금리/NNG;인상/NNG,65,1.9187502385340103,Hawkish
9,10, 연관효과/NNG,19,1.3068244867853258,Hawkish
12,13,태생/NNG,25,1.3403328069593086,Hawkish
12,12, ecb/NNG;경제/NNG;성장/NNG,24,1.4520272075392509,Hawkish
10,9, 물가/NNG;안정/NNG;목표/NNG;넘/VV,19,1.6133635639325008,Hawkish
8,8, 리셋/NNG,16,1.4520272075392506,Hawkish
47,20, 불능화/NNG,67,3.412263937717239,Hawkish
9,8, 빌레/NNG,17,1.6335306084816572,Hawkish
20,16,구균/NNG,36,1.8150340094240636,Hawkish
41,23, 혈청형/NNG,64,2.588396326483012,Hawkish
10,8, 중이염/NNG,18,1.8150340094240636,Hawkish
10,8,틱증/NNG,18,1.8150340094240636,Hawkish
27,29,이강/NNG,56,1.3518874001227508,Hawkish
20,20, 판매/NNG;성장/NNG,40,1.4520272075392509,Hawkish
9,7, 귀성객/NNG,16,1.866892123979037,Hawkish
12,8, 종군/NNG,20,2.1780408113088763,Hawkish
10,7, 만행/NNG,17,2.07432458219893,Hawkish
27,29, 흉기/NNG,56,1.3518874001227508,Hawkish
9,9,맏형/NNG,18,1.4520272075392509,Hawkish
20,14, 귀경/NNG,34,2.07432458219893,Hawkish
9,9, 소송/NNG;위험/NNG,18,1.4520272075392509,Hawkish
10,6,다수결/NNG,16,2.420045345898751,Hawkish
54,59, 선거비용/NNG,113,1.3289740543579585,Hawkish
13,13, 죄질/NNG,26,1.4520272075392509,Hawkish
8,8, 탄두/NNG,16,1.4520272075392506,Hawkish
10,10, 경기/NNG;기업/NNG;실적/NNG;개선/NNG,20,1.4520272075392509,Hawkish
20,12, 총사퇴/NNG,32,2.420045345898751,Hawkish
16,11,대안투자/NNG,27,2.1120395746025467,Hawkish
12,8, 쓰레기봉투/NNG,20,2.1780408113088763,Hawkish
15,15,의제/NNG,30,1.4520272075392506,Hawkish
12,12, 소재부품/NNG,24,1.4520272075392509,Hawkish
20,20, 서브프라임/NNG;악재/NNG,40,1.4520272075392509,Hawkish
20,17,법원경매/NNG,37,1.7082673029873539,Hawkish
16,15, 경제/NNG;지표/NNG;성장/NNG,31,1.5488290213752007,Hawkish
12,9, 담보금/NNG,21,1.9360362767190011,Hawkish
10,10, 자서전/NNG,20,1.4520272075392509,Hawkish
35,38,컨트리/NNG,73,1.3373934806282575,Hawkish
181,189,서브프라임사태/NNG,370,1.3905657384370602,Hawkish
9,9, 금융시장/NNG;받/VV;충격/NNG,18,1.4520272075392509,Hawkish
27,7, 서브프라임/NNG;위험/NNG,34,5.60067637193711,Hawkish
28,30,기준선/NNG,58,1.3552253937033008,Hawkish
10,6, 호전/NNG;과열/NNG,16,2.420045345898751,Hawkish
13,12, fed/NNG;경제/NNG;침체/NNG,25,1.5730294748341882,Hawkish
286,315,영효/NNG,601,1.3183485122419865,Hawkish
9,10, 경제/NNG;지표/NNG;부진/NNG;악재/NNG,19,1.3068244867853258,Hawkish
10,10, 차등화/NNG,20,1.4520272075392509,Hawkish
10,7, 成/NNG,17,2.07432458219893,Hawkish
11,8, 성장/NNG;방해/NNG,19,1.9965374103664697,Hawkish
18,12, 주택차압/NNG;증가/NNG,30,2.1780408113088763,Hawkish
11,11, 범죄인/NNG,22,1.4520272075392509,Hawkish
11,9, fed/NNG;서브프라임/NNG;부실/NNG,20,1.774699920325751,Hawkish
24,23, 임발/NNG,47,1.5151588252583488,Hawkish
148,146, 서브프라임/NNG;비우량/NNG;주택담보대출/NNG;부실/NNG,294,1.4719179912041722,Hawkish
11,8, 크레디티드/NNG,19,1.9965374103664697,Hawkish
15,14, fed/NNG;ff/NNG;금리/NNG;인하/NNG,29,1.5557434366491973,Hawkish
21,9, 미국발/NNG;서브프라임/NNG;부실/NNG,30,3.3880634842582515,Hawkish
12,8,내재가치/NNG,20,2.1780408113088763,Hawkish
39,37, 서브프라임/NNG;충격/NNG,76,1.5305151647035347,Hawkish
208,52,대지진/NNG,260,5.808108830157003,Hawkish
11,11, 병비/NNG,22,1.4520272075392509,Hawkish
14,13, 유색/NNG,27,1.5637216081191931,Hawkish
9,8, 유동성/NNG;과잉/NNG;우려/NNG,17,1.6335306084816572,Hawkish
46,41, 식료품/NNG;가격/NNG;급등/NNG,87,1.6291036962635497,Hawkish
54,60,청/NNG,114,1.3068244867853256,Hawkish
9,9, 호언/NNG,18,1.4520272075392509,Hawkish
18,18, 하방/NNG;지지/NNG,36,1.4520272075392509,Hawkish
22,15, 그린스펀풋/NNG,37,2.129639904390901,Hawkish
17,11, 버냉키풋/NNG,28,2.244042048015206,Hawkish
12,12, 긴축/NNG;불안/NNG,24,1.4520272075392509,Hawkish
22,16,운동/NNG,38,1.9965374103664697,Hawkish
16,1, 발기인/NNG,17,23.23243532062801,Hawkish
9,7, 파지/NNG,16,1.866892123979037,Hawkish
11,9, 주택/NNG;거래/NNG;침체/NNG,20,1.774699920325751,Hawkish
16,17, 강소/NNG,33,1.3666138423898828,Hawkish
9,7, 승화/NNG,16,1.866892123979037,Hawkish
109,104, 접종/NNG,213,1.5218362079017147,Hawkish
13,11, 구토/NNG,24,1.7160321543645694,Hawkish
9,7,핀/NNG,16,1.866892123979037,Hawkish
11,7, 투자/NNG;환경/NNG;악화/NNG,18,2.2817570404188228,Hawkish
12,8, 물가/NNG;상승률/NNG;넘/VV;않/VX,20,2.1780408113088763,Hawkish
13,13, 약하/VA;하락/NNG,26,1.4520272075392509,Hawkish
12,12,퉁/MAG,24,1.4520272075392509,Hawkish
12,6, 꼬마/NNG,18,2.9040544150785017,Hawkish
9,8, 順/NNG,17,1.6335306084816572,Hawkish
18,14, 경작지/NNG,32,1.866892123979037,Hawkish
8,8, 지표/NNG;깜짝/MAG;호조/NNG,16,1.4520272075392506,Hawkish
11,5, fed/NNG;인플레이션/NNG;방어/NNG,16,3.1944598565863513,Hawkish
35,24, 프록시/NNG,59,2.1175396776614073,Hawkish
11,8,트림/NNG,19,1.9965374103664697,Hawkish
24,13, 지급기/NNG,37,2.680665613918617,Hawkish
15,14, 수출항/NNG,29,1.5557434366491973,Hawkish
8,8, 기준원유/NNG,16,1.4520272075392506,Hawkish
12,12, 장례식장/NNG,24,1.4520272075392509,Hawkish
21,23, 귀어/NNG,44,1.325763972101055,Hawkish
11,5, 단기/NNG;외화차입/NNG;급증/NNG,16,3.1944598565863513,Hawkish
11,10, 금융부채/NNG;늘/VV,21,1.5972299282931757,Hawkish
21,20, 모기지/NNG;고정/NNG;금리/NNG;떨어/VV,41,1.5246285679162133,Hawkish
12,11, 타격/NNG;입/VV;없/VA,23,1.58402968095191,Hawkish
15,13, 내수/NNG;강화/NNG,28,1.6754160086991354,Hawkish
9,10, 인플레이션/NNG;목표/NNG;넘/VV,19,1.3068244867853258,Hawkish
11,9, 돌아온다고/VV,20,1.774699920325751,Hawkish
25,18, 孫/NNG,43,2.0167044549156263,Hawkish
12,4, 브라보/NNG,16,4.356081622617753,Hawkish
13,10, 쇼와/NNG,23,1.887635369801026,Hawkish
13,8, 가두/VV,21,2.359544212251283,Hawkish
11,10,흡수합병/NNG,21,1.5972299282931757,Hawkish
9,10,유공/NNG,19,1.3068244867853258,Hawkish
8,8, 꾸몄/VV,16,1.4520272075392506,Hawkish
12,6, 노비/NNG,18,2.9040544150785017,Hawkish
13,8,욱/MAG,21,2.359544212251283,Hawkish
10,7, 부채/NNG;상환/NNG;압박/NNG,17,2.07432458219893,Hawkish
30,23, 변별력/NNG,53,1.8939485315729356,Hawkish
14,13,라이프/NNG,27,1.5637216081191931,Hawkish
18,16, 가계/NNG;저축률/NNG;하락/NNG,34,1.6335306084816572,Hawkish
12,10, 위험/NNG;수위/NNG;오르/VV,22,1.742432649047101,Hawkish
17,14, 스페셜리스트/NNG,31,1.7631758948690905,Hawkish
17,11, 고금리/NNG;피해/NNG,28,2.244042048015206,Hawkish
14,5,엑스포/NNG,19,4.065676181109902,Hawkish
12,11, 금리/NNG;오르/VV;하락/NNG,23,1.58402968095191,Hawkish
10,7,대학가/NNG,17,2.07432458219893,Hawkish
17,17, 연체/NNG;우려/NNG,34,1.4520272075392509,Hawkish
8,8, 가계/NNG;대출/NNG;금리/NNG;낮/VV,16,1.4520272075392506,Hawkish
10,10,패러다임/NNG,20,1.4520272075392509,Hawkish
9,7, 인터폴/NNG,16,1.866892123979037,Hawkish
15,13, 항쟁/NNG,28,1.6754160086991354,Hawkish
12,12, 어드밴티지/NNG,24,1.4520272075392509,Hawkish
14,9, 탄탄/NNG;경기/NNG;회복/NNG,23,2.258708989505501,Hawkish
13,11, 경대/NNG,24,1.7160321543645694,Hawkish
9,7, 금리/NNG;인상/NNG;전망/NNG;늘/VV,16,1.866892123979037,Hawkish
54,59, 환승론/NNG,113,1.3289740543579585,Hawkish
11,10, 대출/NNG;영업/NNG;강화/NNG,21,1.5972299282931757,Hawkish
10,11, 수온/NNG,21,1.3200247341265916,Hawkish
10,7, 부당한공동행위/NNG,17,2.07432458219893,Hawkish
18,10, 산업/NNG;생산/NNG;예상/NNG;부진/NNG,28,2.6136489735706516,Hawkish
30,19, 미스터리/NNG,49,2.2926745382198694,Hawkish
9,7, 채권/NNG;반대/NNG,16,1.866892123979037,Hawkish
16,14,모스/NNG,30,1.6594596657591438,Hawkish
10,9, 살펴본다면/VV,19,1.6133635639325008,Hawkish
11,12, 옥토/NNG,23,1.331024940244313,Hawkish
10,7, 만만/NNG;않/VX;우려/NNG,17,2.07432458219893,Hawkish
34,32, 지수/NNG;밀/VV;오르/VV,66,1.5427789080104541,Hawkish
11,7, 수출관세/NNG,18,2.2817570404188228,Hawkish
19,21, 申/NNG,40,1.3137389020593222,Hawkish
10,6, 예산액/NNG,16,2.420045345898751,Hawkish
8,8,작년도/NNG,16,1.4520272075392506,Hawkish
15,16, 차입비율/NNG,31,1.3612755070680476,Hawkish
10,9,본다면/VV,19,1.6133635639325008,Hawkish
9,10, 어길/VV,19,1.3068244867853258,Hawkish
12,10, 은행/NNG;부도/NNG;위험/NNG,22,1.742432649047101,Hawkish
11,12, 물가/NNG;인상/NNG;억제/NNG,23,1.331024940244313,Hawkish
16,7, 와인정기예금/NNG,23,3.3189193315182877,Hawkish
11,10, 회갑/NNG,21,1.5972299282931757,Hawkish
10,7, 미/NNG;서브프라임/NNG;부실/NNG,17,2.07432458219893,Hawkish
9,8, 데드/NNG,17,1.6335306084816572,Hawkish
9,8, 둔화/NNG;전망/NNG;하락/NNG,17,1.6335306084816572,Hawkish
13,6,동계/NNG,19,3.1460589496683764,Hawkish
14,12, 금리/NNG;언제/MAG;오르/VV,26,1.6940317421291258,Hawkish
15,13, 처남/NNG,28,1.6754160086991354,Hawkish
12,10, 영업이익/NNG;넘/VV,22,1.742432649047101,Hawkish
13,10, 금융시장/NNG;풀/VV,23,1.887635369801026,Hawkish
16,2, 수감자/NNG,18,11.616217660314005,Hawkish
10,8,소상공인지원센터/NNG,18,1.8150340094240636,Hawkish
8,8,전사/NNG,16,1.4520272075392506,Hawkish
17,17, 기일물/NNG,34,1.4520272075392509,Hawkish
12,10,방만/NNG,22,1.742432649047101,Hawkish
12,9, 우려/NNG;이어지/VV;하락/NNG,21,1.9360362767190011,Hawkish
9,10,양주/NNG,19,1.3068244867853258,Hawkish
12,12,바보/NNG,24,1.4520272075392509,Hawkish
12,12,주채무계열/NNG,24,1.4520272075392509,Hawkish
9,9, 계장/NNG,18,1.4520272075392509,Hawkish
11,11, 국채선물시장/NNG;급등/NNG,22,1.4520272075392509,Hawkish
9,9, 마를/VV,18,1.4520272075392509,Hawkish
19,19, 가격/NNG;상승/NNG;크/VV,38,1.4520272075392509,Hawkish
20,22, 둬서/VV,42,1.3200247341265916,Hawkish
20,1, 신용경색/NNG;공포/NNG,21,29.040544150785017,Hawkish
18,17, 미국발/NNG;신용경색/NNG;우려/NNG,35,1.5374405726886184,Hawkish
9,7, 자본시장/NNG;개방/NNG;확대/NNG,16,1.866892123979037,Hawkish
11,5,오류/NNG,16,3.1944598565863513,Hawkish
13,10, 품질개선/NNG,23,1.887635369801026,Hawkish
15,4, 신용경색/NNG;확산/NNG;우려/NNG,19,5.44510202827219,Hawkish
19,21, 손실/NNG;늘/VV,40,1.3137389020593222,Hawkish
9,9, 부실/NNG;금리/NNG;인상/NNG,18,1.4520272075392509,Hawkish
14,6, 신용경색/NNG;우려/NNG;확산/NNG,20,3.3880634842582515,Hawkish
14,3,탈레반/NNG,17,6.776126968516503,Hawkish
10,10, 지표/NNG;경제/NNG;회복/NNG,20,1.4520272075392509,Hawkish
102,107, 중보/NNG,209,1.3841754688691923,Hawkish
27,13, 신용경색/NNG;충격/NNG,40,3.0157488156584438,Hawkish
8,8, 표준시/NNG,16,1.4520272075392506,Hawkish
9,9, 재무회계/NNG,18,1.4520272075392509,Hawkish
13,7, 댔/XSV,20,2.6966219568586087,Hawkish
18,8, 금리/NNG;무제한/NNG,26,3.2670612169633144,Hawkish
18,2, 신용경색/NNG;확산/NNG;막/VV,20,13.068244867853258,Hawkish
13,10, 신용경색/NNG;차단/NNG,23,1.887635369801026,Hawkish
10,6, gdp/NNG;지표/NNG;부진/NNG,16,2.420045345898751,Hawkish
16,14, 저기압/NNG,30,1.6594596657591438,Hawkish
15,6,서킷브레이커/NNG,21,3.6300680188481267,Hawkish
12,6, 위기/NNG;확산/NNG;우려/NNG,18,2.9040544150785017,Hawkish
18,18,드/VV,36,1.4520272075392509,Hawkish
8,8, 주택/NNG;건설/NNG;경기/NNG;침체/NNG,16,1.4520272075392506,Hawkish
99,22, fed/NNG;재할인율/NNG;인하/NNG,121,6.534122433926629,Hawkish
11,6, 신용경색/NNG;불확실성/NNG,17,2.662049880488626,Hawkish
95,56, 재할인율/NNG;인하/NNG,151,2.4632604413612293,Hawkish
31,16, fed/NNG;긴급/NNG;금리/NNG;인하/NNG,47,2.8133027146072984,Hawkish
10,9, 두박/NNG,19,1.6133635639325008,Hawkish
16,15, fed/NNG;금융시장/NNG;안정/NNG,31,1.5488290213752007,Hawkish
10,10, 재할인율/NNG;오르/VV,20,1.4520272075392509,Hawkish
9,10, 불거질지/VV,19,1.3068244867853258,Hawkish
8,8, 낮/VA;불안/NNG,16,1.4520272075392506,Hawkish
12,10,공대/NNG,22,1.742432649047101,Hawkish
15,7, 신용위기/NNG;타격/NNG,22,3.1114868732983947,Hawkish
10,10, 순채권/NNG,20,1.4520272075392509,Hawkish
14,13, 다원/NNG,27,1.5637216081191931,Hawkish
10,10, 채권시장/NNG;국고채/NNG;하락/NNG,20,1.4520272075392509,Hawkish
23,12, 은행채/NNG;스프레드/NNG;확대/NNG,35,2.7830521477835637,Hawkish
13,7, 식량난/NNG,20,2.6966219568586087,Hawkish
18,19, 소독/NNG,37,1.375604722931922,Hawkish
14,7, 폐합/NNG,21,2.9040544150785017,Hawkish
13,13, 신용위기/NNG;끝/NNG,26,1.4520272075392509,Hawkish
10,10,진실/NNG,20,1.4520272075392509,Hawkish
9,10, 부동산/NNG;경기/NNG;개선/NNG,19,1.3068244867853258,Hawkish
20,15, 회유/NNG,35,1.936036276719001,Hawkish
24,23, 리파이낸스/NNG,47,1.5151588252583488,Hawkish
29,32, 지정학/NNG;우려/NNG;완화/NNG,61,1.315899656832446,Hawkish
14,11,침묵/NNG,25,1.8480346277772284,Hawkish
54,56, 證券/NNG,110,1.4001690929842776,Hawkish
11,12, 韓中/NNG,23,1.331024940244313,Hawkish
12,8, 내수/NNG;소비/NNG;증가/NNG,20,2.1780408113088763,Hawkish
9,8, 경제공동체/NNG,17,1.6335306084816572,Hawkish
14,10, 지표/NNG;약세/NNG,24,2.032838090554951,Hawkish
12,11, 쳐서/VV,23,1.58402968095191,Hawkish
16,16, 국제/NNG;금융/NNG;불안/NNG,32,1.4520272075392506,Hawkish
11,10, 불안/NNG;효과/NNG,21,1.5972299282931757,Hawkish
10,9, 금융시장/NNG;호전/NNG,19,1.6133635639325008,Hawkish
12,10,공동구매/NNG,22,1.742432649047101,Hawkish
11,5, 비농업/NNG;일자리/NNG;감소/NNG,16,3.1944598565863513,Hawkish
12,8, 경기/NNG;하락/NNG;위험/NNG;막/VV,20,2.1780408113088763,Hawkish
10,11, 제보자/NNG,21,1.3200247341265916,Hawkish
18,7, 권합니다/VV,25,3.733784247958074,Hawkish
13,6, 더운/VA,19,3.1460589496683764,Hawkish
17,16,질서/NNG,33,1.5427789080104541,Hawkish
17,14, 육지/NNG,31,1.7631758948690905,Hawkish
12,7, 몰표/NNG,19,2.489189498638716,Hawkish
8,8, 경제/NNG;불황/NNG;빠지/VV,16,1.4520272075392506,Hawkish
13,7, 노던록사태/NNG,20,2.6966219568586087,Hawkish
30,31,드림/NNG,61,1.405187620199275,Hawkish
36,32, pf/NNG;부실/NNG,68,1.6335306084816572,Hawkish
9,10, 힘쓴/VV,19,1.3068244867853258,Hawkish
29,28, 부동산/NNG;pf/NNG;부실/NNG,57,1.503885322094224,Hawkish
11,5, 맞짱/NNG,16,3.1944598565863513,Hawkish
51,55, 애론/NNG,106,1.3464252288091234,Hawkish
25,23, 비무장지대/NNG,48,1.5782904429774465,Hawkish
11,12,협업/NNG,23,1.331024940244313,Hawkish
9,10, 엄수/NNG,19,1.3068244867853258,Hawkish
12,8, 세계/NNG;물가/NNG;상승/NNG,20,2.1780408113088763,Hawkish
10,11,순차/NNG,21,1.3200247341265916,Hawkish
8,8, 경기/NNG;침체/NNG;빠지/VV;않/VX,16,1.4520272075392506,Hawkish
95,106,캠코/NNG,201,1.3013451388323476,Hawkish
12,8, 달러원/NNG;영향/NNG;줄/VV,20,2.1780408113088763,Hawkish
25,27,감원계획/NNG,52,1.3444696366104174,Hawkish
26,23,금융기업/NNG,49,1.6414220606965444,Hawkish
9,8, 경기/NNG;침체/NNG;우려/NNG;높/VA,17,1.6335306084816572,Hawkish
11,12, 중재자/NNG,23,1.331024940244313,Hawkish
10,9,에프/NNG,19,1.6133635639325008,Hawkish
10,6, 손주/NNG,16,2.420045345898751,Hawkish
32,26, 블랙리스트/NNG,58,1.7871104092790777,Hawkish
20,16,달러페그제/NNG,36,1.8150340094240636,Hawkish
18,2, 권고서/NNG,20,13.068244867853258,Hawkish
16,17, 경제/NNG;성장/NNG;하방/NNG;위험/NNG,33,1.3666138423898828,Hawkish
11,6, 지표/NNG;호조/NNG;강세/NNG,17,2.662049880488626,Hawkish
14,7, 화살표/NNG,21,2.9040544150785017,Hawkish
10,6, 소탕/NNG,16,2.420045345898751,Hawkish
11,11, 채권/NNG;발행/NNG;확보/NNG,22,1.4520272075392509,Hawkish
17,13, 금리선물/NNG;fed/NNG;금리/NNG;인하/NNG,30,1.8988048098590204,Hawkish
9,7, 사택/NNG,16,1.866892123979037,Hawkish
27,27, 해외/NNG;불확실성/NNG,54,1.4520272075392506,Hawkish
38,31, 주택/NNG;지표/NNG;개선/NNG,69,1.7799043189190817,Hawkish
18,17,촌놈/NNG,35,1.5374405726886184,Hawkish
11,12, 상납/NNG,23,1.331024940244313,Hawkish
9,8, 초보자/NNG,17,1.6335306084816572,Hawkish
18,10, 달러인덱스/NNG;최저/NNG,28,2.6136489735706516,Hawkish
12,13, 가계/NNG;이자/NNG;부담/NNG;크/VV,25,1.3403328069593086,Hawkish
19,8, 근담보/NNG,27,3.448564617905721,Hawkish
9,9, 원가경쟁력/NNG;확보/NNG,18,1.4520272075392509,Hawkish
21,14, 삼중/NNG,35,2.1780408113088763,Hawkish
12,9,시노/NNG,21,1.9360362767190011,Hawkish
14,15,투자컨설팅/NNG,29,1.3552253937033008,Hawkish
14,14,특사/NNG,28,1.4520272075392509,Hawkish
14,13, 경제/NNG;활력/NNG;저하/NNG,27,1.5637216081191931,Hawkish
10,8, 선망/NNG,18,1.8150340094240636,Hawkish
12,10, 대출/NNG;연체율/NNG;상승/NNG,22,1.742432649047101,Hawkish
9,9, 상방/NNG;하방/NNG,18,1.4520272075392509,Hawkish
19,16, 자투리/NNG,35,1.7242823089528605,Hawkish
12,11,인사이트펀드/NNG,23,1.58402968095191,Hawkish
39,42,실손/NNG,81,1.3483109784293044,Hawkish
19,20, 앨범/NNG,39,1.3794258471622882,Hawkish
8,8,교통공사/NNG,16,1.4520272075392506,Hawkish
17,9, 예방법/NNG,26,2.7427180586852518,Hawkish
19,16, 자금/NNG;미리/MAG;확보/NNG,35,1.7242823089528605,Hawkish
22,6, 4자회담/NNG,28,5.324099760977252,Hawkish
11,11, 밥값/NNG,22,1.4520272075392509,Hawkish
9,10, 우려/NNG;대외/NNG;악재/NNG,19,1.3068244867853258,Hawkish
15,14,소멸시효/NNG,29,1.5557434366491973,Hawkish
10,10, 실소유주/NNG,20,1.4520272075392509,Hawkish
10,6, 다니엘/NNG,16,2.420045345898751,Hawkish
12,12, 풍문/NNG,24,1.4520272075392509,Hawkish
13,9, 하락/NNG;지수/NNG;하락/NNG,22,2.097372633112251,Hawkish
11,6, 금융시장/NNG;시스템/NNG;위험/NNG,17,2.662049880488626,Hawkish
14,7, 필히/MAG,21,2.9040544150785017,Hawkish
17,9, 가계/NNG;부채/NNG;부담/NNG;증가/NNG,26,2.7427180586852518,Hawkish
36,32,중앙경제공작회의/NNG,68,1.6335306084816572,Hawkish
16,16, 역외/NNG;환율/NNG;소폭/MAG;상승/NNG,32,1.4520272075392506,Hawkish
11,12,연예인/NNG,23,1.331024940244313,Hawkish
27,6, 물가/NNG;불안/NNG;확산/NNG,33,6.534122433926628,Hawkish
124,87,신혼/NNG,211,2.0695560199410012,Hawkish
12,8,총기/NNG,20,2.1780408113088763,Hawkish
12,8,차명/NNG,20,2.1780408113088763,Hawkish
24,25, 인민군/NNG,49,1.393946119237681,Hawkish
80,67, gdp/NNG;갭/NNG;플러스/NNG,147,1.733763829897613,Hawkish
9,7, 인플레이션/NNG;지표/NNG;근원/NNG;오르/VV,16,1.866892123979037,Hawkish
17,11, 임정/NNG,28,2.244042048015206,Hawkish
11,12, 활동가/NNG,23,1.331024940244313,Hawkish
10,10, 전세/NNG;오르/VV,20,1.4520272075392509,Hawkish
10,7, 경제/NNG;쉽/VA,17,2.07432458219893,Hawkish
16,9, 유가/NNG;밀/VV;오르/VV,25,2.5813817022920014,Hawkish
14,9,의왕/NNG,23,2.258708989505501,Hawkish
10,9, 물가/NNG;상승/NNG;완화/NNG,19,1.6133635639325008,Hawkish
13,9, 전세가격/NNG;약세/NNG,22,2.097372633112251,Hawkish
10,9, 이익/NNG;많/VA,19,1.6133635639325008,Hawkish
10,9,네일/NNG,19,1.6133635639325008,Hawkish
12,12, 고용/NNG;지표/NNG;불확실성/NNG,24,1.4520272075392509,Hawkish
15,16, 프렌들리/NNG,31,1.3612755070680476,Hawkish
9,9,로터리/NNG,18,1.4520272075392509,Hawkish
8,8, 森/NNG,16,1.4520272075392506,Hawkish
22,17, 민영화계획/NNG,39,1.879094033286089,Hawkish
12,8,사업보고서/NNG,20,2.1780408113088763,Hawkish
14,11, 여쭤/VV,25,1.8480346277772284,Hawkish
14,11, 통화/NNG;긴축/NNG;완화/NNG,25,1.8480346277772284,Hawkish
14,9, 무점/NNG,23,2.258708989505501,Hawkish
10,9, 개정판/NNG,19,1.6133635639325008,Hawkish
12,8, 지분쪼개기/NNG,20,2.1780408113088763,Hawkish
11,6, 수요/NNG;감소/NNG;전망/NNG;하락/NNG,17,2.662049880488626,Hawkish
10,8, 채권/NNG;충격/NNG,18,1.8150340094240636,Hawkish
10,9, 경기/NNG;부양책/NNG;실망/NNG,19,1.6133635639325008,Hawkish
13,9, 글로벌/NNG;금융시장/NNG;패닉/NNG,22,2.097372633112251,Hawkish
15,14,미의회예산국/NNG,29,1.5557434366491973,Hawkish
9,7, 축배/NNG,16,1.866892123979037,Hawkish
12,9, 신용금고/NNG,21,1.9360362767190011,Hawkish
13,14, 비엘/NNG,27,1.3483109784293044,Hawkish
37,39,자치구/NNG,76,1.3775642738192893,Hawkish
11,10, 小康/NNG,21,1.5972299282931757,Hawkish
13,4, 깡/NNG,17,4.719088424502566,Hawkish
11,11, 회람/NNG,22,1.4520272075392509,Hawkish
10,9, 적조/NNG,19,1.6133635639325008,Hawkish
9,8,주요주주/NNG,17,1.6335306084816572,Hawkish
13,11, 초청장/NNG,24,1.7160321543645694,Hawkish
10,10, gdp/NNG;전망/NNG;낮/VV,20,1.4520272075392509,Hawkish
11,11,스프/NNG,22,1.4520272075392509,Hawkish
19,9,언어/NNG,28,3.0653907714717517,Hawkish
9,8, 도산/NNG;막/VV,17,1.6335306084816572,Hawkish
34,37, 순자산/NNG;운용/NNG;넘/VV,71,1.3342952717928251,Hawkish
9,9, 돋보기/NNG,18,1.4520272075392509,Hawkish
9,10, 국제/NNG;금융시장/NNG;불안/NNG;경기/NNG;부진/NNG,19,1.3068244867853258,Hawkish
10,9, 병진/NNG,19,1.6133635639325008,Hawkish
17,5,쑨/VV,22,4.936892505633453,Hawkish
25,25, 경제/NNG;마이너스/NNG;성장/NNG,50,1.4520272075392509,Hawkish
21,23, 식품기업/NNG,44,1.325763972101055,Hawkish
12,7, 종적/NNG,19,2.489189498638716,Hawkish
12,10, 빼낼/VV,22,1.742432649047101,Hawkish
21,13, 동화가치/NNG,34,2.3455824121787896,Hawkish
20,18, 수석비서관회의/NNG,38,1.6133635639325008,Hawkish
14,12, 가계/NNG;대출/NNG;넘/VV,26,1.6940317421291258,Hawkish
33,28, 하이패스/NNG,61,1.7113177803141169,Hawkish
25,25, 인민대표회의/NNG,50,1.4520272075392509,Hawkish
9,7, 지정학/NNG;불안/NNG;크/VV,16,1.866892123979037,Hawkish
12,6,소형차/NNG,18,2.9040544150785017,Hawkish
17,4, 쑨/VV,21,6.171115632041817,Hawkish
21,13, 글로벌/NNG;주식시장/NNG;불안/NNG,34,2.3455824121787896,Hawkish
49,46, 섬김/VV,95,1.5467246341178977,Hawkish
9,9, 홈에쿼티론/NNG,18,1.4520272075392509,Hawkish
13,10, 침체/NNG;빠지/VV;이중침체/NNG,23,1.887635369801026,Hawkish
34,24,유용/NNG,58,2.0570385440139387,Hawkish
27,26, 채권펀드/NNG;하락/NNG,53,1.5078744078292219,Hawkish
23,23, 보이콧/NNG,46,1.4520272075392506,Hawkish
12,11, 경제/NNG;완전히/MAG;회복/NNG,23,1.58402968095191,Hawkish
16,16, 경제/NNG;위기/NNG;벗어나/VV,32,1.4520272075392506,Hawkish
10,9,경제금융상황점검회의/NNG,19,1.6133635639325008,Hawkish
34,24, 경제금융상황점검회의/NNG,58,2.0570385440139387,Hawkish
11,11, 색출/NNG,22,1.4520272075392509,Hawkish
10,11, 중소기업/NNG;이자/NNG;부담/NNG,21,1.3200247341265916,Hawkish
8,8, 춘분/NNG,16,1.4520272075392506,Hawkish
8,8, 언니/NNG,16,1.4520272075392506,Hawkish
27,30, 그은/VV,57,1.3068244867853256,Hawkish
10,8,방중/NNG,18,1.8150340094240636,Hawkish
10,11,이제껏/MAG,21,1.3200247341265916,Hawkish
16,7, 두드림/VV,23,3.3189193315182877,Hawkish
9,9, 기업/NNG;신용등급/NNG;안정/NNG,18,1.4520272075392509,Hawkish
15,14, 與野/NNG,29,1.5557434366491973,Hawkish
11,10, 분리과세/NNG;고수익/NNG;위험/NNG,21,1.5972299282931757,Hawkish
13,14,상호금융회사/NNG,27,1.3483109784293044,Hawkish
16,16,환율효과/NNG,32,1.4520272075392506,Hawkish
20,18,스탁론/NNG,38,1.6133635639325008,Hawkish
13,9, 공관장/NNG,22,2.097372633112251,Hawkish
17,11, 식량/NNG;가격/NNG;상승/NNG,28,2.244042048015206,Hawkish
17,6, 공회/NNG,23,4.114077088027877,Hawkish
15,12, 완화/NNG;한계/NNG,27,1.8150340094240633,Hawkish
9,8,대계/NNG,17,1.6335306084816572,Hawkish
9,8, 국제/NNG;원자재/NNG;가격/NNG;약세/NNG,17,1.6335306084816572,Hawkish
10,7,적기/NNG,17,2.07432458219893,Hawkish
11,11,금융거래세/NNG,22,1.4520272075392509,Hawkish
12,11, 서비스업/NNG;경기/NNG;확장/NNG,23,1.58402968095191,Hawkish
8,8, 환경기술/NNG,16,1.4520272075392506,Hawkish
18,13, 대내외/NNG;여건/NNG;녹록/NNG;않/VX,31,2.010499210438963,Hawkish
8,8,퍼포먼스/NNG,16,1.4520272075392506,Hawkish
8,8, 들락날락/MAG,16,1.4520272075392506,Hawkish
12,8,강진/NNG,20,2.1780408113088763,Hawkish
14,14,국고여유자금/NNG,28,1.4520272075392509,Hawkish
9,8, 호찌/NNG,17,1.6335306084816572,Hawkish
14,15, 민시/NNG,29,1.3552253937033008,Hawkish
12,5,자금팀/NNG,17,3.484865298094202,Hawkish
8,8, 이자비용/NNG;부담/NNG;크/VV,16,1.4520272075392506,Hawkish
13,8,바젤은행감독위원회/NNG,21,2.359544212251283,Hawkish
9,9, 인플레이션/NNG;무역/NNG;적자/NNG,18,1.4520272075392509,Hawkish
11,10, 김밥/NNG,21,1.5972299282931757,Hawkish
10,10, 예약금/NNG,20,1.4520272075392509,Hawkish
40,38,유로본드/NNG,78,1.5284496921465798,Hawkish
164,177,민재/NNG,341,1.3453811414487973,Hawkish
9,8, 물가/NNG;상승/NNG;우려/NNG;크/VV,17,1.6335306084816572,Hawkish
28,13, 항일/NNG,41,3.1274432162383863,Hawkish
10,6, 반등/NNG;제한/NNG,16,2.420045345898751,Hawkish
16,5, 국해/NNG,21,4.646487064125602,Hawkish
19,9, 진보신/NNG,28,3.0653907714717517,Hawkish
19,20, 총위험액/NNG,39,1.3794258471622882,Hawkish
11,11, 자금세탁방지/NNG,22,1.4520272075392509,Hawkish
9,9, 단채/NNG,18,1.4520272075392509,Hawkish
11,12,금융투자업/NNG,23,1.331024940244313,Hawkish
15,16, 가스/NNG;요금/NNG;인상/NNG,31,1.3612755070680476,Hawkish
11,12,우세/NNG,23,1.331024940244313,Hawkish
13,5,열주/NNG,18,3.775270739602052,Hawkish
150,112, 하이보/NNG,262,1.944679295811497,Hawkish
18,19, 망은/NNG,37,1.375604722931922,Hawkish
12,11, 엘크/NNG,23,1.58402968095191,Hawkish
11,5, 분금/NNG,16,3.1944598565863513,Hawkish
25,27,수석비서관회의/NNG,52,1.3444696366104174,Hawkish
14,15, 자율형사립고/NNG,29,1.3552253937033008,Hawkish
23,6, 모진/VA,29,5.566104295567127,Hawkish
9,10, 강력/NNG;매파/NNG,19,1.3068244867853258,Hawkish
11,12, 조세지출/NNG,23,1.331024940244313,Hawkish
9,9, 지수/NNG;경기/NNG;둔화/NNG;우려/NNG,18,1.4520272075392509,Hawkish
13,6,후배/NNG,19,3.1460589496683764,Hawkish
9,7, 구매/NNG;미루/VV,16,1.866892123979037,Hawkish
23,23, 물가/NNG;상승률/NNG;밑돌/VV,46,1.4520272075392506,Hawkish
12,13, 노산/NNG,25,1.3403328069593086,Hawkish
10,7, 저번/NNG,17,2.07432458219893,Hawkish
20,13, 원유/NNG;수요/NNG;감소/NNG;우려/NNG,33,2.2338880115988475,Hawkish
10,7, 절하/NNG;없/VA,17,2.07432458219893,Hawkish
16,6, 낭독/NNG,22,3.8720725534380014,Hawkish
24,19, 쩨/MAG,43,1.834139630575896,Hawkish
10,9,산탄데르은행/NNG,19,1.6133635639325008,Hawkish
12,7,국가안보회의/NNG,19,2.489189498638716,Hawkish
9,10, 요도/NNG,19,1.3068244867853258,Hawkish
29,20, 티타임/NNG,49,2.1054394509319136,Hawkish
17,12,일감/NNG,29,2.0570385440139387,Hawkish
10,10,원당/NNG,20,1.4520272075392509,Hawkish
21,22, 발사체/NNG,43,1.3860259708329212,Hawkish
14,5, 담쟁이/NNG,19,4.065676181109902,Hawkish
10,11, fx거래/NNG,21,1.3200247341265916,Hawkish
12,4,비컨/NNG,16,4.356081622617753,Hawkish
19,18, 순이익/NNG;시장/NNG;예상/NNG;상회/NNG,37,1.5326953857358758,Hawkish
9,9, 금융위기/NNG;경기/NNG;부양/NNG,18,1.4520272075392509,Hawkish
9,7, 신월/NNG,16,1.866892123979037,Hawkish
12,9,모리/NNG,21,1.9360362767190011,Hawkish
19,19,연고점/NNG,38,1.4520272075392509,Hawkish
15,2, 신흥국/NNG;인플레이션/NNG;우려/NNG,17,10.89020405654438,Hawkish
9,8, 성장/NNG;의구심/NNG,17,1.6335306084816572,Hawkish
26,26, 물가/NNG;목표/NNG;상향/NNG,52,1.4520272075392509,Hawkish
9,9,과밀억제권역/NNG,18,1.4520272075392509,Hawkish
14,10, 고등어/NNG,24,2.032838090554951,Hawkish
17,9, 근거리/NNG,26,2.7427180586852518,Hawkish
17,8, 비안/NNG,25,3.0855578160209083,Hawkish
10,11, 자락/NNG,21,1.3200247341265916,Hawkish
23,0, 구스타브/NNG,23,inf,Hawkish
20,13, 유로존/NNG;경제/NNG;침체/NNG,33,2.2338880115988475,Hawkish
10,8, crs/NNG;금리/NNG;하락/NNG;압력/NNG,18,1.8150340094240636,Hawkish
14,15, 엄벌/NNG,29,1.3552253937033008,Hawkish
10,11,숙명/NNG,21,1.3200247341265916,Hawkish
19,14, 위험/NNG;균형/NNG;잡/VV,33,1.9706083530889835,Hawkish
10,11,거래액/NNG,21,1.3200247341265916,Hawkish
8,8,신차효과/NNG,16,1.4520272075392506,Hawkish
13,13, 선루프/NNG,26,1.4520272075392509,Hawkish
10,9, 경제/NNG;위기/NNG;탈출/NNG,19,1.6133635639325008,Hawkish
14,9, 가계/NNG;기업/NNG;부실/NNG,23,2.258708989505501,Hawkish
9,7, 유동성/NNG;충분히/MAG;확보/NNG,16,1.866892123979037,Hawkish
23,19, 공실/NNG;위험/NNG,42,1.7577171459685668,Hawkish
22,20,반값/NNG,42,1.5972299282931757,Hawkish
15,10,장학금/NNG,25,2.178040811308876,Hawkish
13,6, 연기설/NNG,19,3.1460589496683764,Hawkish
14,12, 경제/NNG;침체국면/NNG;벗어나/VV,26,1.6940317421291258,Hawkish
13,14, 은행/NNG;금리/NNG;급등/NNG,27,1.3483109784293044,Hawkish
8,8,트리플약세/NNG,16,1.4520272075392506,Hawkish
9,10,신간/NNG,19,1.3068244867853258,Hawkish
212,156, 보금자리주택/NNG,368,1.9732677435789818,Hawkish
12,8, 국채/NNG;금리/NNG;많이/MAG;오르/VV,20,2.1780408113088763,Hawkish
19,13, 전매/NNG;제한/NNG;풀/VV,32,2.122193611018905,Hawkish
13,13,시급/NNG,26,1.4520272075392509,Hawkish
12,9,재정위/NNG,21,1.9360362767190011,Hawkish
21,15, 난도/NNG,36,2.032838090554951,Hawkish
13,13, 틔워줄/VV,26,1.4520272075392509,Hawkish
13,14,스파/NNG,27,1.3483109784293044,Hawkish
51,28,하이보/NNG,79,2.6447638423036355,Hawkish
20,22,반정부/NNG,42,1.3200247341265916,Hawkish
23,25, 레지던스/NNG,48,1.3358650309361106,Hawkish
12,4,테러지원국/NNG,16,4.356081622617753,Hawkish
14,10, 동남아시아국가연합/NNG,24,2.032838090554951,Hawkish
49,52,고은/VA,101,1.3682564071042942,Hawkish
14,9, 부채/NNG;상환/NNG;어렵/VA,23,2.258708989505501,Hawkish
14,13, 통화정책/NNG;실기/NNG,27,1.5637216081191931,Hawkish
12,11, 정류장/NNG,23,1.58402968095191,Hawkish
43,28,포린트/NNG,71,2.2298989258638495,Hawkish
12,9, 미/NNG;국채/NNG;가격/NNG;오르/VV,21,1.9360362767190011,Hawkish
8,8, 퇴행/NNG,16,1.4520272075392506,Hawkish
9,7, 디프테리아/NNG,16,1.866892123979037,Hawkish
21,20, 침습/NNG,41,1.5246285679162133,Hawkish
39,31, 사회적경제/NNG,70,1.8267439062590576,Hawkish
8,8, 플러그인/NNG,16,1.4520272075392506,Hawkish
9,9, 우려/NNG;국제/NNG;유가/NNG;급락/NNG,18,1.4520272075392509,Hawkish
14,14, 정비계획/NNG,28,1.4520272075392509,Hawkish
11,8,산운/NNG,19,1.9965374103664697,Hawkish
9,7, 유언비어/NNG,16,1.866892123979037,Hawkish
34,29, 민평/NNG;밑돌/VV,63,1.7023767260805012,Hawkish
16,11, 고용/NNG;우려/NNG,27,2.1120395746025467,Hawkish
15,11,조승/NNG,26,1.9800371011898874,Hawkish
10,6, 수입규제/NNG;강화/NNG,16,2.420045345898751,Hawkish
19,8,도시개발공사/NNG,27,3.448564617905721,Hawkish
8,8, 기대/NNG;넘/VV;상승/NNG,16,1.4520272075392506,Hawkish
14,14, 우려/NNG;크/VV;안전자산/NNG;선호/NNG,28,1.4520272075392509,Hawkish
11,12, gdp/NNG;실망/NNG,23,1.331024940244313,Hawkish
18,15, 적자성/NNG,33,1.742432649047101,Hawkish
8,8, 저신용자/NNG;고금리/NNG,16,1.4520272075392506,Hawkish
9,7, 가로지르/VV,16,1.866892123979037,Hawkish
11,7, 임금/NNG;반납/NNG,18,2.2817570404188228,Hawkish
10,6, 판결서/NNG,16,2.420045345898751,Hawkish
15,13,구역/NNG,28,1.6754160086991354,Hawkish
14,14, 금값/NNG;하락/NNG;압력/NNG,28,1.4520272075392509,Hawkish
13,9, 산탄데르은행/NNG,22,2.097372633112251,Hawkish
26,17,월봉/NNG,43,2.22074749388356,Hawkish
12,9, 독재자/NNG,21,1.9360362767190011,Hawkish
10,9, 절화/NNG,19,1.6133635639325008,Hawkish
10,9, 기업/NNG;부도/NNG;위험/NNG;크/VV,19,1.6133635639325008,Hawkish
9,9, 소비자/NNG;신뢰지수/NNG;급등/NNG,18,1.4520272075392509,Hawkish
54,52,개별소비세/NNG,106,1.5078744078292219,Hawkish
9,9, 둘러본/VV,18,1.4520272075392509,Hawkish
10,10, 주택/NNG;활성화/NNG,20,1.4520272075392509,Hawkish
12,11, 표할/VV,23,1.58402968095191,Hawkish
8,8,다사다난/NNG,16,1.4520272075392506,Hawkish
10,10,업소/NNG,20,1.4520272075392509,Hawkish
15,15, 미디어법/NNG,30,1.4520272075392506,Hawkish
14,13,구제자금/NNG,27,1.5637216081191931,Hawkish
77,65, 스팩/NNG,142,1.7200937689311127,Hawkish
9,8, gdp/NNG;달하/VV;재정/NNG;적자/NNG,17,1.6335306084816572,Hawkish
9,7, 해직/NNG,16,1.866892123979037,Hawkish
18,3, 산촌/NNG,21,8.712163245235505,Hawkish
11,6, 대출/NNG;금리/NNG;오르/VV;없/VA,17,2.662049880488626,Hawkish
12,8, 입주/NNG;물량/NNG;부담/NNG,20,2.1780408113088763,Hawkish
12,13,중금/NNG,25,1.3403328069593086,Hawkish
13,9, 대출/NNG;금리/NNG;역대/NNG;최저/NNG,22,2.097372633112251,Hawkish
10,11, 자금/NNG;애로/NNG;해소/NNG,21,1.3200247341265916,Hawkish
8,8,키위/NNG,16,1.4520272075392506,Hawkish
13,11,패스트트랙/NNG,24,1.7160321543645694,Hawkish
9,8, 불안/NNG;위험자산/NNG;회피/NNG,17,1.6335306084816572,Hawkish
9,9, 이익/NNG;실현/NNG;하락/NNG,18,1.4520272075392509,Hawkish
63,36, 녹색금융/NNG,99,2.541047613193689,Hawkish
11,9,녹색금융/NNG,20,1.774699920325751,Hawkish
21,6, 할매/NNG,27,5.082095226387377,Hawkish
59,35, 초고위험/NNG,94,2.447703006994737,Hawkish
11,11, 외채/NNG;구조/NNG;개선/NNG,22,1.4520272075392509,Hawkish
12,6, 수지구/NNG,18,2.9040544150785017,Hawkish
14,11, 폐차/NNG,25,1.8480346277772284,Hawkish
17,14,오토매틱데이터프로세싱/NNG,31,1.7631758948690905,Hawkish
11,5, 인하/NNG;중단/NNG,16,3.1944598565863513,Hawkish
11,5, 고난도/NNG,16,3.1944598565863513,Hawkish
10,7, 중재원/NNG,17,2.07432458219893,Hawkish
11,8, 빅토리/NNG,19,1.9965374103664697,Hawkish
13,6,그룹사/NNG,19,3.1460589496683764,Hawkish
11,9, 국새/NNG,20,1.774699920325751,Hawkish
12,6, 물별/NNG,18,2.9040544150785017,Hawkish
10,6, 양적완화/NNG;한계/NNG,16,2.420045345898751,Hawkish
15,12,평균값/NNG,27,1.8150340094240633,Hawkish
20,13, 세계/NNG;경기/NNG;개선/NNG,33,2.2338880115988475,Hawkish
16,15, 경비원/NNG,31,1.5488290213752007,Hawkish
19,20, 경기/NNG;부양책/NNG;축소/NNG,39,1.3794258471622882,Hawkish
8,8, 미/NNG;국채/NNG;금리/NNG;낮/VA,16,1.4520272075392506,Hawkish
11,5, 국채/NNG;발행/NNG;실패/NNG,16,3.1944598565863513,Hawkish
22,20, 민트/NNG,42,1.5972299282931757,Hawkish
9,7,민트/NNG,16,1.866892123979037,Hawkish
9,10,개인워크아웃/NNG,19,1.3068244867853258,Hawkish
26,16, 가격/NNG;파운드/NNG;하락/NNG,42,2.359544212251283,Hawkish
30,19, 통화정책/NNG;당분간/MAG;금융/NNG;완화/NNG,49,2.2926745382198694,Hawkish
10,6, 방정/NNG,16,2.420045345898751,Hawkish
12,12, 세계/NNG;교역/NNG;위축/NNG,24,1.4520272075392509,Hawkish
8,8, 바운스/NNG,16,1.4520272075392506,Hawkish
14,7, 수출/NNG;감소/NNG;둔화/NNG,21,2.9040544150785017,Hawkish
12,11, 집값/NNG;회복/NNG,23,1.58402968095191,Hawkish
8,8, 넷북/NNG,16,1.4520272075392506,Hawkish
16,14, 기업인수목적회사/NNG,30,1.6594596657591438,Hawkish
10,9, 이칭/NNG,19,1.6133635639325008,Hawkish
20,20, 임직원수/NNG,40,1.4520272075392509,Hawkish
57,46, 홀씨/NNG,103,1.799251104994289,Hawkish
17,14, 부채/NNG;증가/NNG;우려/NNG,31,1.7631758948690905,Hawkish
18,17, 지수/NNG;경기/NNG;확장/NNG;위축/NNG,35,1.5374405726886184,Hawkish
11,8, 자금/NNG;부담/NNG;줄/VV,19,1.9965374103664697,Hawkish
19,12, 주택청약저축/NNG,31,2.299043078603814,Hawkish
36,37, 장기물/NNG;오르/VV,73,1.412783228957109,Hawkish
21,9, pmi/NNG;오르/VV,30,3.3880634842582515,Hawkish
8,8, 국채/NNG;수익률/NNG;바닥/NNG,16,1.4520272075392506,Hawkish
11,12, 부비/NNG,23,1.331024940244313,Hawkish
41,29,신종플루/NNG,70,2.0528660520382513,Hawkish
10,8, 재정/NNG;적자/NNG;낮/VV,18,1.8150340094240636,Hawkish
13,5, 완화정책/NNG;되돌/VV,18,3.775270739602052,Hawkish
14,8, 부채/NNG;거품/NNG,22,2.541047613193689,Hawkish
20,11, 시스템트레이딩/NNG,31,2.640049468253183,Hawkish
15,11, 석해/NNG,26,1.9800371011898874,Hawkish
9,8, 추경/NNG;확대/NNG,17,1.6335306084816572,Hawkish
10,11, 글로벌/NNG;유동성/NNG;넘/VV,21,1.3200247341265916,Hawkish
9,8, 국채/NNG;금리/NNG;상승/NNG;우려/NNG,17,1.6335306084816572,Hawkish
9,9, 이자이익/NNG;개선/NNG,18,1.4520272075392509,Hawkish
21,19,리플레이션/NNG,40,1.604872176753909,Hawkish
36,22, 나로호/NNG,58,2.376044521427865,Hawkish
18,4,나로호/NNG,22,6.534122433926629,Hawkish
11,10,반종/NNG,21,1.5972299282931757,Hawkish
10,7, 돌이/NNG,17,2.07432458219893,Hawkish
13,12, 부동산/NNG;담보대출/NNG;모기지/NNG;금리/NNG;인상/NNG,25,1.5730294748341882,Hawkish
14,10, 도발/NNG;지정학/NNG;위험/NNG,24,2.032838090554951,Hawkish
9,7, 원화/NNG;넘/VV,16,1.866892123979037,Hawkish
12,9, 球/NNG,21,1.9360362767190011,Hawkish
15,5, 녹색채권/NNG,20,4.356081622617752,Hawkish
39,19, 디도스/NNG,58,2.9804768996858306,Hawkish
11,6, 포도주/NNG,17,2.662049880488626,Hawkish
12,7, 소비/NNG;지표/NNG;좋/VA,19,2.489189498638716,Hawkish
13,10, 중환자실/NNG,23,1.887635369801026,Hawkish
14,5, 인플레이션/NNG;당분간/MAG;억제/NNG,19,4.065676181109902,Hawkish
20,13, 홍지/NNG,33,2.2338880115988475,Hawkish
13,8, 출구전략/NNG;핵심/NNG;금리/NNG;인상/NNG,21,2.359544212251283,Hawkish
12,11, 외파/NNG,23,1.58402968095191,Hawkish
12,10, 경제/NNG;회복/NNG;가속/NNG,22,1.742432649047101,Hawkish
17,5, 경제/NNG;활동/NNG;안정/NNG,22,4.936892505633453,Hawkish
10,6, 외국인/NNG;하락/NNG;개인/NNG;상승/NNG,16,2.420045345898751,Hawkish
14,4, 노점/NNG,18,5.082095226387378,Hawkish
32,27, 보금자리주택지구/NNG,59,1.720921134861334,Hawkish
9,7, 주택가격전망지수/NNG,16,1.866892123979037,Hawkish
8,8, 차등가격/NNG,16,1.4520272075392506,Hawkish
9,10, 원액/NNG,19,1.3068244867853258,Hawkish
11,5,막걸리/NNG,16,3.1944598565863513,Hawkish
13,3,보금자리주택지구/NNG,16,6.292117899336753,Hawkish
9,7, 수출/NNG;경쟁력/NNG;부정적/VAX,16,1.866892123979037,Hawkish
16,6, 紀/NNG,22,3.8720725534380014,Hawkish
28,20,벌금/NNG,48,2.032838090554951,Hawkish
11,10, 경기/NNG;부양책/NNG;철회/NNG,21,1.5972299282931757,Hawkish
10,6, 고용창출/NNG;효과/NNG;높/VA,16,2.420045345898751,Hawkish
9,10, 돈/NNG;풀/VV;경기/NNG;살/VV,19,1.3068244867853258,Hawkish
9,9, 경제/NNG;급속/NNG;회복/NNG,18,1.4520272075392509,Hawkish
13,7, 무역/NNG;회복/NNG,20,2.6966219568586087,Hawkish
13,14, 금리/NNG;깜짝/MAG;인상/NNG,27,1.3483109784293044,Hawkish
14,11, 금리/NNG;낮/VV;양적완화/NNG,25,1.8480346277772284,Hawkish
11,5,수공/NNG,16,3.1944598565863513,Hawkish
9,10,쓰나미/NNG,19,1.3068244867853258,Hawkish
19,18,전문가그룹/NNG,37,1.5326953857358758,Hawkish
19,9,상호금융사/NNG,28,3.0653907714717517,Hawkish
17,6, 채권/NNG;금리/NNG;경제/NNG;지표/NNG;호조/NNG,23,4.114077088027877,Hawkish
10,9, 갈매/NNG,19,1.6133635639325008,Hawkish
15,14,모집인/NNG,29,1.5557434366491973,Hawkish
12,11, 집단/NNG;대출/NNG;급증/NNG,23,1.58402968095191,Hawkish
39,20,양음/NNG,59,2.831453054701539,Hawkish
19,21, 파면/NNG,40,1.3137389020593222,Hawkish
10,10, 금융위기/NNG;높/VA,20,1.4520272075392509,Hawkish
10,11, 출구전략/NNG;시행/NNG;우려/NNG,21,1.3200247341265916,Hawkish
36,32,북클로징/NNG,68,1.6335306084816572,Hawkish
18,16, 가격/NNG;파운드/NNG;상승/NNG,34,1.6335306084816572,Hawkish
11,8, 금리/NNG;인상/NNG;전망/NNG;하향/NNG,19,1.9965374103664697,Hawkish
9,9, 외화차입/NNG;여건/NNG;양호/NNG,18,1.4520272075392509,Hawkish
9,9,중원/NNG,18,1.4520272075392509,Hawkish
13,4, 대출/NNG;무제한/NNG,17,4.719088424502566,Hawkish
17,13, 장기물/NNG;금리/NNG;떨어/VV,30,1.8988048098590204,Hawkish
28,26,명절/NNG,54,1.5637216081191931,Hawkish
13,12, 양적완화/NNG;조치/NNG;종료/NNG,25,1.5730294748341882,Hawkish
10,10, 채권시장/NNG;국고채/NNG;상승/NNG,20,1.4520272075392509,Hawkish
11,11, 만혼/NNG,22,1.4520272075392509,Hawkish
19,11,뚜/MAG,30,2.5080469948405244,Hawkish
9,10,불어난/VV,19,1.3068244867853258,Hawkish
19,8, crs/NNG;종료/NNG,27,3.448564617905721,Hawkish
16,12, 월정액제/NNG,28,1.9360362767190007,Hawkish
11,9, 인플레이션/NNG;포함/NNG;경제/NNG;이례적/VAX;낮/VA,20,1.774699920325751,Hawkish
11,8, 녹색인증/NNG,19,1.9965374103664697,Hawkish
13,14,산림청/NNG,27,1.3483109784293044,Hawkish
15,6, 지급유예/NNG,21,3.6300680188481267,Hawkish
25,2,시무식/NNG,27,18.150340094240637,Hawkish
31,30, 회사채/NNG;수익률/NNG;오르/VV,61,1.5004281144572258,Hawkish
8,8, pmi/NNG;확장/NNG,16,1.4520272075392506,Hawkish
13,7, 서비스업/NNG;pmi/NNG;오르/VV,20,2.6966219568586087,Hawkish
62,44,구제역/NNG,106,2.046038337896217,Hawkish
24,15, 세계/NNG;경제/NNG;회복/NNG;둔화/NNG,39,2.3232435320628015,Hawkish
10,11, 경제/NNG;회복/NNG;둔화/NNG;우려/NNG,21,1.3200247341265916,Hawkish
38,40, 재정위기/NNG;해소/NNG,78,1.3794258471622882,Hawkish
51,49, 국고채/NNG;지표물/NNG;상승/NNG,100,1.511293624173506,Hawkish
10,9, 긴축/NNG;우려/NNG;크/VV,19,1.6133635639325008,Hawkish
9,9, 경제/NNG;회복/NNG;실망/NNG,18,1.4520272075392509,Hawkish
17,16,수습/NNG,33,1.5427789080104541,Hawkish
10,8, 변동성/NNG;금리/NNG;인상/NNG,18,1.8150340094240636,Hawkish
8,8, crs/NNG;급락/NNG,16,1.4520272075392506,Hawkish
43,44, 리콜사태/NNG,87,1.419026589186086,Hawkish
11,5, 선행/NNG;지수/NNG;오르/VV,16,3.1944598565863513,Hawkish
11,12,챈/VV,23,1.331024940244313,Hawkish
16,11, 수출/NNG;지표/NNG;호조/NNG,27,2.1120395746025467,Hawkish
9,7, 양호/NNG;금리/NNG;인상/NNG,16,1.866892123979037,Hawkish
26,22, 사무장/NNG,48,1.7160321543645694,Hawkish
28,11, 재정위기/NNG;긴축/NNG,39,3.6960692555544568,Hawkish
15,6, 많이/MAG;오르/VV;필요/NNG;없/VA,21,3.6300680188481267,Hawkish
27,21, 전세/NNG;선호/NNG,48,1.8668921239790368,Hawkish
12,5, 지수/NNG;추세/NNG;상승/NNG,17,3.484865298094202,Hawkish
64,22, fed/NNG;재할인율/NNG;인상/NNG,86,4.224079149205093,Hawkish
11,7, 재정위기/NNG;우려/NNG;크/VV,18,2.2817570404188228,Hawkish
9,10, 문진/NNG,19,1.3068244867853258,Hawkish
15,16, 재정위기/NNG;빠지/VV,31,1.3612755070680476,Hawkish
9,10,한걸/VV,19,1.3068244867853258,Hawkish
11,6, 태공/NNG,17,2.662049880488626,Hawkish
23,5, fed/NNG;금리/NNG;인상/NNG;기대/NNG;낮/VV,28,6.679325154680553,Hawkish
9,9,연쇄점/NNG,18,1.4520272075392509,Hawkish
12,13, 교육장/NNG,25,1.3403328069593086,Hawkish
9,7, 부채/NNG;적자/NNG,16,1.866892123979037,Hawkish
51,25,긴축안/NNG,76,2.962135503380072,Hawkish
23,15, fed/NNG;시장/NNG;금리/NNG;인상/NNG,38,2.2264417182268508,Hawkish
20,18, 강경/NNG;비둘기/NNG,38,1.6133635639325008,Hawkish
13,12, 국제선물거래소/NNG,25,1.5730294748341882,Hawkish
28,16,스팩/NNG,44,2.541047613193689,Hawkish
10,9, 갑작/NNG;금리/NNG;인상/NNG,19,1.6133635639325008,Hawkish
26,9,자문형랩/NNG,35,4.194745266224502,Hawkish
49,49,천안/NNG,98,1.4520272075392509,Hawkish
9,7,안함/NNG,16,1.866892123979037,Hawkish
13,13,준공후미분양/NNG,26,1.4520272075392509,Hawkish
17,12,머스크/NNG,29,2.0570385440139387,Hawkish
16,17, 와이파이/NNG,33,1.3666138423898828,Hawkish
9,9,노동계/NNG,18,1.4520272075392509,Hawkish
8,8, 금융위기/NNG;금리/NNG;오르/VV,16,1.4520272075392506,Hawkish
28,31, 커미티드라인/NNG,59,1.3115084455193233,Hawkish
23,24, 채권관련이익/NNG,47,1.3915260738917818,Hawkish
25,24,디아/NNG,49,1.5125283411867194,Hawkish
11,12, 역외/NNG;환율/NNG;오르/VV,23,1.331024940244313,Hawkish
15,11,일명/NNG,26,1.9800371011898874,Hawkish
36,28, 초저위험/NNG,64,1.866892123979037,Hawkish
11,7, 판독/NNG,18,2.2817570404188228,Hawkish
14,9,담화/NNG,23,2.258708989505501,Hawkish
11,8, 전투태세/NNG,19,1.9965374103664697,Hawkish
9,10, 트립/NNG,19,1.3068244867853258,Hawkish
34,16,신혜/NNG,50,3.0855578160209083,Hawkish
13,12, 유로존/NNG;재정위기/NNG;불안/NNG,25,1.5730294748341882,Hawkish
22,24, 금자리/NNG,46,1.331024940244313,Hawkish
53,7, 확성기/NNG,60,10.993920285654328,Hawkish
11,11,만기보유증권/NNG,22,1.4520272075392509,Hawkish
71,44, 양음/NNG,115,2.3430439030747006,Hawkish
11,12,러브/NNG,23,1.331024940244313,Hawkish
16,9, 민간/NNG;고용/NNG;지표/NNG;부진/NNG,25,2.5813817022920014,Hawkish
28,31, 사청/NNG,59,1.3115084455193233,Hawkish
20,0,토지수익연계채권/NNG,20,inf,Hawkish
30,12,예리/NNG,42,3.6300680188481267,Hawkish
9,10, 답해야/VV,19,1.3068244867853258,Hawkish
15,7, 대자연/NNG,22,3.1114868732983947,Hawkish
95,97,햇살론/NNG,192,1.4220885022291634,Hawkish
8,8, 중산층가구/NNG,16,1.4520272075392506,Hawkish
15,4, 캐피털사/NNG;고금리/NNG,19,5.44510202827219,Hawkish
15,8, 계약면적/NNG,23,2.722551014136095,Hawkish
10,8, 코픽스/NNG;금리/NNG;상승/NNG,18,1.8150340094240636,Hawkish
34,23,구경/NNG,57,2.1464750024493275,Hawkish
13,6, 금리/NNG;인상/NNG;시장/NNG;금리/NNG;오르/VV,19,3.1460589496683764,Hawkish
61,63,p2p대출/NNG,124,1.405931105712608,Hawkish
9,9, 경제/NNG;소비자/NNG;심리/NNG;낙관/NNG,18,1.4520272075392509,Hawkish
11,12,재정불량국/NNG,23,1.331024940244313,Hawkish
9,9, 소셜네트워킹서비스/NNG,18,1.4520272075392509,Hawkish
17,10, 국민경제대책회의/NNG,27,2.4684462528167264,Hawkish
117,128, p2p금융/NNG,245,1.3272436193913464,Hawkish
10,6,이니셜/NNG,16,2.420045345898751,Hawkish
9,7, 금리/NNG;소폭/MAG;낮/VA,16,1.866892123979037,Hawkish
25,10, 패밀리오피스/NNG,35,3.630068018848127,Hawkish
9,8, 갱도/NNG,17,1.6335306084816572,Hawkish
14,10, 회사채/NNG;발행/NNG;부담/NNG,24,2.032838090554951,Hawkish
14,8, 채소/NNG;가격/NNG;하락/NNG,22,2.541047613193689,Hawkish
11,9,성세/NNG,20,1.774699920325751,Hawkish
13,6, 지수/NNG;마이너스/NNG;급락/NNG,19,3.1460589496683764,Hawkish
50,12,포격/NNG,62,6.050113364746878,Hawkish
15,9, 포격사건/NNG,24,2.420045345898751,Hawkish
20,8,부동산임대업/NNG,28,3.630068018848127,Hawkish
10,6, 위키리크스/NNG,16,2.420045345898751,Hawkish
10,11, 전망/NNG;국채/NNG;수익률/NNG;상승/NNG,21,1.3200247341265916,Hawkish
8,8, 잠입/NNG,16,1.4520272075392506,Hawkish
10,11, 경제/NNG;느리/VA;성장/NNG,21,1.3200247341265916,Hawkish
16,12, 초저금리/NNG;양적완화/NNG,28,1.9360362767190007,Hawkish
17,2, 연장근로/NNG,19,12.342231264083633,Hawkish
10,9, 물머리/NNG,19,1.6133635639325008,Hawkish
12,9, 해외/NNG;금리/NNG;오르/VV,21,1.9360362767190011,Hawkish
9,10, 두드린/VV,19,1.3068244867853258,Hawkish
14,4,여진/NNG,18,5.082095226387378,Hawkish
14,10, 수인선/NNG,24,2.032838090554951,Hawkish
40,6,이집트사태/NNG,46,9.680181383595004,Hawkish
12,5, 신반/NNG,17,3.484865298094202,Hawkish
13,13,소셜/NNG,26,1.4520272075392509,Hawkish
11,7,의뢰인/NNG,18,2.2817570404188228,Hawkish
14,6, 플래트닝/NNG;일드커브/NNG;플래트닝/NNG,20,3.3880634842582515,Hawkish
13,6,가지급금/NNG,19,3.1460589496683764,Hawkish
12,10, 촌인/NNG,22,1.742432649047101,Hawkish
31,17,우대형/NNG,48,2.6478143196303985,Hawkish
28,13,올리/NNG,41,3.1274432162383863,Hawkish
12,4, 높/VA;필요/NNG;없/VA,16,4.356081622617753,Hawkish
15,3,원전사태/NNG,18,7.260136037696253,Hawkish
13,5, 검문소/NNG,18,3.775270739602052,Hawkish
15,11, 금리/NNG;인상/NNG;의구심/NNG,26,1.9800371011898874,Hawkish
19,14, 세슘/NNG,33,1.9706083530889835,Hawkish
11,8, 부월/NNG,19,1.9965374103664697,Hawkish
12,12, 부채/NNG;한도/NNG;상향/NNG,24,1.4520272075392509,Hawkish
10,11, 개선/NNG;성공/NNG,21,1.3200247341265916,Hawkish
8,8, 신용/NNG;대출/NNG;위험/NNG,16,1.4520272075392506,Hawkish
9,9,한규/NNG,18,1.4520272075392509,Hawkish
9,8,초대형투자은행/NNG,17,1.6335306084816572,Hawkish
9,7,대손준비금/NNG,16,1.866892123979037,Hawkish
10,7, 이익공/NNG,17,2.07432458219893,Hawkish
20,21,딩/NNG,41,1.3828830547992865,Hawkish
16,5, 가격/NNG;유가/NNG;급락/NNG,21,4.646487064125602,Hawkish
10,10, 지표/NNG;부진/NNG;상승/NNG,20,1.4520272075392509,Hawkish
10,9, 망중립성/NNG,19,1.6133635639325008,Hawkish
23,16,공표/NNG,39,2.087289110837673,Hawkish
10,10, 국채시장/NNG;최대/NNG,20,1.4520272075392509,Hawkish
8,8, 기대/NNG;소폭/MAG;오르/VV,16,1.4520272075392506,Hawkish
12,5, 곤충/NNG,17,3.484865298094202,Hawkish
17,4,그리스긴축안/NNG,21,6.171115632041817,Hawkish
16,16, 반겔/NNG,32,1.4520272075392506,Hawkish
12,4, 일드커브/NNG;플래트닝/NNG;되돌/VV,16,4.356081622617753,Hawkish
25,20, 졸자/NNG,45,1.8150340094240636,Hawkish
26,20, 제조업/NNG;pmi/NNG;낮/VA,46,1.887635369801026,Hawkish
15,8, 세계/NNG;금융시장/NNG;흔들/VV,23,2.722551014136095,Hawkish
9,9, 연체/NNG;금리/NNG;인하/NNG,18,1.4520272075392509,Hawkish
37,31, 살균제/NNG,68,1.733064731579106,Hawkish
13,3, 녹인배리어/NNG,16,6.292117899336753,Hawkish
8,8, 경제/NNG;대외/NNG;위험/NNG,16,1.4520272075392506,Hawkish
9,9, 채권시장/NNG;베어스티프닝/NNG,18,1.4520272075392509,Hawkish
14,2, 국채/NNG;매도/NNG;장기/NNG;금리/NNG;낮/VV,16,10.164190452774756,Hawkish
9,7, 촌역/NNG,16,1.866892123979037,Hawkish
16,2,슈퍼위원회/NNG,18,11.616217660314005,Hawkish
12,12, 신흥국/NNG;자본/NNG;이탈/NNG,24,1.4520272075392509,Hawkish
11,9, 위험/NNG;지표/NNG;상승/NNG,20,1.774699920325751,Hawkish
15,6, 회복/NNG;민생안정/NNG,21,3.6300680188481267,Hawkish
10,9, 유로존/NNG;경제/NNG;안정/NNG,19,1.6133635639325008,Hawkish
10,9, 채권시장/NNG;강세/NNG;압력/NNG,19,1.6133635639325008,Hawkish
12,8, 오질/NNG,20,2.1780408113088763,Hawkish
19,18,크라우드펀딩/NNG,37,1.5326953857358758,Hawkish
12,13, 고용/NNG;시장/NNG;예상/NNG;밑돌/VV,25,1.3403328069593086,Hawkish
8,8,성전/NNG,16,1.4520272075392506,Hawkish
17,14, 유로존/NNG;마이너스/NNG,31,1.7631758948690905,Hawkish
12,9, 금리/NNG;상승/NNG;영향/NNG;받/VV;하락/NNG,21,1.9360362767190011,Hawkish
109,86,재형저축/NNG,195,1.8403600653695156,Hawkish
15,12, 공인중개업소/NNG,27,1.8150340094240633,Hawkish
12,11,경제장관회의/NNG,23,1.58402968095191,Hawkish
20,9, 주택/NNG;착공/NNG;실적/NNG;늘/VV,29,3.2267271278650016,Hawkish
9,8, 합성/NNG;pmi/NNG;하락/NNG,17,1.6335306084816572,Hawkish
45,47,행복주택/NNG,92,1.39023881572907,Hawkish
11,8, 재정절벽/NNG;해소/NNG,19,1.9965374103664697,Hawkish
11,12,연매/NNG,23,1.331024940244313,Hawkish
12,6, 높/VA;거래/NNG;마치/VV;상승/NNG,18,2.9040544150785017,Hawkish
36,39, ism/NNG;서비스업/NNG;pmi/NNG;상승/NNG,75,1.3403328069593086,Hawkish
15,14, 부채한도/NNG;우려/NNG,29,1.5557434366491973,Hawkish
13,8, 종합소득금액/NNG,21,2.359544212251283,Hawkish
14,9, 유로존/NNG;지표/NNG;호조/NNG,23,2.258708989505501,Hawkish
9,7, 유초/NNG,16,1.866892123979037,Hawkish
52,29,시퀘스터/NNG,81,2.6036349928290017,Hawkish
13,12, 무역/NNG;지표/NNG;호조/NNG,25,1.5730294748341882,Hawkish
11,7, 채권시장/NNG;국고채/NNG;지표/NNG;금리/NNG;낮/VA,18,2.2817570404188228,Hawkish
13,12, 연기금풀/NNG,25,1.5730294748341882,Hawkish
15,16, rbc비율/NNG;개선/NNG,31,1.3612755070680476,Hawkish
24,16, 그린본드/NNG,40,2.1780408113088763,Hawkish
22,24, 디지털금융/NNG,46,1.331024940244313,Hawkish
12,10, 재고/NNG;예상/NNG;웃돌/VV,22,1.742432649047101,Hawkish
9,10, 지정학/NNG;위험/NNG;안전자산/NNG;선호/NNG,19,1.3068244867853258,Hawkish
13,11, ism/NNG;서비스업/NNG;pmi/NNG;하락/NNG,24,1.7160321543645694,Hawkish
9,10,통상임금/NNG,19,1.3068244867853258,Hawkish
8,8, 혼례/NNG,16,1.4520272075392506,Hawkish
8,8, fed/NNG;양적완화/NNG;정책/NNG;축소/NNG,16,1.4520272075392506,Hawkish
28,26, 모험자본/NNG,54,1.5637216081191931,Hawkish
16,16, 체감도/NNG;높/VV,32,1.4520272075392506,Hawkish
11,11, 양적완화/NNG;축소/NNG;불안/NNG,22,1.4520272075392509,Hawkish
12,7, 활성화/NNG;민생안정/NNG,19,2.489189498638716,Hawkish
18,19, 신흥국/NNG;통화/NNG;불안/NNG,37,1.375604722931922,Hawkish
28,14, 자산/NNG;매입/NNG;축소/NNG;우려/NNG,42,2.9040544150785017,Hawkish
49,14, 열병식/NNG,63,5.082095226387378,Hawkish
14,8, 호조/NNG;fed/NNG;매파/NNG,22,2.541047613193689,Hawkish
9,9, 저성장/NNG;탈출/NNG,18,1.4520272075392509,Hawkish
11,8, 자가점유율/NNG,19,1.9965374103664697,Hawkish
11,9,사내유보금/NNG,20,1.774699920325751,Hawkish
20,13, 경찰공제회/NNG,33,2.2338880115988475,Hawkish
8,8, 호주달러/NNG;금리/NNG;인하/NNG,16,1.4520272075392506,Hawkish
15,7,고연/NNG,22,3.1114868732983947,Hawkish
10,8, 지표/NNG;호조/NNG;약세/NNG,18,1.8150340094240636,Hawkish
9,9, 수출업체/NNG;네고/NNG;상단/NNG;막/VV,18,1.4520272075392509,Hawkish
10,8, 통화/NNG;증시/NNG;급락/NNG,18,1.8150340094240636,Hawkish
11,9, 알고리즘매매/NNG,20,1.774699920325751,Hawkish
12,12, rbc비율/NNG;떨어/VV,24,1.4520272075392509,Hawkish
9,10, 리코노믹스/NNG,19,1.3068244867853258,Hawkish
16,9, 에너지저장장치/NNG,25,2.5813817022920014,Hawkish
11,11, 유가/NNG;상승/NNG;긍정적/VAX,22,1.4520272075392509,Hawkish
10,10, 불안/NNG;국제/NNG;유가/NNG;하락/NNG,20,1.4520272075392509,Hawkish
9,9, 레피/NNG;금리/NNG;인하/NNG,18,1.4520272075392509,Hawkish
10,10, 마이너스gdp/NNG;갭/NNG;해소/NNG,20,1.4520272075392509,Hawkish
9,10, 약화/NNG;오르/VV,19,1.3068244867853258,Hawkish
59,57,계좌이동제/NNG,116,1.5029755306108032,Hawkish
33,34, 초장기물/NNG;금리/NNG;상승/NNG,67,1.4093205249645666,Hawkish
42,42,모디/NNG,84,1.4520272075392509,Hawkish
12,5, 인버스상품/NNG,17,3.484865298094202,Hawkish
21,0, 송인/NNG,21,inf,Hawkish
11,6, 임장/NNG,17,2.662049880488626,Hawkish
18,17, 달러위안/NNG;상승/NNG,35,1.5374405726886184,Hawkish
13,11, 펜딩/NNG;주택/NNG;판매/NNG;지수/NNG;하락/NNG,24,1.7160321543645694,Hawkish
18,18, 지정학/NNG;우려/NNG;크/VV,36,1.4520272075392509,Hawkish
11,6, 고용/NNG;지표/NNG;임금/NNG;상승/NNG,17,2.662049880488626,Hawkish
10,8, 금리/NNG;마이너스/NNG;한계/NNG,18,1.8150340094240636,Hawkish
12,12, 물량/NNG;압박/NNG;하락/NNG,24,1.4520272075392509,Hawkish
11,5, 중위험/NNG;위험/NNG,16,3.1944598565863513,Hawkish
17,12, fed/NNG;물가/NNG;목표/NNG;하회/NNG,29,2.0570385440139387,Hawkish
12,13,격추/NNG,25,1.3403328069593086,Hawkish
13,7, 질적/VAX;완화/NNG,20,2.6966219568586087,Hawkish
19,14, 구조적/VAX;장기/NNG;침체/NNG,33,1.9706083530889835,Hawkish
121,63, ecb/NNG;양적완화/NNG;축소/NNG,184,2.7888141605118943,Hawkish
10,8, 금리/NNG;ecb/NNG;양적완화/NNG,18,1.8150340094240636,Hawkish
12,8, 전망/NNG;웃돌/VV;경기/NNG;긍정적/VAX,20,2.1780408113088763,Hawkish
13,11, 전세가율/NNG;높/VA,24,1.7160321543645694,Hawkish
9,9, 지준율/NNG;금리/NNG;내리/VV,18,1.4520272075392509,Hawkish
21,18, pce/NNG;증가/NNG,39,1.6940317421291258,Hawkish
39,43, opec/NNG;산유량/NNG;감축/NNG,82,1.3169549091635064,Hawkish
9,7,자살보험금/NNG,16,1.866892123979037,Hawkish
14,10, 유가/NNG;급락/NNG;금리/NNG;인상/NNG,24,2.032838090554951,Hawkish
8,8,상표권/NNG,16,1.4520272075392506,Hawkish
22,16, 태주/NNG,38,1.9965374103664697,Hawkish
9,10, 미/NNG;건설/NNG;지출/NNG;감소/NNG,19,1.3068244867853258,Hawkish
12,12, 순이자마진/NNG;역대/NNG;최저/NNG,24,1.4520272075392509,Hawkish
19,15, 申年/NNG,34,1.839234462883051,Hawkish
25,24, 고용절벽/NNG,49,1.5125283411867194,Hawkish
18,16, 절하/NNG;위험/NNG,34,1.6335306084816572,Hawkish
16,8, fed/NNG;금리/NNG;전망/NNG;하향/NNG,24,2.9040544150785013,Hawkish
10,11, 생산/NNG;투자/NNG;회복/NNG,21,1.3200247341265916,Hawkish
27,22, fed/NNG;금리/NNG;인상/NNG;우호적/VAX,49,1.7820333910708988,Hawkish
12,6,아타만/NNG,18,2.9040544150785017,Hawkish
16,14, 저유가/NNG;금리/NNG;인상/NNG,30,1.6594596657591438,Hawkish
20,17,명훈/NNG,37,1.7082673029873539,Hawkish
12,10, 금리/NNG;인상/NNG;가능성/NNG;살/VV,22,1.742432649047101,Hawkish
13,7, 갑작/NNG;위안/NNG;절하/NNG,20,2.6966219568586087,Hawkish
11,5,계좌이동서비스/NNG,16,3.1944598565863513,Hawkish
16,16, 하락/NNG;위안/NNG;절하/NNG,32,1.4520272075392506,Hawkish
22,14, 태전/NNG,36,2.2817570404188228,Hawkish
10,11, 미/NNG;금리/NNG;인상/NNG;불확실성/NNG,21,1.3200247341265916,Hawkish
10,10, 금리/NNG;인상/NNG;강하/VA;지지/NNG,20,1.4520272075392509,Hawkish
22,24, 결정투표/NNG,46,1.331024940244313,Hawkish
103,76, 전자계약/NNG,179,1.9678789786387216,Hawkish
9,8, fed/NNG;금리/NNG;인상/NNG;가능성/NNG;살/VV,17,1.6335306084816572,Hawkish
18,0, 감계/NNG,18,inf,Hawkish
8,8, 당향/NNG,16,1.4520272075392506,Hawkish
17,7,중신용자/NNG,24,3.526351789738181,Hawkish
226,213, 케이뱅크/NNG,439,1.5406485864031485,Hawkish
201,173,케이뱅크/NNG,374,1.687037391418436,Hawkish
15,14, opec/NNG;산유량/NNG;감산/NNG,29,1.5557434366491973,Hawkish
21,21, 블록체인/NNG,42,1.4520272075392509,Hawkish
18,10, fed/NNG;고용시장/NNG;호조/NNG,28,2.6136489735706516,Hawkish
21,11, ecb/NNG;정책/NNG;실망/NNG,32,2.7720519416658425,Hawkish
10,6, opec/NNG;원유/NNG;생산/NNG;감축/NNG,16,2.420045345898751,Hawkish
12,4,블랙아웃/NNG,16,4.356081622617753,Hawkish
8,8, 달러인덱스/NNG;소폭/MAG;오르/VV,16,1.4520272075392506,Hawkish
19,0,수소탄/NNG,19,inf,Hawkish
10,7, 역외/NNG;위안/NNG;약세/NNG,17,2.07432458219893,Hawkish
25,10,전자계약/NNG,35,3.630068018848127,Hawkish
15,12, 국채선물시장/NNG;미/NNG;금리/NNG;상승/NNG,27,1.8150340094240633,Hawkish
9,8, 임금/NNG;상승/NNG;약하/VA,17,1.6335306084816572,Hawkish
17,7, 환율관찰대상국/NNG,24,3.526351789738181,Hawkish
10,9, 통안채/NNG;금리/NNG;오르/VV;금리/NNG;상승/NNG,19,1.6133635639325008,Hawkish
8,8,사잇돌/NNG,16,1.4520272075392506,Hawkish
14,15,건들/MAG,29,1.3552253937033008,Hawkish
13,4, 금리/NNG;인상/NNG;여건/NNG;강화/NNG,17,4.719088424502566,Hawkish
14,13, 제조업/NNG;pmi/NNG;내리/VV,27,1.5637216081191931,Hawkish
34,15, 금리조작부/NNG,49,3.291261670422302,Hawkish
14,11, 메기효과/NNG,25,1.8480346277772284,Hawkish
15,1, 신위탁보증제도/NNG,16,21.78040811308876,Hawkish
10,6,갭투자/NNG,16,2.420045345898751,Hawkish
9,7,운선/NNG,16,1.866892123979037,Hawkish
11,6,태전/NNG,17,2.662049880488626,Hawkish
23,1, 酉年/NNG,24,33.39662577340277,Hawkish
10,8, 담보권/NNG;실행/NNG;유예/NNG,18,1.8150340094240636,Hawkish
12,13,파면/NNG,25,1.3403328069593086,Hawkish
41,17, 물가/NNG;부진/NNG;일시적/VAX,58,3.5019479711240753,Hawkish
13,8,중기부/NNG,21,2.359544212251283,Hawkish
12,8,청구자/NNG,20,2.1780408113088763,Hawkish
25,2,어마/NNG,27,18.150340094240637,Hawkish
